unitid,instnm,semester,quarter,year,yearofsem,after,totcohortsize,w_cohortsize,m_cohortsize,tot4yrgrads,m_4yrgrads,w_4yrgrads,women_gradrate_4yr,men_gradrate_4yr,total_gradrate_4yr,instatetuition,costs,faculty,white_cohortsize
100654,ALABAMA A&M UNIVERSITY,1,0,1991,NA,NA,1010,527,483,152,32,120,0.22,0.07,0.15,1298,53,223,11
100654,ALABAMA A&M UNIVERSITY,1,0,1992,NA,NA,876,444,432,157,46,111,0.25,0.11,0.18,1600,52,267,5
100654,ALABAMA A & M UNIVERSITY,1,0,1993,NA,NA,1019,543,476,189,55,134,0.24,0.12,0.19,1600,50,262,7
100654,ALABAMA A & M UNIVERSITY,1,0,1995,NA,NA,849,434,415,185,47,138,0.31,0.11,0.22,2022,68,298,18
100654,ALABAMA A & M UNIVERSITY,1,0,1996,NA,NA,716,372,344,147,44,103,0.27,0.13,0.21,2312,66,311,17
100654,ALABAMA A & M UNIVERSITY,1,0,1997,NA,NA,789,412,377,159,41,118,0.28,0.11,0.2,2420,72,306,22
100654,ALABAMA A & M UNIVERSITY,1,0,1998,NA,NA,995,518,477,182,38,144,0.27,0.08,0.18,2332,78,237,25
100654,ALABAMA A & M UNIVERSITY,1,0,1999,NA,NA,1111,550,561,97,16,81,0.14,0.03,0.09,1932,75,243,26
100654,ALABAMA A & M UNIVERSITY,1,0,2000,NA,NA,1020,504,516,118,24,94,0.18,0.05,0.12,2400,79,273,26
100654,ALABAMA A & M UNIVERSITY,1,0,2001,NA,NA,1038,541,497,138,34,104,0.19,0.07,0.13,2400,96,304,18
100654,ALABAMA A & M UNIVERSITY,1,0,2002,NA,NA,1043,506,537,118,37,81,0.16,0.07,0.11,2520,90,284,18
100654,ALABAMA A & M UNIVERSITY,1,0,2003,NA,NA,1287,673,614,112,30,82,0.12,0.05,0.09,2832,107,294,17
100654,ALABAMA A & M UNIVERSITY,1,0,2004,NA,NA,1198,611,587,146,31,115,0.18,0.05,0.12,3120,110,307,10
100654,Alabama A & M University,1,0,2005,NA,NA,1088,572,516,116,27,89,0.15,0.05,0.11,3120,118,319,13
100654,Alabama A & M University,1,0,2006,NA,NA,1133,584,549,110,29,81,0.13,0.05,0.1,3120,123,319,12
100654,Alabama A & M University,1,0,2007,NA,NA,882,475,407,88,21,67,0.14,0.05,0.1,3432,126,311,9
100654,Alabama A & M University,1,0,2008,NA,NA,1044,568,476,115,23,92,0.16,0.05,0.11,3432,132,309,7
100654,Alabama A & M University,1,0,2009,NA,NA,1042,537,505,115,22,93,0.17,0.04,0.11,3948,122,311,24
100654,Alabama A & M University,1,0,2010,NA,NA,1073,549,524,69,18,51,0.09,0.03,0.06,4872,138,276,15
100663,UNIVERSITY OF ALABAMA AT BIRMINGHAM,0,1,1991,2001,0,937,500,437,82,33,49,0.09,0.08,0.09,2050,712,709,600
100663,UNIVERSITY OF ALABAMA AT BIRMINGHAM,0,1,1992,2001,0,898,479,419,54,19,35,0.07,0.05,0.06,2238,812,786,576
100663,UNIVERSITY OF ALABAMA AT BIRMINGHAM,0,1,1993,2001,0,938,518,420,99,31,68,0.13,0.07,0.11,2358,910,802,613
100663,UNIVERSITY OF ALABAMA AT BIRMINGHAM,0,1,1995,2001,0,1052,599,453,128,37,91,0.15,0.08,0.12,2604,937,707,602
100663,UNIVERSITY OF ALABAMA AT BIRMINGHAM,0,1,1996,2001,0,1027,597,430,134,35,99,0.16,0.08,0.13,2700,1024,680,568
100663,UNIVERSITY OF ALABAMA AT BIRMINGHAM,0,1,1997,2001,0,1115,657,458,161,52,109,0.16,0.11,0.14,2850,1075,690,631
100663,UNIVERSITY OF ALABAMA AT BIRMINGHAM,0,1,1998,2001,0,1076,646,430,164,48,116,0.17,0.11,0.15,3060,1188,691,611
100663,UNIVERSITY OF ALABAMA AT BIRMINGHAM,0,1,1999,2001,0,1143,678,465,163,59,104,0.15,0.13,0.14,2730,1180,708,667
100663,UNIVERSITY OF ALABAMA AT BIRMINGHAM,0,1,2000,2001,0,1234,748,486,173,51,122,0.16,0.1,0.14,2820,1215,564,653
100663,UNIVERSITY OF ALABAMA AT BIRMINGHAM,1,0,2001,2001,1,1224,765,459,175,57,118,0.15,0.12,0.14,2970,1334,421,648
100663,UNIVERSITY OF ALABAMA AT BIRMINGHAM,1,0,2002,2001,1,1398,820,578,228,86,142,0.17,0.15,0.16,3150,1335,804,775
100663,UNIVERSITY OF ALABAMA AT BIRMINGHAM,1,0,2003,2001,1,1607,1042,565,266,61,205,0.19,0.11,0.17,3480,1440,833,781
100663,UNIVERSITY OF ALABAMA AT BIRMINGHAM,1,0,2004,2001,1,1536,973,563,284,82,202,0.2,0.15,0.18,3840,1571,810,846
100663,University of Alabama at Birmingham,1,0,2005,2001,1,1515,895,620,350,110,240,0.26,0.18,0.23,3960,1604,824,875
100663,University of Alabama at Birmingham,1,0,2006,2001,1,1485,895,590,378,124,254,0.28,0.21,0.25,3960,1707,824,905
100663,University of Alabama at Birmingham,1,0,2007,2001,1,1378,807,571,404,137,267,0.33,0.24,0.29,3384,1824,852,835
100663,University of Alabama at Birmingham,1,0,2008,2001,1,1246,710,536,406,140,266,0.37,0.26,0.33,3792,2213,849,790
100663,University of Alabama at Birmingham,1,0,2009,2001,1,1494,819,675,474,188,286,0.34,0.28,0.32,4224,2223,832,932
100663,University of Alabama at Birmingham,1,0,2010,2001,1,1537,851,686,463,176,287,0.33,0.26,0.3,5806,2338,861,921
100751,THE UNIVERSITY OF ALABAMA,1,0,1991,NA,NA,2511,1348,1163,630,213,417,0.3,0.18,0.25,1936,237,818,2174
100751,THE UNIVERSITY OF ALABAMA,1,0,1992,NA,NA,2436,1310,1126,684,240,444,0.33,0.21,0.28,2068,237,773,2075
100751,THE UNIVERSITY OF ALABAMA,1,0,1993,NA,NA,2516,1318,1198,638,231,407,0.3,0.19,0.25,2172,257,762,2148
100751,THE UNIVERSITY OF ALABAMA,1,0,1995,NA,NA,2493,1387,1106,748,246,502,0.36,0.22,0.3,2374,294,770,2133
100751,THE UNIVERSITY OF ALABAMA,1,0,1996,NA,NA,2049,1195,854,744,240,504,0.42,0.28,0.36,2470,295,738,1777
100751,THE UNIVERSITY OF ALABAMA,1,0,1997,NA,NA,2572,1403,1169,859,307,552,0.39,0.26,0.33,2594,306,750,2111
100751,UNIVERSITY OF ALABAMA,1,0,1998,NA,NA,2597,1437,1160,857,269,588,0.4,0.23,0.33,2684,320,781,2088
100751,UNIVERSITY OF ALABAMA,1,0,1999,NA,NA,2687,1499,1188,948,309,639,0.42,0.26,0.35,2872,341,795,2216
100751,UNIVERSITY OF ALABAMA,1,0,2000,NA,NA,2886,1653,1233,1038,303,735,0.44,0.25,0.36,3014,357,787,2357
100751,UNIVERSITY OF ALABAMA,1,0,2001,NA,NA,2384,1342,1042,920,313,607,0.45,0.3,0.39,3292,380,779,2047
100751,UNIVERSITY OF ALABAMA,1,0,2002,NA,NA,2585,1441,1144,932,318,614,0.42,0.28,0.36,3556,372,794,2230
100751,UNIVERSITY OF ALABAMA,1,0,2003,NA,NA,2982,1685,1297,1121,364,757,0.44,0.28,0.38,4134,392,810,2584
100751,THE UNIVERSITY OF ALABAMA,1,0,2004,NA,NA,3290,1853,1437,1248,426,822,0.44,0.3,0.38,4630,404,800,2873
100751,The University of Alabama,1,0,2005,NA,NA,3642,2038,1604,1373,491,882,0.43,0.31,0.38,4864,449,813,3048
100751,The University of Alabama,1,0,2006,NA,NA,4275,2377,1898,1757,660,1097,0.46,0.35,0.41,5278,496,850,3609
100751,The University of Alabama,1,0,2007,NA,NA,4438,2461,1977,1897,708,1189,0.48,0.36,0.43,5700,565,904,3890
100751,The University of Alabama,1,0,2008,NA,NA,5009,2776,2233,1942,703,1239,0.44,0.31,0.39,6400,629,1067,4280
100751,The University of Alabama,1,0,2009,NA,NA,5062,2746,2316,2093,772,1321,0.48,0.33,0.41,7000,658,1106,4221
100751,The University of Alabama,1,0,2010,NA,NA,5443,3006,2437,2387,856,1531,0.5,0.35,0.44,7900,760,1175,4332
100858,AUBURN UNIVERSITY MAIN CAMPUS,0,1,1991,2000,0,3024,1496,1528,846,312,534,0.35000000000000003,0.2,0.28,1596,306,1128,2704
100858,AUBURN UNIVERSITY MAIN CAMPUS,0,1,1992,2000,0,3141,1621,1520,927,295,632,0.38,0.19,0.3,1755,304,1098,2864
100858,AUBURN UNIVERSITY MAIN CAMPUS,0,1,1993,2000,0,2997,1552,1445,878,286,592,0.38,0.2,0.29,1950,321,1109,2703
100858,AUBURN UNIVERSITY MAIN CAMPUS,0,1,1995,2000,0,3486,1832,1654,1106,345,761,0.41000000000000003,0.21,0.32,2250,368,1131,3175
100858,AUBURN UNIVERSITY MAIN CAMPUS,0,1,1996,2000,0,3287,1746,1541,1321,446,875,0.5,0.29,0.4,2355,372,1145,2985
100858,AUBURN UNIVERSITY MAIN CAMPUS,0,1,1997,2000,0,3140,1676,1464,1165,385,780,0.46,0.26,0.37,2565,376,1145,2879
100858,AUBURN UNIVERSITY MAIN CAMPUS,0,1,1998,2000,0,3654,1913,1741,1229,415,814,0.42,0.24,0.34,2760,393,1139,3278
100858,AUBURN UNIVERSITY MAIN CAMPUS,0,1,1999,2000,0,3693,1875,1818,1189,393,796,0.42,0.22,0.32,2895,425,1146,3253
100858,AUBURN UNIVERSITY MAIN CAMPUS,1,0,2000,2000,1,3861,1990,1871,1277,451,826,0.41000000000000003,0.24,0.33,3050,488,1130,3459
100858,AUBURN UNIVERSITY MAIN CAMPUS,1,0,2001,2000,1,3739,1949,1790,1284,468,816,0.41000000000000003,0.26,0.34,3260,506,1115,3258
100858,AUBURN UNIVERSITY MAIN CAMPUS,1,0,2002,2000,1,4148,2184,1964,1424,498,926,0.42,0.25,0.34,3650,481,1142,3596
100858,AUBURN UNIVERSITY MAIN CAMPUS,1,0,2003,2000,1,3692,1965,1727,1352,444,908,0.46,0.26,0.37,4230,526,1171,3174
100858,AUBURN UNIVERSITY MAIN CAMPUS,1,0,2004,2000,1,3579,1849,1730,1279,445,834,0.45,0.26,0.36,4610,552,1177,3032
100858,Auburn University Main Campus,1,0,2005,2000,1,4179,2180,1999,1491,511,980,0.44,0.26,0.36,4800,573,1176,3543
100858,Auburn University Main Campus,1,0,2006,2000,1,4072,2168,1904,1556,549,1007,0.46,0.29,0.38,5000,580,1139,3328
100858,Auburn University Main Campus,1,0,2007,2000,1,4165,2207,1958,1565,548,1017,0.46,0.28,0.38,5250,642,1132,3414
100858,Auburn University Main Campus,1,0,2008,2000,1,3967,2049,1918,1676,627,1049,0.51,0.33,0.42,5880,703,1176,3493
100858,Auburn University Main Campus,1,0,2009,2000,1,3911,2007,1904,1733,617,1116,0.55,0.32,0.44,6240,722,1184,3363
100858,Auburn University,1,0,2010,2000,1,4193,2204,1989,1963,730,1233,0.55,0.37,0.47,7008,717,1196,3523
101435,HUNTINGDON COLLEGE,1,0,1991,NA,NA,189,101,88,60,25,35,0.34,0.28,0.32,6400,9,44,158
101435,HUNTINGDON COLLEGE,1,0,1992,NA,NA,166,91,75,53,14,39,0.42,0.19,0.32,7140,10,43,135
101435,HUNTINGDON COLLEGE,1,0,1993,NA,NA,125,80,45,40,7,33,0.41000000000000003,0.16,0.32,7540,9,44,107
101435,HUNTINGDON COLLEGE,1,0,1995,NA,NA,160,106,54,56,17,39,0.36,0.31,0.35,8645,10,41,146
101435,HUNTINGDON COLLEGE,1,0,1996,NA,NA,165,95,70,62,16,46,0.48,0.23,0.38,10140,12,43,140
101435,HUNTINGDON COLLEGE,1,0,1997,NA,NA,191,114,77,89,28,61,0.53,0.36,0.47,10600,9,43,177
101435,HUNTINGDON COLLEGE,1,0,1998,NA,NA,175,96,79,88,31,57,0.59,0.39,0.5,11010,10,44,158
101435,HUNTINGDON COLLEGE,1,0,1999,NA,NA,163,103,60,58,14,44,0.42,0.23,0.36,10500,11,47,144
101435,HUNTINGDON COLLEGE,1,0,2000,NA,NA,151,95,56,67,21,46,0.48,0.38,0.44,11000,12,44,134
101435,HUNTINGDON COLLEGE,1,0,2001,NA,NA,146,96,50,58,13,45,0.46,0.26,0.4,11500,12,42,128
101435,HUNTINGDON COLLEGE,1,0,2002,NA,NA,165,108,57,76,21,55,0.5,0.37,0.46,13800,12,41,146
101435,HUNTINGDON COLLEGE,1,0,2003,NA,NA,203,76,127,72,30,42,0.55,0.24,0.35,14560,13,32,171
101435,HUNTINGDON COLLEGE,1,0,2004,NA,NA,192,72,120,71,38,33,0.45,0.32,0.37,15250,13,32,160
101435,Huntingdon College,1,0,2005,NA,NA,185,90,95,78,34,44,0.48,0.36,0.42,15250,13,33,159
101435,Huntingdon College,1,0,2006,NA,NA,214,85,129,72,36,36,0.42,0.28,0.34,15990,14,34,172
101435,Huntingdon College,1,0,2007,NA,NA,257,117,140,78,23,55,0.47000000000000003,0.16,0.3,17570,16,42,201
101435,Huntingdon College,1,0,2008,NA,NA,253,106,147,76,28,48,0.45,0.19,0.3,19320,17,44,196
101435,Huntingdon College,1,0,2009,NA,NA,237,99,138,58,30,28,0.28,0.22,0.24,19990,19,45,169
101435,Huntingdon College,1,0,2010,NA,NA,271,113,158,71,30,41,0.36,0.19,0.26,18512,18,47,184
101480,JACKSONVILLE STATE UNIVERSITY,1,0,1991,NA,NA,1100,567,533,109,42,67,0.11,0.08,0.1,1420,44,274,829
101480,JACKSONVILLE STATE UNIVERSITY,1,0,1992,NA,NA,1106,615,491,116,34,82,0.13,0.07,0.1,1550,44,274,847
101480,JACKSONVILLE STATE UNIVERSITY,1,0,1993,NA,NA,845,436,409,89,24,65,0.14,0.06,0.11,1680,44,272,648
101480,JACKSONVILLE STATE UNIVERSITY,1,0,1995,NA,NA,798,435,363,136,36,100,0.22,0.1,0.17,1840,51,268,618
101480,JACKSONVILLE STATE UNIVERSITY,1,0,1996,NA,NA,817,446,371,122,23,99,0.22,0.06,0.15,1940,52,255,613
101480,JACKSONVILLE STATE UNIVERSITY,1,0,1997,NA,NA,764,401,363,123,43,80,0.19,0.12,0.16,2040,53,261,582
101480,JACKSONVILLE STATE UNIVERSITY,1,0,1998,NA,NA,752,392,360,112,34,78,0.19,0.09,0.15,2140,54,262,573
101480,JACKSONVILLE STATE UNIVERSITY,1,0,1999,NA,NA,805,455,350,142,44,98,0.21,0.13,0.18,2440,59,262,592
101480,JACKSONVILLE STATE UNIVERSITY,1,0,2000,NA,NA,850,443,407,127,39,88,0.19,0.1,0.15,2640,64,263,587
101480,JACKSONVILLE STATE UNIVERSITY,1,0,2001,NA,NA,877,480,397,146,40,106,0.22,0.1,0.17,2940,68,265,569
101480,JACKSONVILLE STATE UNIVERSITY,1,0,2002,NA,NA,1059,567,492,146,41,105,0.18,0.08,0.14,3240,73,289,748
101480,JACKSONVILLE STATE UNIVERSITY,1,0,2003,NA,NA,1044,561,483,139,45,94,0.16,0.09,0.13,3540,78,294,686
101480,JACKSONVILLE STATE UNIVERSITY,1,0,2004,NA,NA,1017,555,462,91,20,71,0.12,0.04,0.09,4040,79,300,657
101480,Jacksonville State University,1,0,2005,NA,NA,1120,595,525,120,37,83,0.13,0.07,0.11,4040,88,305,673
101480,Jacksonville State University,1,0,2006,NA,NA,1106,626,480,106,23,83,0.13,0.05,0.1,4056,94,319,631
101480,Jacksonville State University,1,0,2007,NA,NA,1252,696,556,127,44,83,0.11,0.08,0.1,4056,102,321,633
101480,Jacksonville State University,1,0,2008,NA,NA,1243,663,580,108,31,77,0.11,0.05,0.09,4560,106,322,693
101480,Jacksonville State University,1,0,2009,NA,NA,1220,695,525,137,30,107,0.15,0.06,0.11,5970,107,322,649
101480,Jacksonville State University,1,0,2010,NA,NA,1246,685,561,180,55,125,0.18,0.1,0.14,6780,111,326,755
101675,MILES COLLEGE,1,0,1991,NA,NA,365,144,221,73,41,32,0.22,0.19,0.2,3760,6,33,0
101675,MILES COLLEGE,1,0,1992,NA,NA,226,108,118,107,52,55,0.5,0.44,0.47,3800,7,34,2
101675,MILES COLLEGE,1,0,1993,NA,NA,331,164,167,162,67,95,0.5700000000000001,0.4,0.49,3800,7,33,2
101675,MILES COLLEGE,1,0,1995,NA,NA,229,114,115,120,50,70,0.61,0.43,0.52,4350,10,41,0
101675,MILES COLLEGE,1,0,1996,NA,NA,327,146,181,125,58,67,0.45,0.32,0.38,4500,11,43,0
101675,MILES COLLEGE,1,0,1997,NA,NA,374,169,205,3,2,1,0,0.01,0.01,4500,13,45,0
101675,MILES COLLEGE,1,0,1998,NA,NA,340,177,163,133,51,82,0.46,0.31,0.39,4500,15,47,2
101675,MILES COLLEGE,1,0,1999,NA,NA,319,170,149,113,21,92,0.54,0.14,0.35,4280,16,59,1
101675,MILES COLLEGE,1,0,2000,NA,NA,425,220,205,85,19,66,0.3,0.09,0.2,4408,18,62,0
101675,MILES COLLEGE,1,0,2001,NA,NA,423,213,210,29,9,20,0.09,0.04,0.07,4408,19,66,4
101675,MILES COLLEGE,1,0,2002,NA,NA,391,195,196,24,7,17,0.08,0.04,0.06,4628,21,87,1
101675,MILES COLLEGE,1,0,2003,NA,NA,347,179,168,24,6,18,0.1,0.04,0.07,5090,20,111,0
101675,MILES COLLEGE,1,0,2004,NA,NA,427,203,224,49,9,40,0.19,0.04,0.11,5250,17,89,2
101675,Miles College,1,0,2005,NA,NA,389,177,212,25,4,21,0.11,0.02,0.06,5408,18,92,1
101675,Miles College,1,0,2006,NA,NA,352,159,193,15,3,12,0.07,0.02,0.04,5950,19,93,3
101675,Miles College,1,0,2007,NA,NA,486,246,240,29,7,22,0.08,0.03,0.06,6545,23,94,10
101675,Miles College,1,0,2008,NA,NA,461,213,248,38,5,33,0.15,0.02,0.08,7396,22,102,7
101675,Miles College,1,0,2009,NA,NA,392,179,213,21,4,17,0.09,0.02,0.05,8506,24,102,3
101675,Miles College,1,0,2010,NA,NA,343,141,202,44,18,26,0.18,0.09,0.13,9186,25,97,2
101879,UNIVERSITY OF NORTH ALABAMA,1,0,1991,NA,NA,755,387,368,66,23,43,0.11,0.06,0.09,1296,28,190,664
101879,UNIVERSITY OF NORTH ALABAMA,1,0,1992,NA,NA,554,321,233,74,24,50,0.15,0.1,0.13,1460,30,196,490
101879,UNIVERSITY OF NORTH ALABAMA,1,0,1993,NA,NA,651,371,280,83,16,67,0.18,0.06,0.13,1586,33,200,567
101879,UNIVERSITY OF NORTH ALABAMA,1,0,1995,NA,NA,762,444,318,167,44,123,0.27,0.14,0.22,1910,37,197,638
101879,UNIVERSITY OF NORTH ALABAMA,1,0,1996,NA,NA,790,459,331,99,28,71,0.15,0.08,0.13,1998,37,200,650
101879,UNIVERSITY OF NORTH ALABAMA,1,0,1997,NA,NA,751,448,303,111,20,91,0.2,0.07,0.15,2166,38,193,648
101879,UNIVERSITY OF NORTH ALABAMA,1,0,1998,NA,NA,828,490,338,118,28,90,0.18,0.08,0.14,2256,41,181,648
101879,UNIVERSITY OF NORTH ALABAMA,1,0,1999,NA,NA,809,473,336,127,28,99,0.2,0.08,0.16,2232,43,203,650
101879,UNIVERSITY OF NORTH ALABAMA,1,0,2000,NA,NA,824,481,343,143,35,108,0.22,0.1,0.17,2328,46,199,677
101879,UNIVERSITY OF NORTH ALABAMA,1,0,2001,NA,NA,816,465,351,147,36,111,0.23,0.1,0.18,2544,48,196,636
101879,UNIVERSITY OF NORTH ALABAMA,1,0,2002,NA,NA,786,457,329,104,27,77,0.16,0.08,0.13,2784,47,198,586
101879,UNIVERSITY OF NORTH ALABAMA,1,0,2003,NA,NA,789,479,310,142,37,105,0.21,0.12,0.18,3048,50,199,597
101879,UNIVERSITY OF NORTH ALABAMA,1,0,2004,NA,NA,856,469,387,107,27,80,0.17,0.07,0.12,3336,52,200,668
101879,University of North Alabama,1,0,2005,NA,NA,982,526,456,2,1,1,0,0,0,3432,58,208,678
101879,University of North Alabama,1,0,2006,NA,NA,1019,575,444,112,26,86,0.14,0.06,0.11,3528,64,222,622
101879,University of North Alabama,1,0,2007,NA,NA,1023,558,465,126,31,95,0.17,0.07,0.12,3288,72,231,654
101879,University of North Alabama,1,0,2008,NA,NA,988,533,455,119,34,85,0.15,0.07,0.12,4590,83,242,639
101879,University of North Alabama,1,0,2009,NA,NA,1064,597,467,122,33,89,0.14,0.07,0.11,4008,83,236,775
101879,University of North Alabama,1,0,2010,NA,NA,961,562,399,152,43,109,0.19,0.11,0.16,4440,83,238,744
102049,SAMFORD UNIVERSITY,1,0,1991,NA,NA,569,337,232,217,89,128,0.37,0.38,0.38,6540,48,188,536
102049,SAMFORD UNIVERSITY,1,0,1992,NA,NA,662,405,257,295,108,187,0.46,0.42,0.45,7064,52,203,621
102049,SAMFORD UNIVERSITY,1,0,1993,NA,NA,680,438,242,318,117,201,0.45,0.48,0.47,7770,58,215,648
102049,SAMFORD UNIVERSITY,1,0,1995,NA,NA,647,399,248,331,118,213,0.53,0.48,0.51,8648,61,233,617
102049,SAMFORD UNIVERSITY,1,0,1996,NA,NA,646,388,258,329,117,212,0.54,0.45,0.51,9070,86,236,606
102049,SAMFORD UNIVERSITY,1,0,1997,NA,NA,745,470,275,405,139,266,0.56,0.51,0.54,9432,76,240,708
102049,SAMFORD UNIVERSITY,1,0,1998,NA,NA,625,390,235,316,110,206,0.52,0.47,0.51,9904,72,245,594
102049,SAMFORD UNIVERSITY,1,0,1999,NA,NA,674,420,254,353,120,233,0.55,0.47,0.52,10300,73,243,627
102049,SAMFORD UNIVERSITY,1,0,2000,NA,NA,657,427,230,359,122,237,0.55,0.53,0.55,10738,78,250,607
102049,SAMFORD UNIVERSITY,1,0,2001,NA,NA,658,434,224,354,109,245,0.56,0.49,0.54,11490,78,257,597
102049,SAMFORD UNIVERSITY,1,0,2002,NA,NA,652,428,224,5,0,5,0.01,0,0.01,12294,85,260,618
102049,SAMFORD UNIVERSITY,1,0,2003,NA,NA,682,426,256,362,123,239,0.56,0.48,0.53,13154,86,264,615
102049,SAMFORD UNIVERSITY,1,0,2004,NA,NA,665,423,242,359,111,248,0.58,0.46,0.54,13944,92,267,621
102049,Samford University,1,0,2005,NA,NA,699,457,242,358,93,265,0.5700000000000001,0.38,0.51,14642,98,278,634
102049,Samford University,1,0,2006,NA,NA,644,392,252,326,99,227,0.5700000000000001,0.39,0.51,16000,108,280,591
102049,Samford University,1,0,2007,NA,NA,711,459,252,348,112,236,0.51,0.44,0.49,17920,121,280,651
102049,Samford University,1,0,2008,NA,NA,705,442,263,336,104,232,0.52,0.4,0.48,19300,117,290,616
102049,Samford University,1,0,2009,NA,NA,730,486,244,430,132,298,0.61,0.54,0.59,20200,121,282,670
102049,Samford University,1,0,2010,NA,NA,711,455,256,417,132,285,0.62,0.52,0.59,21722,123,294,616
102094,UNIVERSITY OF SOUTH ALABAMA,0,1,1991,1998,0,1245,653,592,117,32,85,0.13,0.05,0.09,2103,266,430,1030
102094,UNIVERSITY OF SOUTH ALABAMA,0,1,1992,1998,0,1170,668,502,123,38,85,0.12,0.08,0.11,2295,290,418,978
102094,UNIVERSITY OF SOUTH ALABAMA,0,1,1993,1998,0,1086,621,465,125,38,87,0.14,0.08,0.12,2295,350,434,898
102094,UNIVERSITY OF SOUTH ALABAMA,0,1,1995,1998,0,1192,674,518,167,54,113,0.16,0.1,0.14,2541,367,447,985
102094,UNIVERSITY OF SOUTH ALABAMA,0,1,1996,1998,0,1066,590,476,147,37,110,0.18,0.08,0.14,2538,373,442,883
102094,UNIVERSITY OF SOUTH ALABAMA,0,1,1997,1998,0,1132,663,469,138,38,100,0.15,0.08,0.12,2673,394,432,903
102094,UNIVERSITY OF SOUTH ALABAMA,1,0,1998,1998,1,1044,618,426,143,36,107,0.17,0.08,0.14,2673,416,435,799
102094,UNIVERSITY OF SOUTH ALABAMA,1,0,1999,1998,1,882,521,361,122,22,100,0.19,0.06,0.14,2670,409,442,668
102094,UNIVERSITY OF SOUTH ALABAMA,1,0,2000,1998,1,1064,679,385,167,46,121,0.17,0.12,0.16,2670,452,436,810
102094,UNIVERSITY OF SOUTH ALABAMA,1,0,2001,1998,1,1116,634,482,160,40,120,0.18,0.08,0.14,2910,449,430,850
102094,UNIVERSITY OF SOUTH ALABAMA,1,0,2002,1998,1,1004,597,407,135,42,93,0.15,0.1,0.13,3090,477,441,777
102094,UNIVERSITY OF SOUTH ALABAMA,1,0,2003,1998,1,1218,704,514,155,42,113,0.16,0.08,0.13,3390,496,475,851
102094,UNIVERSITY OF SOUTH ALABAMA,1,0,2004,1998,1,1278,725,553,180,60,120,0.16,0.11,0.14,3810,436,483,882
102094,University of South Alabama,1,0,2005,1998,1,1198,689,509,199,62,137,0.19,0.12,0.17,3810,450,499,836
102094,University of South Alabama,1,0,2006,1998,1,1355,777,578,190,55,135,0.17,0.1,0.14,3810,469,516,941
102094,University of South Alabama,1,0,2007,1998,1,1457,801,656,200,68,132,0.16,0.1,0.14,4020,493,527,991
102094,University of South Alabama,1,0,2008,1998,1,1543,875,668,230,68,162,0.18,0.1,0.15,4410,548,530,1055
102094,University of South Alabama,1,0,2009,1998,1,1753,927,826,244,83,161,0.17,0.1,0.14,4860,562,503,1146
102094,University of South Alabama,1,0,2010,1998,1,1707,950,757,262,83,179,0.18,0.11,0.15,5448,573,514,1074
102234,SPRING HILL COLLEGE,1,0,1991,NA,NA,279,158,121,106,42,64,0.4,0.35,0.38,10149,18,64,229
102234,SPRING HILL COLLEGE,1,0,1992,NA,NA,295,167,128,144,58,86,0.51,0.45,0.49,10763,18,57,255
102234,SPRING HILL COLLEGE,1,0,1993,NA,NA,229,129,100,106,43,63,0.48,0.43,0.46,11425,19,55,205
102234,SPRING HILL COLLEGE,1,0,1995,NA,NA,232,141,91,113,34,79,0.56,0.37,0.49,12489,20,61,198
102234,SPRING HILL COLLEGE,1,0,1996,NA,NA,201,121,80,96,32,64,0.52,0.4,0.48,13140,21,61,176
102234,SPRING HILL COLLEGE,1,0,1997,NA,NA,254,144,110,118,55,63,0.43,0.5,0.46,13890,17,60,221
102234,SPRING HILL COLLEGE,1,0,1998,NA,NA,242,119,123,120,61,59,0.49,0.5,0.5,14620,20,64,210
102234,SPRING HILL COLLEGE,1,0,1999,NA,NA,299,182,117,147,43,104,0.5700000000000001,0.37,0.49,14390,20,65,241
102234,SPRING HILL COLLEGE,1,0,2000,NA,NA,284,186,98,158,47,111,0.59,0.48,0.56,15254,22,66,244
102234,SPRING HILL COLLEGE,1,0,2001,NA,NA,251,137,114,112,39,73,0.53,0.34,0.45,16170,23,68,190
102234,SPRING HILL COLLEGE,1,0,2002,NA,NA,289,168,121,151,60,91,0.54,0.5,0.52,16980,24,68,241
102234,SPRING HILL COLLEGE,1,0,2003,NA,NA,308,193,115,157,61,96,0.49,0.53,0.51,17830,25,67,225
102234,SPRING HILL COLLEGE,1,0,2004,NA,NA,309,203,106,156,44,112,0.55,0.42,0.5,18722,26,69,222
102234,Spring Hill College,1,0,2005,NA,NA,274,173,101,139,49,90,0.52,0.49,0.51,19658,28,72,200
102234,Spring Hill College,1,0,2006,NA,NA,345,226,119,189,62,127,0.56,0.52,0.55,20650,32,77,238
102234,Spring Hill College,1,0,2007,NA,NA,380,243,137,179,65,114,0.46,0.47,0.47,21686,34,80,289
102234,Spring Hill College,1,0,2008,NA,NA,344,213,131,175,62,113,0.53,0.47,0.51,22770,37,82,234
102234,Spring Hill College,1,0,2009,NA,NA,355,203,152,152,55,97,0.47000000000000003,0.36,0.43,23910,39,82,248
102234,Spring Hill College,1,0,2010,NA,NA,392,252,140,180,56,124,0.49,0.4,0.46,25110,36,78,268
102368,TROY STATE UNIVERSITY-MAIN CAMPUS,0,1,1991,1999,0,793,437,356,205,70,135,0.3,0.2,0.26,1470,36,182,641
102368,TROY STATE UNIVERSITY-MAIN CAMPUS,0,1,1992,1999,0,935,460,475,217,73,144,0.31,0.15,0.23,1617,39,188,742
102368,TROY STATE UNIVERSITY-MAIN CAMPUS,0,1,1993,1999,0,926,526,400,303,108,195,0.37,0.27,0.33,1771,52,204,731
102368,TROY STATE UNIVERSITY-MAIN CAMPUS,0,1,1995,1999,0,877,477,400,354,120,234,0.49,0.3,0.4,2007,59,216,711
102368,TROY STATE UNIVERSITY-MAIN CAMPUS,0,1,1996,1999,0,877,483,394,340,133,207,0.42,0.34,0.39,2175,52,221,658
102368,TROY STATE UNIVERSITY-MAIN CAMPUS,0,1,1997,1999,0,803,474,329,307,109,198,0.41000000000000003,0.33,0.38,2250,53,218,612
102368,TROY STATE UNIVERSITY-MAIN CAMPUS,0,1,1998,1999,0,768,437,331,251,75,176,0.4,0.23,0.33,2490,56,167,501
102368,TROY STATE UNIVERSITY-MAIN CAMPUS,1,0,1999,1999,1,845,510,335,271,85,186,0.36,0.25,0.32,2660,78,169,571
102368,TROY STATE UNIVERSITY-MAIN CAMPUS,1,0,2000,1999,1,941,513,428,271,105,166,0.32,0.25,0.29,2850,83,217,568
102368,TROY STATE UNIVERSITY-MAIN CAMPUS,1,0,2001,1999,1,1054,572,482,211,71,140,0.24,0.15,0.2,3020,88,265,666
102368,TROY STATE UNIVERSITY-MAIN CAMPUS,1,0,2002,1999,1,1353,730,623,288,101,187,0.25,0.16,0.21,3220,90,307,810
102368,TROY STATE UNIVERSITY-MAIN CAMPUS,1,0,2003,1999,1,1229,672,557,215,66,149,0.22,0.12,0.17,3530,104,314,757
102368,TROY STATE UNIVERSITY-MAIN CAMPUS,1,0,2004,1999,1,1450,788,662,230,67,163,0.2,0.1,0.16,3850,116,316,866
102368,Troy University,1,0,2005,1999,1,1434,789,645,201,64,137,0.17,0.1,0.14,4004,169,443,834
102368,Troy University,1,0,2006,1999,1,1666,964,702,238,77,161,0.16,0.11,0.14,4004,181,444,930
102368,Troy University,1,0,2007,1999,1,1763,1011,752,222,75,147,0.14,0.1,0.13,4164,201,440,958
102368,Troy University,1,0,2008,1999,1,1827,1081,746,246,76,170,0.15,0.1,0.13,4248,218,449,988
102368,Troy University,1,0,2009,1999,1,1997,1192,805,265,78,187,0.15,0.1,0.13,4632,242,490,988
102368,Troy University,1,0,2010,1999,1,1810,1083,727,295,97,198,0.18,0.13,0.16,5184,255,577,949
102377,TUSKEGEE UNIVERSITY,1,0,1991,NA,NA,837,469,368,167,70,97,0.2,0.19,0.2,6250,60,249,2
102377,TUSKEGEE UNIVERSITY,1,0,1992,NA,NA,612,311,301,123,36,87,0.27,0.12,0.2,6535,65,251,0
102377,TUSKEGEE UNIVERSITY,1,0,1993,NA,NA,595,302,293,104,39,65,0.21,0.13,0.17,6734,73,254,0
102377,TUSKEGEE UNIVERSITY,1,0,1995,NA,NA,645,383,262,139,35,104,0.27,0.13,0.22,7424,73,274,0
102377,TUSKEGEE UNIVERSITY,1,0,1996,NA,NA,810,497,313,180,34,146,0.29,0.11,0.22,8020,72,256,1
102377,TUSKEGEE UNIVERSITY,1,0,1997,NA,NA,713,466,247,179,29,150,0.32,0.12,0.25,8662,68,227,0
102377,TUSKEGEE UNIVERSITY,1,0,1998,NA,NA,683,412,271,154,37,117,0.28,0.14,0.23,9060,84,231,0
102377,TUSKEGEE UNIVERSITY,1,0,1999,NA,NA,679,400,279,119,27,92,0.23,0.1,0.18,9500,79,231,0
102377,TUSKEGEE UNIVERSITY,1,0,2000,NA,NA,591,354,237,149,37,112,0.31,0.16,0.25,9928,86,233,0
102377,TUSKEGEE UNIVERSITY,1,0,2001,NA,NA,645,375,270,108,41,67,0.17,0.15,0.17,10326,90,236,0
102377,TUSKEGEE UNIVERSITY,1,0,2002,NA,NA,738,426,312,168,36,132,0.3,0.12,0.23,10584,92,271,0
102377,TUSKEGEE UNIVERSITY,1,0,2003,NA,NA,528,272,256,82,32,50,0.18,0.12,0.16,11060,101,261,0
102377,TUSKEGEE UNIVERSITY,1,0,2004,NA,NA,701,389,312,123,35,88,0.22,0.11,0.18,11290,101,215,3
102377,Tuskegee University,1,0,2005,NA,NA,730,385,345,112,30,82,0.21,0.09,0.15,11690,102,232,2
102377,Tuskegee University,1,0,2006,NA,NA,688,395,293,151,33,118,0.29,0.11,0.22,12400,102,275,2
102377,Tuskegee University,1,0,2007,NA,NA,796,444,352,133,31,102,0.22,0.09,0.17,13520,104,291,2
102377,Tuskegee University,1,0,2008,NA,NA,722,414,308,154,44,110,0.26,0.14,0.21,14740,109,269,1
102377,Tuskegee University,1,0,2009,NA,NA,688,410,278,123,25,98,0.23,0.09,0.18,15630,115,273,2
102377,Tuskegee University,1,0,2010,NA,NA,701,393,308,228,99,129,0.32,0.32,0.33,16100,119,281,0
104151,ARIZONA STATE UNIVERSITY,1,0,1991,NA,NA,2447,1214,1233,442,174,268,0.22,0.14,0.18,1528,473,1514,1864
104151,ARIZONA STATE UNIVERSITY,1,0,1992,NA,NA,2901,1503,1398,452,162,290,0.19,0.12,0.16,1590,473,1556,2149
104151,ARIZONA STATE UNIVERSITY-MAIN CAMPUS,1,0,1993,NA,NA,3298,1637,1661,561,203,358,0.21,0.12,0.17,1844,441,1383,2489
104151,ARIZONA STATE UNIVERSITY-MAIN CAMPUS,1,0,1995,NA,NA,3945,2096,1849,854,299,555,0.26,0.16,0.22,1950,500,1499,2893
104151,ARIZONA STATE UNIVERSITY-MAIN CAMPUS,1,0,1996,NA,NA,4001,2117,1884,1028,398,630,0.29,0.21,0.26,2009,555,1487,2963
104151,ARIZONA STATE UNIVERSITY-MAIN CAMPUS,1,0,1997,NA,NA,4938,2646,2292,1284,448,836,0.31,0.2,0.26,2058,561,1530,3683
104151,ARIZONA STATE UNIVERSITY-MAIN CAMPUS,1,0,1998,NA,NA,4753,2561,2192,1270,480,790,0.3,0.22,0.27,2158,620,1569,3471
104151,ARIZONA STATE UNIVERSITY-MAIN CAMPUS,1,0,1999,NA,NA,5625,3096,2529,1505,522,983,0.31,0.21,0.27,2188,645,1554,3845
104151,ARIZONA STATE UNIVERSITY-MAIN CAMPUS,1,0,2000,NA,NA,5763,3058,2705,1615,596,1019,0.33,0.22,0.28,2272,672,1561,4179
104151,ARIZONA STATE UNIVERSITY-MAIN CAMPUS,1,0,2001,NA,NA,5950,3157,2793,1649,599,1050,0.33,0.21,0.28,2412,725,1568,4379
104151,ARIZONA STATE UNIVERSITY-MAIN CAMPUS,1,0,2002,NA,NA,6094,3323,2771,1813,661,1152,0.34,0.24,0.3,2508,724,1573,4323
104151,ARIZONA STATE UNIVERSITY-MAIN CAMPUS,1,0,2003,NA,NA,6815,3652,3163,1997,730,1267,0.34,0.23,0.29,3508,754,1565,4801
104151,ARIZONA STATE UNIVERSITY AT THE TEMPE CAMPUS,1,0,2004,NA,NA,7293,3998,3295,2324,816,1508,0.37,0.25,0.32,3973,836,1637,5111
104151,Arizona State University at the Tempe Campus,1,0,2005,NA,NA,7927,4267,3660,2561,996,1565,0.36,0.27,0.32,4311,941,1693,5361
104151,Arizona State University at the Tempe Campus,1,0,2006,NA,NA,8533,4556,3977,2837,1145,1692,0.37,0.29,0.33,4591,1032,1660,5722
104151,Arizona State University at the Tempe Campus,1,0,2007,NA,NA,7308,3775,3533,2753,1126,1627,0.43,0.32,0.38,4821,1105,1715,4900
104151,Arizona State University,1,0,2008,NA,NA,6743,3320,3423,2886,1224,1662,0.5,0.36,0.43,5409,1467,2392,4273
104151,Arizona State University,1,0,2009,NA,NA,6747,3279,3468,3054,1335,1719,0.52,0.38,0.45,5997,1465,2371,4270
104151,Arizona State University,1,0,2010,NA,NA,6210,2997,3213,3071,1409,1662,0.55,0.44,0.49,7793,1522,2416,3773
104179,UNIVERSITY OF ARIZONA,1,0,1991,NA,NA,3970,2063,1907,786,297,489,0.23,0.16,0.2,1528,653,1537,2959
104179,UNIVERSITY OF ARIZONA,1,0,1992,NA,NA,3803,1926,1877,814,302,512,0.26,0.16,0.21,1528,659,1513,2847
104179,UNIVERSITY OF ARIZONA,1,0,1993,NA,NA,4287,2254,2033,968,317,651,0.28,0.16,0.23,1778,697,1349,3124
104179,UNIVERSITY OF ARIZONA,1,0,1995,NA,NA,4370,2382,1988,1160,405,755,0.31,0.2,0.27,1884,756,1360,3116
104179,UNIVERSITY OF ARIZONA,1,0,1996,NA,NA,4006,2102,1904,1145,441,704,0.33,0.23,0.29,2009,757,1386,2899
104179,UNIVERSITY OF ARIZONA,1,0,1997,NA,NA,4431,2409,2022,1294,463,831,0.34,0.23,0.29,2058,788,1370,3213
104179,UNIVERSITY OF ARIZONA,1,0,1998,NA,NA,5088,2773,2315,1595,590,1005,0.36,0.25,0.31,2158,823,1352,3725
104179,UNIVERSITY OF ARIZONA,1,0,1999,NA,NA,5126,2745,2381,1626,623,1003,0.36,0.26,0.32,0,874,1348,3721
104179,UNIVERSITY OF ARIZONA,1,0,2000,NA,NA,5443,2924,2519,1613,618,995,0.34,0.25,0.3,0,931,1364,3984
104179,UNIVERSITY OF ARIZONA,1,0,2001,NA,NA,5727,3005,2722,1871,717,1154,0.38,0.26,0.33,0,982,1380,4087
104179,UNIVERSITY OF ARIZONA,1,0,2002,NA,NA,5613,3008,2605,1805,703,1102,0.36,0.27,0.32,0,978,1375,3946
104179,UNIVERSITY OF ARIZONA,1,0,2003,NA,NA,5780,3154,2626,1870,708,1162,0.36,0.27,0.32,3508,1048,1362,3980
104179,UNIVERSITY OF ARIZONA,1,0,2004,NA,NA,5566,3008,2558,1880,723,1157,0.38,0.28,0.34,3998,1133,1364,3704
104179,University of Arizona,1,0,2005,NA,NA,5785,3115,2670,2104,820,1284,0.41000000000000003,0.31,0.36,4394,1190,1538,3970
104179,University of Arizona,1,0,2006,NA,NA,5788,3092,2696,2085,813,1272,0.41000000000000003,0.3,0.36,4594,1262,1578,3794
104179,University of Arizona,1,0,2007,NA,NA,6231,3395,2836,2485,976,1509,0.44,0.34,0.4,4824,1323,1590,4152
104179,University of Arizona,1,0,2008,NA,NA,6331,3377,2954,2536,1017,1519,0.44,0.34,0.4,5274,1416,1593,4133
104179,University of Arizona,1,0,2009,NA,NA,6782,3697,3085,2922,1146,1776,0.48,0.37,0.43,6540,1446,1546,4241
104179,University of Arizona,1,0,2010,NA,NA,6797,3629,3168,2847,1137,1710,0.47000000000000003,0.36,0.42,7614,1466,1527,3962
105330,NORTHERN ARIZONA UNIVERSITY,1,0,1991,NA,NA,1881,1064,817,294,97,197,0.18,0.12,0.16,1528,148,623,1470
105330,NORTHERN ARIZONA UNIVERSITY,1,0,1992,NA,NA,2095,1203,892,315,104,211,0.17,0.12,0.15,1528,155,608,1645
105330,NORTHERN ARIZONA UNIVERSITY,1,0,1993,NA,NA,1930,1090,840,306,103,203,0.18,0.12,0.16,1844,162,608,1537
105330,NORTHERN ARIZONA UNIVERSITY,1,0,1995,NA,NA,2015,1120,895,436,133,303,0.27,0.15,0.22,1950,192,673,1612
105330,NORTHERN ARIZONA UNIVERSITY,1,0,1996,NA,NA,2267,1288,979,538,170,368,0.28,0.17,0.24,2009,205,637,1867
105330,NORTHERN ARIZONA UNIVERSITY,1,0,1997,NA,NA,1983,1169,814,530,154,376,0.32,0.19,0.27,2058,219,650,1676
105330,NORTHERN ARIZONA UNIVERSITY,1,0,1998,NA,NA,2073,1188,885,554,176,378,0.31,0.2,0.27,2160,234,654,1695
105330,NORTHERN ARIZONA UNIVERSITY,1,0,1999,NA,NA,2162,1278,884,562,166,396,0.3,0.19,0.26,2188,240,661,1772
105330,NORTHERN ARIZONA UNIVERSITY,1,0,2000,NA,NA,2273,1384,889,613,174,439,0.31,0.2,0.27,2272,248,684,1870
105330,NORTHERN ARIZONA UNIVERSITY,1,0,2001,NA,NA,2146,1299,847,609,169,440,0.33,0.2,0.28,2412,260,708,1769
105330,NORTHERN ARIZONA UNIVERSITY,1,0,2002,NA,NA,2153,1327,826,681,173,508,0.38,0.21,0.32,2507,267,698,1718
105330,NORTHERN ARIZONA UNIVERSITY,1,0,2003,NA,NA,2114,1249,865,644,196,448,0.35000000000000003,0.23,0.3,3508,269,711,1670
105330,NORTHERN ARIZONA UNIVERSITY,1,0,2004,NA,NA,2274,1309,965,652,190,462,0.35000000000000003,0.2,0.29,3983,279,710,1769
105330,Northern Arizona University,1,0,2005,NA,NA,2101,1268,833,645,174,471,0.37,0.21,0.31,4223,287,723,1622
105330,Northern Arizona University,1,0,2006,NA,NA,2527,1488,1039,756,224,532,0.35000000000000003,0.22,0.3,4376,321,751,1931
105330,Northern Arizona University,1,0,2007,NA,NA,2880,1676,1204,868,261,607,0.36,0.22,0.3,4594,341,767,2166
105330,Northern Arizona University,1,0,2008,NA,NA,3248,1899,1349,1078,316,762,0.4,0.23,0.33,5144,369,802,2437
105330,Northern Arizona University,1,0,2009,NA,NA,3377,1951,1426,1122,354,768,0.39,0.25,0.33,6092,368,804,2390
105330,Northern Arizona University,1,0,2010,NA,NA,3739,2209,1530,1354,442,912,0.41000000000000003,0.29,0.36,5431,369,825,2486
106245,UNIVERSITY OF ARKANSAS AT LITTLE ROCK,1,0,1991,NA,NA,941,536,405,45,14,31,0.05,0.03,0.05,1806,66,413,729
106245,UNIVERSITY OF ARKANSAS AT LITTLE ROCK,1,0,1992,NA,NA,1092,600,492,61,23,38,0.06,0.05,0.06,1902,74,387,781
106245,UNIVERSITY OF ARKANSAS AT LITTLE ROCK,1,0,1993,NA,NA,966,565,401,59,12,47,0.08,0.03,0.06,2098,85,398,613
106245,UNIVERSITY OF ARKANSAS AT LITTLE ROCK,1,0,1995,NA,NA,675,390,285,103,37,66,0.16,0.13,0.15,2368,91,367,456
106245,UNIVERSITY OF ARKANSAS AT LITTLE ROCK,1,0,1996,NA,NA,691,429,262,65,18,47,0.1,0.07,0.09,2538,94,351,437
106245,UNIVERSITY OF ARKANSAS AT LITTLE ROCK,1,0,1997,NA,NA,841,503,338,46,13,33,0.06,0.04,0.05,2538,99,362,503
106245,UNIVERSITY OF ARKANSAS AT LITTLE ROCK,1,0,1998,NA,NA,865,539,326,93,22,71,0.13,0.07,0.11,2616,100,369,506
106245,UNIVERSITY OF ARKANSAS AT LITTLE ROCK,1,0,1999,NA,NA,826,518,308,51,12,39,0.07,0.04,0.06,2424,104,371,466
106245,UNIVERSITY OF ARKANSAS AT LITTLE ROCK,1,0,2000,NA,NA,836,484,352,73,28,45,0.09,0.08,0.09,2544,111,407,424
106245,UNIVERSITY OF ARKANSAS AT LITTLE ROCK,1,0,2001,NA,NA,703,410,293,57,19,38,0.09,0.06,0.08,2664,118,444,392
106245,UNIVERSITY OF ARKANSAS AT LITTLE ROCK,1,0,2002,NA,NA,739,456,283,72,19,53,0.11,0.07,0.1,2850,135,449,419
106245,UNIVERSITY OF ARKANSAS AT LITTLE ROCK,1,0,2003,NA,NA,691,405,286,29,9,20,0.04,0.03,0.04,3024,125,488,373
106245,UNIVERSITY OF ARKANSAS AT LITTLE ROCK,1,0,2004,NA,NA,759,452,307,54,18,36,0.07,0.06,0.07,3216,129,496,410
106245,University of Arkansas at Little Rock,1,0,2005,NA,NA,762,445,317,64,24,40,0.08,0.08,0.08,3384,137,513,403
106245,University of Arkansas at Little Rock,1,0,2006,NA,NA,603,317,286,40,19,21,0.06,0.07,0.07,3552,147,505,334
106245,University of Arkansas at Little Rock,1,0,2007,NA,NA,812,471,341,57,28,29,0.06,0.08,0.07,4612,162,474,449
106245,University of Arkansas at Little Rock,1,0,2008,NA,NA,618,375,243,50,23,27,0.07,0.09,0.08,4890,165,513,345
106245,University of Arkansas at Little Rock,1,0,2009,NA,NA,674,387,287,74,27,47,0.12,0.09,0.11,5040,172,542,367
106245,University of Arkansas at Little Rock,1,0,2010,NA,NA,683,376,307,80,40,40,0.1,0.13,0.12,5228,183,507,370
106342,ARKANSAS COLLEGE,1,0,1991,NA,NA,121,79,42,48,17,31,0.39,0.4,0.4,7040,11,47,109
106342,ARKANSAS COLLEGE,1,0,1992,NA,NA,138,80,58,51,21,30,0.37,0.36,0.37,7603,11,43,118
106342,ARKANSAS COLLEGE,1,0,1993,NA,NA,166,84,82,65,29,36,0.42,0.35,0.39,8060,12,42,159
106342,LYON COLLEGE,1,0,1995,NA,NA,168,90,78,82,32,50,0.55,0.41,0.49,8990,14,45,152
106342,LYON COLLEGE,1,0,1996,NA,NA,129,69,60,60,22,38,0.55,0.37,0.47,9490,15,41,113
106342,LYON COLLEGE,1,0,1997,NA,NA,125,63,62,54,19,35,0.55,0.31,0.43,10100,15,42,110
106342,LYON COLLEGE,1,0,1998,NA,NA,107,65,42,56,21,35,0.53,0.5,0.52,10526,12,44,96
106342,LYON COLLEGE,1,0,1999,NA,NA,141,79,62,82,33,49,0.62,0.53,0.58,10272,11,42,119
106342,LYON COLLEGE,1,0,2000,NA,NA,127,71,56,74,30,44,0.61,0.54,0.58,10580,12,41,113
106342,LYON COLLEGE,1,0,2001,NA,NA,129,80,49,68,20,48,0.6,0.41,0.53,11000,13,41,116
106342,LYON COLLEGE,1,0,2002,NA,NA,113,47,66,62,33,29,0.61,0.5,0.55,11540,14,42,100
106342,LYON COLLEGE,1,0,2003,NA,NA,120,67,53,53,23,30,0.44,0.43,0.44,11990,14,44,102
106342,LYON COLLEGE,1,0,2004,NA,NA,141,66,75,62,37,25,0.37,0.49,0.44,12710,15,44,114
106342,Lyon College,1,0,2005,NA,NA,111,61,50,45,20,25,0.4,0.4,0.41,13475,15,44,100
106342,Lyon College,1,0,2006,NA,NA,128,61,67,56,27,29,0.47000000000000003,0.4,0.44,14420,16,43,106
106342,Lyon College,1,0,2007,NA,NA,143,84,59,62,19,43,0.51,0.32,0.43,15466,16,44,117
106342,Lyon College,1,0,2008,NA,NA,102,52,50,50,25,25,0.48,0.5,0.49,18500,17,44,83
106342,Lyon College,1,0,2009,NA,NA,216,114,102,75,39,36,0.31,0.38,0.35,19424,17,41,181
106342,Lyon College,1,0,2010,NA,NA,198,107,91,70,29,41,0.38,0.32,0.35,21100,16,43,154
106397,UNIVERSITY OF ARKANSAS-FAYETTEVILLE,1,0,1991,NA,NA,2327,1080,1247,381,170,211,0.19,0.14,0.16,1732,223,771,1989
106397,UNIVERSITY OF ARKANSAS-FAYETTEVILLE,1,0,1992,NA,NA,2327,1066,1261,394,165,229,0.21,0.13,0.17,1838,235,790,2047
106397,UNIVERSITY OF ARKANSAS AT FAYETTEVILLE,1,0,1993,NA,NA,2015,964,1051,401,158,243,0.25,0.15,0.2,1946,258,806,1753
106397,UNIVERSITY OF ARKANSAS AT FAYETTEVILLE,1,0,1995,NA,NA,2249,1148,1101,425,155,270,0.23,0.14,0.19,2130,262,808,1863
106397,UNIVERSITY OF ARKANSAS AT FAYETTEVILLE,1,0,1996,NA,NA,2174,1105,1069,490,184,306,0.27,0.17,0.23,2639,273,770,1784
106397,UNIVERSITY OF ARKANSAS AT FAYETTEVILLE,1,0,1997,NA,NA,2125,1077,1048,515,191,324,0.3,0.18,0.24,2896,295,828,1770
106397,UNIVERSITY OF ARKANSAS AT FAYETTEVILLE,1,0,1998,NA,NA,2456,1245,1211,665,246,419,0.33,0.2,0.27,3119,304,810,2085
106397,UNIVERSITY OF ARKANSAS AT FAYETTEVILLE,1,0,1999,NA,NA,2189,1123,1066,666,235,431,0.38,0.22,0.3,2800,328,796,1791
106397,UNIVERSITY OF ARKANSAS MAIN CAMPUS,1,0,2000,NA,NA,2179,1092,1087,645,246,399,0.36,0.23,0.3,2968,358,796,1848
106397,UNIVERSITY OF ARKANSAS MAIN CAMPUS,1,0,2001,NA,NA,2190,1126,1064,718,290,428,0.38,0.27,0.33,3116,405,797,1877
106397,UNIVERSITY OF ARKANSAS MAIN CAMPUS,1,0,2002,NA,NA,2137,1106,1031,707,284,423,0.38,0.28,0.33,3573,418,791,1792
106397,UNIVERSITY OF ARKANSAS MAIN CAMPUS,1,0,2003,NA,NA,2260,1175,1085,775,318,457,0.38,0.29,0.34,3810,452,792,1942
106397,UNIVERSITY OF ARKANSAS MAIN CAMPUS,1,0,2004,NA,NA,2420,1222,1198,835,329,506,0.41000000000000003,0.27,0.35,4115,447,797,2053
106397,University of Arkansas Main Campus,1,0,2005,NA,NA,2662,1324,1338,913,375,538,0.4,0.28,0.34,4361,474,905,2224
106397,University of Arkansas Main Campus,1,0,2006,NA,NA,2719,1346,1373,945,398,547,0.4,0.29,0.35,4590,522,922,2318
106397,University of Arkansas Main Campus,1,0,2007,NA,NA,2877,1425,1452,1055,456,599,0.42,0.31,0.37,4772,538,874,2421
106397,University of Arkansas Main Campus,1,0,2008,NA,NA,2977,1488,1489,1108,475,633,0.42,0.32,0.37,5010,586,908,2487
106397,University of Arkansas,1,0,2009,NA,NA,2890,1448,1442,1129,466,663,0.45,0.32,0.39,5010,613,908,2409
106397,University of Arkansas,1,0,2010,NA,NA,3774,1929,1845,1596,634,962,0.49,0.34,0.42,5211,634,952,3079
106412,UNIVERSITY OF ARKANSAS-PINE BLUFF,1,0,1991,NA,NA,650,393,257,55,15,40,0.1,0.06,0.08,1451,34,165,67
106412,UNIVERSITY OF ARKANSAS-PINE BLUFF,1,0,1992,NA,NA,592,341,251,27,9,18,0.05,0.04,0.05,1451,30,167,57
106412,UNIVERSITY OF ARKANSAS AT PINE BLUFF,1,0,1993,NA,NA,735,379,356,52,15,37,0.09,0.04,0.07,1584,33,192,40
106412,UNIVERSITY OF ARKANSAS AT PINE BLUFF,1,0,1995,NA,NA,565,302,263,39,11,28,0.09,0.04,0.07,1788,38,185,15
106412,UNIVERSITY OF ARKANSAS AT PINE BLUFF,1,0,1996,NA,NA,575,302,273,47,12,35,0.11,0.04,0.08,1860,40,183,7
106412,UNIVERSITY OF ARKANSAS AT PINE BLUFF,1,0,1997,NA,NA,608,297,311,51,12,39,0.13,0.04,0.08,2046,41,176,12
106412,UNIVERSITY OF ARKANSAS AT PINE BLUFF,1,0,1998,NA,NA,721,372,349,70,22,48,0.12,0.06,0.1,2082,43,175,13
106412,UNIVERSITY OF ARKANSAS AT PINE BLUFF,1,0,1999,NA,NA,656,341,315,76,20,56,0.16,0.06,0.12,2058,47,173,8
106412,UNIVERSITY OF ARKANSAS AT PINE BLUFF,1,0,2000,NA,NA,629,330,299,43,13,30,0.09,0.04,0.07,2400,51,172,11
106412,UNIVERSITY OF ARKANSAS AT PINE BLUFF,1,0,2001,NA,NA,700,371,329,97,21,76,0.2,0.06,0.14,2490,62,171,7
106412,UNIVERSITY OF ARKANSAS AT PINE BLUFF,1,0,2002,NA,NA,712,358,354,63,16,47,0.13,0.05,0.09,2664,56,168,10
106412,UNIVERSITY OF ARKANSAS AT PINE BLUFF,1,0,2003,NA,NA,731,333,398,47,12,35,0.1,0.03,0.06,2820,58,167,11
106412,UNIVERSITY OF ARKANSAS AT PINE BLUFF,1,0,2004,NA,NA,690,365,325,47,14,33,0.09,0.04,0.07,3000,60,168,10
106412,University of Arkansas at Pine Bluff,1,0,2005,NA,NA,714,349,365,74,24,50,0.14,0.07,0.1,3150,63,164,13
106412,University of Arkansas at Pine Bluff,1,0,2006,NA,NA,688,340,348,55,18,37,0.1,0.05,0.08,3300,69,160,7
106412,University of Arkansas at Pine Bluff,1,0,2007,NA,NA,786,411,375,44,10,34,0.08,0.03,0.06,3300,66,164,8
106412,University of Arkansas at Pine Bluff,1,0,2008,NA,NA,952,504,448,93,21,72,0.14,0.05,0.1,3450,68,167,11
106412,University of Arkansas at Pine Bluff,1,0,2009,NA,NA,959,523,436,67,16,51,0.09,0.04,0.07,3540,71,173,14
106412,University of Arkansas at Pine Bluff,1,0,2010,NA,NA,780,393,387,51,13,38,0.09,0.03,0.07,3750,73,171,9
106458,ARKANSAS STATE UNIVERSITY MAIN CAMPUS,1,0,1991,NA,NA,1521,833,688,147,44,103,0.12,0.06,0.1,1420,68,403,1225
106458,ARKANSAS STATE UNIVERSITY MAIN CAMPUS,1,0,1992,NA,NA,1607,855,752,164,48,116,0.13,0.06,0.1,1610,75,410,1259
106458,ARKANSAS STATE UNIVERSITY-MAIN CAMPUS,1,0,1993,NA,NA,1487,812,675,190,66,124,0.15,0.1,0.13,1810,83,393,1272
106458,ARKANSAS STATE UNIVERSITY-MAIN CAMPUS,1,0,1995,NA,NA,1448,803,645,218,65,153,0.19,0.1,0.15,1950,81,404,1213
106458,ARKANSAS STATE UNIVERSITY-MAIN CAMPUS,1,0,1996,NA,NA,1592,893,699,216,64,152,0.17,0.09,0.14,1970,87,405,1320
106458,ARKANSAS STATE UNIVERSITY-MAIN CAMPUS,1,0,1997,NA,NA,1687,922,765,249,89,160,0.17,0.12,0.15,2280,93,435,1399
106458,ARKANSAS STATE UNIVERSITY-MAIN CAMPUS,1,0,1998,NA,NA,1705,928,777,270,68,202,0.21,0.09,0.16,2804,99,422,1393
106458,ARKANSAS STATE UNIVERSITY-MAIN CAMPUS,1,0,1999,NA,NA,1654,937,717,303,92,211,0.22,0.13,0.18,2352,108,422,1347
106458,ARKANSAS STATE UNIVERSITY-MAIN CAMPUS,1,0,2000,NA,NA,1591,893,698,307,97,210,0.23,0.14,0.19,2520,118,425,1301
106458,ARKANSAS STATE UNIVERSITY-MAIN CAMPUS,1,0,2001,NA,NA,1594,921,673,309,86,223,0.24,0.13,0.19,3360,125,429,1325
106458,ARKANSAS STATE UNIVERSITY-MAIN CAMPUS,1,0,2002,NA,NA,1539,813,726,291,109,182,0.22,0.15,0.19,3570,131,432,1254
106458,ARKANSAS STATE UNIVERSITY-MAIN CAMPUS,1,0,2003,NA,NA,1426,798,628,233,70,163,0.2,0.11,0.16,3750,127,446,1111
106458,ARKANSAS STATE UNIVERSITY-MAIN CAMPUS,1,0,2004,NA,NA,1296,749,547,212,71,141,0.18,0.13,0.16,4035,134,454,907
106458,Arkansas State University-Main Campus,1,0,2005,NA,NA,1483,826,657,288,108,180,0.21,0.16,0.19,4260,141,447,1068
106458,Arkansas State University-Main Campus,1,0,2006,NA,NA,1659,946,713,345,124,221,0.23,0.17,0.21,4470,145,485,1232
106458,Arkansas State University-Main Campus,1,0,2007,NA,NA,1655,962,693,309,102,207,0.21,0.15,0.19,4620,154,490,1203
106458,Arkansas State University-Main Campus,1,0,2008,NA,NA,1743,981,762,352,129,223,0.22,0.17,0.2,4890,163,461,1037
106458,Arkansas State University-Main Campus,1,0,2009,NA,NA,1645,874,771,349,154,195,0.22,0.2,0.21,4890,178,482,987
106458,Arkansas State University-Main Campus,1,0,2010,NA,NA,1659,897,762,438,167,271,0.3,0.22,0.26,5100,182,482,1152
106467,ARKANSAS TECH UNIVERSITY,1,0,1991,NA,NA,761,403,358,103,32,71,0.17,0.09,0.14,1460,26,176,728
106467,ARKANSAS TECH UNIVERSITY,1,0,1992,NA,NA,812,438,374,112,33,79,0.18,0.09,0.14,1560,28,180,773
106467,ARKANSAS TECH UNIVERSITY,1,0,1993,NA,NA,847,404,443,117,43,74,0.18,0.1,0.14,1710,31,180,800
106467,ARKANSAS TECH UNIVERSITY,1,0,1995,NA,NA,756,386,370,133,46,87,0.22,0.12,0.18,1910,34,181,705
106467,ARKANSAS TECH UNIVERSITY,1,0,1996,NA,NA,668,339,329,94,40,54,0.15,0.12,0.14,1992,35,185,619
106467,ARKANSAS TECH UNIVERSITY,1,0,1997,NA,NA,725,376,349,83,32,51,0.13,0.09,0.11,2126,35,187,664
106467,ARKANSAS TECH UNIVERSITY,1,0,1998,NA,NA,821,401,420,105,41,64,0.15,0.1,0.13,2288,37,186,754
106467,ARKANSAS TECH UNIVERSITY,1,0,1999,NA,NA,1055,508,547,146,55,91,0.17,0.1,0.14,2352,40,192,966
106467,ARKANSAS TECH UNIVERSITY,1,0,2000,NA,NA,1124,593,531,205,70,135,0.22,0.13,0.18,2588,47,201,1030
106467,ARKANSAS TECH UNIVERSITY,1,0,2001,NA,NA,1202,564,638,235,108,127,0.22,0.17,0.2,2796,50,210,1086
106467,ARKANSAS TECH UNIVERSITY,1,0,2002,NA,NA,1169,624,545,207,80,127,0.2,0.15,0.18,3076,51,209,1058
106467,ARKANSAS TECH UNIVERSITY,1,0,2003,NA,NA,1445,723,722,248,96,152,0.21,0.13,0.17,3312,52,229,1312
106467,ARKANSAS TECH UNIVERSITY,1,0,2004,NA,NA,1398,728,670,199,72,127,0.17,0.11,0.14,3696,60,240,1226
106467,Arkansas Tech University,1,0,2005,NA,NA,1457,714,743,253,104,149,0.2,0.14,0.17,3432,64,252,1265
106467,Arkansas Tech University,1,0,2006,NA,NA,1426,711,715,234,83,151,0.21,0.12,0.16,3576,74,265,1209
106467,Arkansas Tech University,1,0,2007,NA,NA,1548,762,786,278,131,147,0.19,0.17,0.18,3672,79,277,1300
106467,Arkansas Tech University,1,0,2008,NA,NA,1450,763,687,305,115,190,0.24,0.17,0.21,3864,87,290,1272
106467,Arkansas Tech University,1,0,2009,NA,NA,1744,882,862,375,139,236,0.26,0.16,0.22,4008,88,294,1517
106467,Arkansas Tech University,1,0,2010,NA,NA,1681,823,858,259,105,154,0.18,0.12,0.15,4080,97,290,1383
106485,UNIVERSITY OF ARKANSAS-MONTICELLO,1,0,1991,NA,NA,478,256,222,33,13,20,0.07,0.06,0.07,1500,15,107,387
106485,UNIVERSITY OF ARKANSAS-MONTICELLO,1,0,1992,NA,NA,581,302,279,53,15,38,0.12,0.05,0.09,1500,18,116,459
106485,UNIVERSITY OF ARKANSAS AT MONTICELLO,1,0,1993,NA,NA,508,249,259,31,12,19,0.07,0.05,0.06,1500,18,117,399
106485,UNIVERSITY OF ARKANSAS AT MONTICELLO,1,0,1995,NA,NA,489,254,235,46,14,32,0.12,0.06,0.09,1786,19,118,387
106485,UNIVERSITY OF ARKANSAS AT MONTICELLO,1,0,1996,NA,NA,453,240,213,44,19,25,0.1,0.09,0.1,1906,20,112,373
106485,UNIVERSITY OF ARKANSAS AT MONTICELLO,1,0,1997,NA,NA,620,342,278,47,8,39,0.11,0.03,0.08,2145,19,107,486
106485,UNIVERSITY OF ARKANSAS AT MONTICELLO,1,0,1998,NA,NA,558,292,266,52,18,34,0.11,0.07,0.09,2330,21,114,423
106485,UNIVERSITY OF ARKANSAS AT MONTICELLO,1,0,1999,NA,NA,685,370,315,53,15,38,0.1,0.05,0.08,2100,22,113,465
106485,UNIVERSITY OF ARKANSAS AT MONTICELLO,1,0,2000,NA,NA,628,346,282,51,17,34,0.09,0.06,0.08,2250,24,113,447
106485,UNIVERSITY OF ARKANSAS AT MONTICELLO,1,0,2001,NA,NA,654,382,272,51,15,36,0.09,0.06,0.08,2370,26,114,465
106485,UNIVERSITY OF ARKANSAS AT MONTICELLO,1,0,2002,NA,NA,645,368,277,46,14,32,0.08,0.05,0.07,2490,24,119,440
106485,UNIVERSITY OF ARKANSAS AT MONTICELLO,1,0,2003,NA,NA,674,371,303,57,25,32,0.08,0.08,0.08,2700,24,152,432
106485,UNIVERSITY OF ARKANSAS AT MONTICELLO,1,0,2004,NA,NA,629,327,302,60,25,35,0.1,0.08,0.1,2850,31,134,394
106485,University of Arkansas at Monticello,1,0,2005,NA,NA,625,337,288,55,20,35,0.1,0.07,0.09,3000,32,145,373
106485,University of Arkansas at Monticello,1,0,2006,NA,NA,630,335,295,71,28,43,0.12,0.09,0.11,3150,33,150,407
106485,University of Arkansas at Monticello,1,0,2007,NA,NA,617,303,314,52,19,33,0.1,0.06,0.08,3240,35,149,413
106485,University of Arkansas at Monticello,1,0,2008,NA,NA,661,361,300,89,33,56,0.15,0.11,0.13,3420,38,146,457
106485,University of Arkansas at Monticello,1,0,2009,NA,NA,740,373,367,63,16,47,0.12,0.04,0.09,3510,38,148,440
106485,University of Arkansas at Monticello,1,0,2010,NA,NA,689,338,351,69,30,39,0.11,0.09,0.1,3600,40,151,374
106704,UNIVERSITY OF CENTRAL ARKANSAS,1,0,1991,NA,NA,1961,1129,832,171,46,125,0.11,0.06,0.09,1370,50,325,1538
106704,UNIVERSITY OF CENTRAL ARKANSAS,1,0,1992,NA,NA,1948,1150,798,352,116,236,0.2,0.15,0.18,1546,58,337,1535
106704,UNIVERSITY OF CENTRAL ARKANSAS,1,0,1993,NA,NA,1792,1098,694,283,94,189,0.17,0.14,0.16,1730,65,340,1388
106704,UNIVERSITY OF CENTRAL ARKANSAS,1,0,1995,NA,NA,1469,920,549,207,46,161,0.17,0.08,0.14,2010,76,356,1218
106704,UNIVERSITY OF CENTRAL ARKANSAS,1,0,1996,NA,NA,1478,928,550,239,69,170,0.18,0.13,0.16,2392,84,367,1211
106704,UNIVERSITY OF CENTRAL ARKANSAS,1,0,1997,NA,NA,1598,1031,567,284,55,229,0.22,0.1,0.18,2692,76,377,1335
106704,UNIVERSITY OF CENTRAL ARKANSAS,1,0,1998,NA,NA,1575,944,631,249,58,191,0.2,0.09,0.16,3038,80,370,1302
106704,UNIVERSITY OF CENTRAL ARKANSAS,1,0,1999,NA,NA,1729,1030,699,272,86,186,0.18,0.12,0.16,2758,84,376,1413
106704,UNIVERSITY OF CENTRAL ARKANSAS,1,0,2000,NA,NA,1627,982,645,325,80,245,0.24,0.12,0.2,2856,94,391,1286
106704,UNIVERSITY OF CENTRAL ARKANSAS,1,0,2001,NA,NA,1668,1028,640,367,102,265,0.25,0.16,0.22,3060,95,407,1229
106704,UNIVERSITY OF CENTRAL ARKANSAS,1,0,2002,NA,NA,1766,1062,704,389,108,281,0.26,0.15,0.22,3312,105,413,1331
106704,UNIVERSITY OF CENTRAL ARKANSAS,1,0,2003,NA,NA,2414,1450,964,527,165,362,0.24,0.17,0.22,3770,98,462,1741
106704,UNIVERSITY OF CENTRAL ARKANSAS,1,0,2004,NA,NA,2216,1313,903,468,131,337,0.25,0.15,0.21,4060,112,450,1656
106704,University of Central Arkansas,1,0,2005,NA,NA,2429,1376,1053,467,136,331,0.24,0.13,0.19,4500,120,478,1641
106704,University of Central Arkansas,1,0,2006,NA,NA,2352,1340,1012,538,187,351,0.26,0.18,0.23,4695,143,514,1532
106704,University of Central Arkansas,1,0,2007,NA,NA,1763,1054,709,362,118,244,0.23,0.17,0.21,4830,160,510,1247
106704,University of Central Arkansas,1,0,2008,NA,NA,2075,1165,910,444,157,287,0.24,0.17,0.21,5100,166,510,1435
106704,University of Central Arkansas,1,0,2009,NA,NA,1753,1023,730,403,136,267,0.26,0.19,0.23,5205,173,512,1221
106704,University of Central Arkansas,1,0,2010,NA,NA,1828,1070,758,445,155,290,0.27,0.2,0.24,5235,174,515,1194
107044,HARDING UNIVERSITY,1,0,1991,NA,NA,673,383,290,192,65,127,0.33,0.22,0.29,5205,38,163,600
107044,HARDING UNIVERSITY,1,0,1992,NA,NA,818,434,384,238,91,147,0.33,0.24,0.29,5460,41,167,688
107044,HARDING UNIVERSITY,1,0,1993,NA,NA,793,437,356,244,101,143,0.32,0.28,0.31,5790,42,179,696
107044,HARDING UNIVERSITY,1,0,1995,NA,NA,779,437,342,250,92,158,0.36,0.27,0.32,6420,49,173,696
107044,HARDING UNIVERSITY,1,0,1996,NA,NA,846,497,349,266,85,181,0.36,0.24,0.31,6825,53,178,753
107044,HARDING UNIVERSITY,1,0,1997,NA,NA,863,495,368,271,85,186,0.37,0.23,0.31,7230,47,179,707
107044,HARDING UNIVERSITY,1,0,1998,NA,NA,908,535,373,285,101,184,0.34,0.27,0.31,7530,51,182,793
107044,HARDING UNIVERSITY,1,0,1999,NA,NA,941,488,453,313,130,183,0.37,0.29,0.33,7755,54,178,814
107044,HARDING UNIVERSITY,1,0,2000,NA,NA,975,557,418,365,137,228,0.4,0.33,0.37,8175,57,185,849
107044,HARDING UNIVERSITY,1,0,2001,NA,NA,979,547,432,365,145,220,0.4,0.34,0.37,8730,62,193,851
107044,HARDING UNIVERSITY,1,0,2002,NA,NA,1011,580,431,383,138,245,0.42,0.32,0.38,9180,67,194,879
107044,HARDING UNIVERSITY,1,0,2003,NA,NA,966,543,423,369,132,237,0.43,0.31,0.38,9720,67,200,859
107044,HARDING UNIVERSITY,1,0,2004,NA,NA,961,516,445,387,161,226,0.43,0.36,0.4,10380,70,211,855
107044,Harding University,1,0,2005,NA,NA,955,527,428,396,132,264,0.5,0.31,0.41,10800,74,223,837
107044,Harding University,1,0,2006,NA,NA,901,477,424,365,134,231,0.48,0.32,0.41,11250,80,231,783
107044,Harding University,1,0,2007,NA,NA,960,549,411,388,124,264,0.48,0.3,0.4,11940,86,249,833
107044,Harding University,1,0,2008,NA,NA,980,537,443,425,158,267,0.49,0.36,0.43,12690,92,251,870
107044,Harding University,1,0,2009,NA,NA,950,530,420,430,143,287,0.54,0.34,0.45,13140,96,259,788
107044,Harding University,1,0,2010,NA,NA,988,506,482,426,177,249,0.49,0.37,0.43,13590,97,263,848
107080,HENDRIX COLLEGE,0,1,1991,2002,0,281,146,135,141,67,74,0.5,0.5,0.5,7150,15,65,257
107080,HENDRIX COLLEGE,0,1,1992,2002,0,335,183,152,174,76,98,0.53,0.5,0.52,7710,15,66,299
107080,HENDRIX COLLEGE,0,1,1993,2002,0,273,165,108,152,58,94,0.56,0.54,0.56,8410,16,65,242
107080,HENDRIX COLLEGE,0,1,1995,2002,0,273,166,107,148,58,90,0.54,0.54,0.54,9325,18,68,248
107080,HENDRIX COLLEGE,0,1,1996,2002,0,306,185,121,188,78,110,0.59,0.64,0.61,9750,18,69,264
107080,HENDRIX COLLEGE,0,1,1997,2002,0,329,193,136,184,76,108,0.55,0.56,0.56,10280,19,71,275
107080,HENDRIX COLLEGE,0,1,1998,2002,0,320,166,154,196,89,107,0.64,0.58,0.61,10835,20,67,239
107080,HENDRIX COLLEGE,0,1,1999,2002,0,330,181,149,183,74,109,0.6,0.5,0.55,11440,22,71,271
107080,HENDRIX COLLEGE,0,1,2000,2002,0,326,173,153,194,85,109,0.63,0.56,0.6,12340,24,75,254
107080,HENDRIX COLLEGE,0,1,2001,2002,0,279,164,115,157,49,108,0.65,0.43,0.56,13071,27,79,191
107080,HENDRIX COLLEGE,1,0,2002,2002,1,317,184,133,199,73,126,0.68,0.55,0.63,14900,27,81,216
107080,HENDRIX COLLEGE,1,0,2003,2002,1,267,155,112,157,63,94,0.6,0.56,0.59,15630,30,81,183
107080,HENDRIX COLLEGE,1,0,2004,2002,1,295,165,130,159,69,90,0.54,0.53,0.54,16510,29,83,223
107080,Hendrix College,1,0,2005,2002,1,280,156,124,179,73,106,0.67,0.59,0.64,19508,31,85,236
107080,Hendrix College,1,0,2006,2002,1,396,222,174,251,99,152,0.68,0.57,0.63,20679,33,90,324
107080,Hendrix College,1,0,2007,2002,1,365,194,171,231,99,132,0.68,0.58,0.63,22125,31,90,305
107080,Hendrix College,1,0,2008,2002,1,430,238,192,284,122,162,0.68,0.64,0.66,23570,40,103,351
107080,Hendrix College,1,0,2009,2002,1,412,245,167,265,107,158,0.64,0.64,0.64,28713,44,109,315
107080,Hendrix College,1,0,2010,2002,1,403,237,166,259,96,163,0.68,0.58,0.64,30410,42,109,283
107141,JOHN BROWN UNIVERSITY,1,0,1991,NA,NA,219,123,96,65,29,36,0.29,0.3,0.3,5390,12,57,180
107141,JOHN BROWN UNIVERSITY,1,0,1992,NA,NA,196,109,87,70,31,39,0.35000000000000003,0.36,0.36,5930,13,58,154
107141,JOHN BROWN UNIVERSITY,1,0,1993,NA,NA,245,139,106,76,29,47,0.33,0.27,0.31,6390,13,60,213
107141,JOHN BROWN UNIVERSITY,1,0,1995,NA,NA,224,115,109,71,28,43,0.37,0.26,0.32,7650,17,64,210
107141,JOHN BROWN UNIVERSITY,1,0,1996,NA,NA,266,148,118,101,37,64,0.43,0.31,0.38,8308,18,62,240
107141,JOHN BROWN UNIVERSITY,1,0,1997,NA,NA,225,121,104,83,37,46,0.38,0.36,0.37,9120,16,62,199
107141,JOHN BROWN UNIVERSITY,1,0,1998,NA,NA,250,138,112,112,44,68,0.49,0.39,0.45,9802,17,65,209
107141,JOHN BROWN UNIVERSITY,1,0,1999,NA,NA,267,149,118,113,39,74,0.49,0.33,0.42,10232,18,71,225
107141,JOHN BROWN UNIVERSITY,1,0,2000,NA,NA,276,164,112,140,51,89,0.54,0.46,0.51,11022,20,73,229
107141,JOHN BROWN UNIVERSITY,1,0,2001,NA,NA,241,149,92,132,50,82,0.55,0.54,0.55,11892,22,75,202
107141,JOHN BROWN UNIVERSITY,1,0,2002,NA,NA,303,186,117,176,64,112,0.6,0.55,0.58,12464,24,73,251
107141,JOHN BROWN UNIVERSITY,1,0,2003,NA,NA,274,140,134,145,68,77,0.55,0.51,0.53,13076,27,80,227
107141,JOHN BROWN UNIVERSITY,1,0,2004,NA,NA,296,156,140,155,67,88,0.56,0.48,0.52,13724,29,80,240
107141,John Brown University,1,0,2005,NA,NA,262,132,130,143,71,72,0.54,0.55,0.55,14544,31,83,227
107141,John Brown University,1,0,2006,NA,NA,326,168,158,190,78,112,0.66,0.49,0.58,15412,32,80,279
107141,John Brown University,1,0,2007,NA,NA,361,206,155,200,81,119,0.5700000000000001,0.52,0.55,16396,36,79,303
107141,John Brown University,1,0,2008,NA,NA,307,165,142,160,72,88,0.53,0.51,0.52,17256,37,81,250
107141,John Brown University,1,0,2009,NA,NA,305,170,135,167,62,105,0.61,0.46,0.55,18032,37,82,250
107141,John Brown University,1,0,2010,NA,NA,322,175,147,180,82,98,0.56,0.56,0.56,18844,39,83,265
107512,OUACHITA BAPTIST UNIVERSITY,1,0,1991,NA,NA,338,182,156,115,44,71,0.39,0.28,0.34,5370,13,86,312
107512,OUACHITA BAPTIST UNIVERSITY,1,0,1992,NA,NA,296,148,148,121,36,85,0.5700000000000001,0.24,0.41,5800,13,91,264
107512,OUACHITA BAPTIST UNIVERSITY,1,0,1993,NA,NA,443,217,226,174,86,88,0.4,0.38,0.39,6230,14,97,404
107512,OUACHITA BAPTIST UNIVERSITY,1,0,1995,NA,NA,380,206,174,173,75,98,0.47000000000000003,0.43,0.46,7070,18,104,351
107512,OUACHITA BAPTIST UNIVERSITY,1,0,1996,NA,NA,451,237,214,184,69,115,0.48,0.32,0.41,7650,18,98,433
107512,OUACHITA BAPTIST UNIVERSITY,1,0,1997,NA,NA,404,230,174,164,59,105,0.45,0.34,0.41,8090,25,108,359
107512,OUACHITA BAPTIST UNIVERSITY,1,0,1998,NA,NA,362,220,142,120,36,84,0.38,0.25,0.33,8550,26,108,336
107512,OUACHITA BAPTIST UNIVERSITY,1,0,1999,NA,NA,443,256,187,197,72,125,0.48,0.39,0.44,8850,21,103,405
107512,OUACHITA BAPTIST UNIVERSITY,1,0,2000,NA,NA,440,247,193,187,69,118,0.47000000000000003,0.36,0.42,9800,29,106,404
107512,OUACHITA BAPTIST UNIVERSITY,1,0,2001,NA,NA,400,214,186,183,73,110,0.51,0.39,0.46,11800,33,109,371
107512,OUACHITA BAPTIST UNIVERSITY,1,0,2002,NA,NA,396,229,167,166,64,102,0.44,0.38,0.42,11800,36,117,360
107512,OUACHITA BAPTIST UNIVERSITY,1,0,2003,NA,NA,343,195,148,140,52,88,0.45,0.35,0.41,12013,28,113,308
107512,OUACHITA BAPTIST UNIVERSITY,1,0,2004,NA,NA,380,223,157,170,49,121,0.54,0.31,0.45,13023,29,108,338
107512,Ouachita Baptist University,1,0,2005,NA,NA,365,213,152,181,66,115,0.53,0.43,0.5,14218,31,114,327
107512,Ouachita Baptist University,1,0,2006,NA,NA,367,190,177,185,73,112,0.58,0.41,0.5,15235,31,119,322
107512,Ouachita Baptist University,1,0,2007,NA,NA,372,202,170,179,60,119,0.58,0.35,0.48,16158,34,115,334
107512,Ouachita Baptist University,1,0,2008,NA,NA,404,220,184,205,80,125,0.56,0.43,0.51,17058,34,112,347
107512,Ouachita Baptist University,1,0,2009,NA,NA,389,198,191,208,84,124,0.62,0.44,0.53,18038,34,113,326
107512,Ouachita Baptist University,1,0,2010,NA,NA,450,243,207,264,102,162,0.66,0.49,0.59,18805,36,107,401
107558,UNIVERSITY OF THE OZARKS,1,0,1991,NA,NA,90,52,38,9,4,5,0.09,0.11,0.1,3520,8,40,83
107558,UNIVERSITY OF THE OZARKS,1,0,1992,NA,NA,120,53,67,11,7,4,0.07,0.1,0.09,4220,8,40,109
107558,UNIVERSITY OF THE OZARKS,1,0,1993,NA,NA,162,96,66,37,15,22,0.22,0.23,0.23,4920,8,43,144
107558,UNIVERSITY OF THE OZARKS,1,0,1995,NA,NA,133,66,67,29,14,15,0.22,0.21,0.22,6540,10,36,110
107558,UNIVERSITY OF THE OZARKS,1,0,1996,NA,NA,110,52,58,37,14,23,0.44,0.24,0.34,7140,10,33,93
107558,UNIVERSITY OF THE OZARKS,1,0,1997,NA,NA,155,66,89,44,21,23,0.34,0.24,0.28,7390,7,31,136
107558,UNIVERSITY OF THE OZARKS,1,0,1998,NA,NA,137,69,68,43,18,25,0.36,0.26,0.31,7990,8,31,102
107558,UNIVERSITY OF THE OZARKS,1,0,1999,NA,NA,164,93,71,53,17,36,0.38,0.24,0.32,8290,9,33,119
107558,UNIVERSITY OF THE OZARKS,1,0,2000,NA,NA,166,100,66,52,17,35,0.35000000000000003,0.26,0.31,8830,10,37,141
107558,UNIVERSITY OF THE OZARKS,1,0,2001,NA,NA,190,116,74,61,22,39,0.33,0.3,0.32,9348,12,41,151
107558,UNIVERSITY OF THE OZARKS,1,0,2002,NA,NA,200,97,103,60,28,32,0.32,0.27,0.3,10282,13,43,156
107558,UNIVERSITY OF THE OZARKS,1,0,2003,NA,NA,206,113,93,63,20,43,0.38,0.22,0.31,11520,15,44,145
107558,UNIVERSITY OF THE OZARKS,1,0,2004,NA,NA,134,74,60,44,18,26,0.35000000000000003,0.3,0.33,12902,15,43,106
107558,University of the Ozarks,1,0,2005,NA,NA,168,89,79,48,19,29,0.32,0.24,0.29,13740,14,44,117
107558,University of the Ozarks,1,0,2006,NA,NA,164,80,84,59,29,30,0.37,0.35,0.36,14470,15,44,109
107558,University of the Ozarks,1,0,2007,NA,NA,178,102,76,61,17,44,0.43,0.22,0.34,15630,16,46,132
107558,University of the Ozarks,1,0,2008,NA,NA,195,113,82,72,27,45,0.39,0.33,0.37,16730,17,48,152
107558,University of the Ozarks,1,0,2009,NA,NA,152,72,80,39,12,27,0.37,0.15,0.26,18300,17,47,110
107558,University of the Ozarks,1,0,2010,NA,NA,204,114,90,61,28,33,0.28,0.31,0.3,19930,18,49,152
110097,BIOLA UNIVERSITY,1,0,1991,NA,NA,391,256,135,155,45,110,0.42,0.33,0.4,9902,36,121,296
110097,BIOLA UNIVERSITY,1,0,1992,NA,NA,464,290,174,176,64,112,0.38,0.37,0.38,10756,37,131,331
110097,BIOLA UNIVERSITY,1,0,1993,NA,NA,444,286,158,157,48,109,0.38,0.3,0.35,11388,42,126,301
110097,BIOLA UNIVERSITY,1,0,1995,NA,NA,407,278,129,168,45,123,0.44,0.35,0.41,12652,44,121,299
110097,BIOLA UNIVERSITY,1,0,1996,NA,NA,407,268,139,184,62,122,0.45,0.45,0.45,13408,47,125,309
110097,BIOLA UNIVERSITY,1,0,1997,NA,NA,437,296,141,204,60,144,0.48,0.43,0.47,14286,41,133,338
110097,BIOLA UNIVERSITY,1,0,1998,NA,NA,469,313,156,227,75,152,0.48,0.48,0.48,15214,45,130,368
110097,BIOLA UNIVERSITY,1,0,1999,NA,NA,563,373,190,370,123,247,0.66,0.65,0.66,15914,49,143,426
110097,BIOLA UNIVERSITY,1,0,2000,NA,NA,608,409,199,326,88,238,0.58,0.44,0.54,16630,51,149,498
110097,BIOLA UNIVERSITY,1,0,2001,NA,NA,649,426,223,360,113,247,0.5700000000000001,0.51,0.55,17410,55,155,514
110097,BIOLA UNIVERSITY,1,0,2002,NA,NA,656,414,242,345,108,237,0.5700000000000001,0.45,0.53,18456,64,162,525
110097,BIOLA UNIVERSITY,1,0,2003,NA,NA,685,459,226,348,104,244,0.53,0.46,0.51,19564,74,174,553
110097,BIOLA UNIVERSITY,1,0,2004,NA,NA,691,443,248,346,120,226,0.51,0.48,0.5,20932,80,175,494
110097,Biola University,1,0,2005,NA,NA,670,416,254,337,111,226,0.54,0.44,0.5,22602,89,184,467
110097,Biola University,1,0,2006,NA,NA,799,521,278,364,102,262,0.5,0.37,0.46,23782,98,198,553
110097,Biola University,1,0,2007,NA,NA,789,514,275,385,118,267,0.51,0.43,0.49,24998,106,205,536
110097,Biola University,1,0,2008,NA,NA,846,530,316,430,157,273,0.51,0.5,0.51,26424,117,212,563
110097,Biola University,1,0,2009,NA,NA,775,508,267,402,131,271,0.53,0.49,0.52,27744,119,218,489
110097,Biola University,1,0,2010,NA,NA,877,560,317,471,159,312,0.55,0.5,0.54,28852,120,226,498
110404,CALIFORNIA INSTITUTE OF TECHNOLOGY,0,1,1991,Inf,0,225,73,152,146,99,47,0.64,0.65,0.65,14230,1334,253,126
110404,CALIFORNIA INSTITUTE OF TECHNOLOGY,0,1,1992,Inf,0,233,60,173,165,119,46,0.76,0.69,0.71,15080,1357,247,132
110404,CALIFORNIA INSTITUTE OF TECHNOLOGY,0,1,1993,Inf,0,209,63,146,151,109,42,0.66,0.75,0.72,16030,1325,257,117
110404,CALIFORNIA INSTITUTE OF TECHNOLOGY,0,1,1995,Inf,0,218,52,166,156,108,48,0.92,0.65,0.72,17370,1311,260,145
110404,CALIFORNIA INSTITUTE OF TECHNOLOGY,0,1,1996,Inf,0,216,64,152,156,112,44,0.68,0.74,0.72,18000,1322,266,140
110404,CALIFORNIA INSTITUTE OF TECHNOLOGY,0,1,1997,Inf,0,217,64,153,169,119,50,0.78,0.78,0.78,18736,1663,258,127
110404,CALIFORNIA INSTITUTE OF TECHNOLOGY,0,1,1998,Inf,0,254,79,175,195,136,59,0.74,0.78,0.77,19166,345,256,153
110404,CALIFORNIA INSTITUTE OF TECHNOLOGY,0,1,1999,Inf,0,234,83,151,195,126,69,0.8300000000000001,0.83,0.83,19260,1720,252,150
110404,CALIFORNIA INSTITUTE OF TECHNOLOGY,0,1,2000,Inf,0,205,74,131,166,107,59,0.79,0.82,0.81,19743,1671,280,110
110404,CALIFORNIA INSTITUTE OF TECHNOLOGY,0,1,2001,Inf,0,214,78,136,175,110,65,0.8300000000000001,0.81,0.82,20904,1817,308,109
110404,CALIFORNIA INSTITUTE OF TECHNOLOGY,0,1,2002,Inf,0,252,73,179,203,138,65,0.89,0.77,0.81,21903,1898,301,148
110404,CALIFORNIA INSTITUTE OF TECHNOLOGY,0,1,2003,Inf,0,190,64,126,138,90,48,0.75,0.71,0.73,23901,1899,310,89
110404,CALIFORNIA INSTITUTE OF TECHNOLOGY,0,1,2004,Inf,0,207,59,148,167,117,50,0.84,0.79,0.81,25335,2098,309,115
110404,California Institute of Technology,0,1,2005,Inf,0,233,69,164,178,127,51,0.73,0.77,0.76,27309,2135,311,105
110404,California Institute of Technology,0,1,2006,Inf,0,210,60,150,166,113,53,0.88,0.75,0.79,28515,2094,324,79
110404,California Institute of Technology,0,1,2007,Inf,0,231,86,145,190,117,73,0.84,0.81,0.82,29940,2287,320,97
110404,California Institute of Technology,0,1,2008,Inf,0,236,97,139,200,112,88,0.9,0.81,0.85,31437,2349,322,93
110404,California Institute of Technology,0,1,2009,Inf,0,251,106,145,212,122,90,0.84,0.84,0.84,33324,2470,312,92
110404,California Institute of Technology,0,1,2010,Inf,0,220,87,133,179,105,74,0.85,0.79,0.81,34989,2299,316,78
110422,CALIFORNIA POLYTECHNIC STATE UNIV-SAN LUIS OBISPO,0,1,1991,Inf,0,1526,717,809,121,36,85,0.11,0.04,0.08,936,156,760,868
110422,CALIFORNIA POLYTECHNIC STATE UNIV-SAN LUIS OBISPO,0,1,1992,Inf,0,1295,566,729,136,37,99,0.17,0.05,0.11,1616,162,681,713
110422,CALIFORNIA POLYTECHNIC STATE UNIV-SAN LUIS OBISPO,0,1,1993,Inf,0,1600,722,878,155,36,119,0.16,0.04,0.1,1674,157,670,948
110422,CALIFORNIA POLYTECHNIC STATE UNIV-SAN LUIS OBISPO,0,1,1995,Inf,0,2418,1092,1326,356,114,242,0.22,0.09,0.15,1891,161,676,1492
110422,CALIFORNIA POLYTECHNIC STATE UNIV-SAN LUIS OBISPO,0,1,1996,Inf,0,2757,1202,1555,448,132,316,0.26,0.08,0.16,1935,165,676,1769
110422,CALIFORNIA POLYTECHNIC STATE UNIV-SAN LUIS OBISPO,0,1,1997,Inf,0,2114,951,1163,318,108,210,0.22,0.09,0.15,2228,176,691,1243
110422,CALIFORNIA POLYTECHNIC STATE UNIV-SAN LUIS OBISPO,0,1,1998,Inf,0,2260,945,1315,367,136,231,0.24,0.1,0.16,2204,180,683,1505
110422,CALIFORNIA POLYTECHNIC STATE UNIV-SAN LUIS OBISPO,0,1,1999,Inf,0,2673,1277,1396,557,167,390,0.3,0.12,0.21,0,189,695,1169
110422,CALIFORNIA POLYTECHNIC STATE UNIV-SAN LUIS OBISPO,0,1,2000,Inf,0,3053,1332,1721,607,212,395,0.29,0.12,0.2,0,267,692,1973
110422,CALIFORNIA POLYTECHNIC STATE UNIV-SAN LUIS OBISPO,0,1,2001,Inf,0,2957,1374,1583,629,220,409,0.29,0.14,0.21,0,281,690,2041
110422,CALIFORNIA POLYTECHNIC STATE UNIV-SAN LUIS OBISPO,0,1,2002,Inf,0,2565,1158,1407,587,209,378,0.32,0.15,0.23,0,225,719,1748
110422,CALIFORNIA POLYTECHNIC STATE UNIV-SAN LUIS OBISPO,0,1,2003,Inf,0,2798,1239,1559,673,264,409,0.33,0.17,0.24,0,235,698,1920
110422,CALIFORNIA POLYTECHNIC STATE UNIVERSITY-SAN LUIS OBISPO,0,1,2004,Inf,0,2900,1169,1731,767,304,463,0.39,0.18,0.26,0,236,653,1962
110422,California Polytechnic State University-San Luis Obispo,0,1,2005,Inf,0,3318,1599,1719,1021,345,676,0.42,0.2,0.31,0,232,678,2270
110422,California Polytechnic State University-San Luis Obispo,0,1,2006,Inf,0,3761,1648,2113,1044,362,682,0.41000000000000003,0.17,0.28,0,272,704,2457
110422,California Polytechnic State University-San Luis Obispo,0,1,2007,Inf,0,4419,1885,2534,1282,460,822,0.43,0.18,0.29,0,276,735,2860
110422,California Polytechnic State University-San Luis Obispo,0,1,2008,Inf,0,3448,1553,1895,1246,458,788,0.5,0.24,0.36,0,305,761,2298
110422,California Polytechnic State University-San Luis Obispo,0,1,2009,Inf,0,3877,1803,2074,1557,593,964,0.53,0.29,0.4,0,314,775,2461
110422,California Polytechnic State University-San Luis Obispo,0,1,2010,Inf,0,3459,1642,1817,1634,636,998,0.6,0.35,0.47,0,318,726,2245
110486,CALIFORNIA STATE COLLEGE-BAKERSFIELD,0,1,1991,Inf,0,363,200,163,26,16,10,0.05,0.1,0.07,936,42,218,143
110486,CALIFORNIA STATE BAKERSFIELD UNIVERSITY,0,1,1992,Inf,0,323,181,142,32,11,21,0.11,0.08,0.1,1444,44,202,117
110486,CALIFORNIA STATE UNIVERSITY-BAKERSFIELD,0,1,1993,Inf,0,317,200,117,38,12,26,0.13,0.1,0.12,1674,44,206,99
110486,CALIFORNIA STATE UNIVERSITY-BAKERSFIELD,0,1,1995,Inf,0,397,236,161,43,11,32,0.13,0.07,0.11,1891,49,209,132
110486,CALIFORNIA STATE UNIVERSITY-BAKERSFIELD,0,1,1996,Inf,0,418,253,165,56,14,42,0.16,0.08,0.13,1935,50,212,150
110486,CALIFORNIA STATE UNIVERSITY-BAKERSFIELD,0,1,1997,Inf,0,467,288,179,49,15,34,0.11,0.08,0.1,1951,53,203,169
110486,CALIFORNIA STATE UNIVERSITY-BAKERSFIELD,0,1,1998,Inf,0,471,298,173,54,9,45,0.15,0.05,0.11,1873,56,219,168
110486,CALIFORNIA STATE UNIVERSITY-BAKERSFIELD,0,1,1999,Inf,0,517,319,198,69,14,55,0.17,0.07,0.13,0,63,223,191
110486,CALIFORNIA STATE UNIVERSITY-BAKERSFIELD,0,1,2000,Inf,0,545,349,196,77,22,55,0.15,0.11,0.14,0,77,243,212
110486,CALIFORNIA STATE UNIVERSITY-BAKERSFIELD,0,1,2001,Inf,0,610,393,217,86,20,66,0.16,0.09,0.14,0,90,264,210
110486,CALIFORNIA STATE UNIVERSITY-BAKERSFIELD,0,1,2002,Inf,0,679,408,271,99,28,71,0.17,0.1,0.15,0,79,283,220
110486,CALIFORNIA STATE UNIVERSITY-BAKERSFIELD,0,1,2003,Inf,0,714,476,238,92,23,69,0.14,0.1,0.13,0,86,307,237
110486,CALIFORNIA STATE UNIVERSITY-BAKERSFIELD,0,1,2004,Inf,0,745,483,262,128,32,96,0.19,0.12,0.17,0,88,301,251
110486,California State University-Bakersfield,0,1,2005,Inf,0,766,503,263,114,21,93,0.18,0.08,0.15,0,90,303,209
110486,California State University-Bakersfield,0,1,2006,Inf,0,854,553,301,120,29,91,0.16,0.1,0.14,0,96,301,216
110486,California State University-Bakersfield,0,1,2007,Inf,0,859,578,281,129,25,104,0.17,0.09,0.15,0,105,293,208
110486,California State University-Bakersfield,0,1,2008,Inf,0,901,592,309,144,45,99,0.16,0.15,0.16,0,114,268,142
110486,California State University-Bakersfield,0,1,2009,Inf,0,1061,652,409,139,39,100,0.15,0.1,0.13,0,112,253,158
110486,California State University-Bakersfield,0,1,2010,Inf,0,1013,613,400,148,50,98,0.15,0.12,0.15,0,109,241,158
110495,CALIFORNIA STATE UNIVERSITY-STANISLAUS,1,0,1991,NA,NA,273,164,109,39,8,31,0.18,0.07,0.14,936,43,201,130
110495,CALIFORNIA STATE UNIVERSITY-STANISLAUS,1,0,1992,NA,NA,307,191,116,33,11,22,0.11,0.09,0.11,1434,43,189,133
110495,CALIFORNIA STATE UNIVERSITY-STANISLAUS,1,0,1993,NA,NA,387,232,155,60,22,38,0.16,0.14,0.16,1674,45,215,194
110495,CALIFORNIA STATE UNIVERSITY-STANISLAUS,1,0,1995,NA,NA,353,242,111,75,12,63,0.26,0.11,0.21,1891,54,235,167
110495,CALIFORNIA STATE UNIVERSITY-STANISLAUS,1,0,1996,NA,NA,381,244,137,85,22,63,0.25,0.16,0.22,1935,55,239,172
110495,CALIFORNIA STATE UNIVERSITY-STANISLAUS,1,0,1997,NA,NA,409,270,139,84,19,65,0.24,0.14,0.21,1915,58,238,191
110495,CALIFORNIA STATE UNIVERSITY-STANISLAUS,1,0,1998,NA,NA,444,297,147,84,16,68,0.22,0.11,0.19,1830,61,237,211
110495,CALIFORNIA STATE UNIVERSITY-STANISLAUS,1,0,1999,NA,NA,470,310,160,101,16,85,0.27,0.1,0.21,0,68,245,222
110495,CALIFORNIA STATE UNIVERSITY-STANISLAUS,1,0,2000,NA,NA,565,362,203,113,27,86,0.23,0.13,0.2,0,76,253,223
110495,CALIFORNIA STATE UNIVERSITY-STANISLAUS,1,0,2001,NA,NA,516,352,164,96,24,72,0.2,0.15,0.19,0,92,262,225
110495,CALIFORNIA STATE UNIVERSITY-STANISLAUS,1,0,2002,NA,NA,550,360,190,116,20,96,0.26,0.11,0.21,0,82,273,232
110495,CALIFORNIA STATE UNIVERSITY-STANISLAUS,1,0,2003,NA,NA,551,365,186,119,37,82,0.22,0.2,0.22,0,91,282,232
110495,CALIFORNIA STATE UNIVERSITY-STANISLAUS,1,0,2004,NA,NA,653,456,197,153,41,112,0.24,0.21,0.23,0,91,264,288
110495,California State University-Stanislaus,1,0,2005,NA,NA,741,511,230,151,31,120,0.23,0.13,0.2,0,89,284,288
110495,California State University-Stanislaus,1,0,2006,NA,NA,846,570,276,148,37,111,0.19,0.13,0.17,0,98,291,324
110495,California State University-Stanislaus,1,0,2007,NA,NA,910,592,318,166,34,132,0.22,0.11,0.18,0,101,309,347
110495,California State University-Stanislaus,1,0,2008,NA,NA,899,576,323,133,33,100,0.17,0.1,0.15,0,123,311,338
110495,California State University-Stanislaus,1,0,2009,NA,NA,798,555,243,124,37,87,0.15,0.15,0.16,0,125,289,258
110495,California State University-Stanislaus,1,0,2010,NA,NA,998,670,328,156,41,115,0.17,0.12,0.16,0,115,265,265
110510,CALIFORNIA STATE UNIVERSITY-SAN BERNARDINO,0,1,1991,Inf,0,815,505,310,58,17,41,0.08,0.05,0.07,936,70,415,387
110510,CALIFORNIA STATE UNIVERSITY-SAN BERNARDINO,0,1,1992,Inf,0,737,449,288,59,23,36,0.08,0.08,0.08,1443,77,399,321
110510,CALIFORNIA STATE UNIVERSITY-SAN BERNARDINO,0,1,1993,Inf,0,692,433,259,37,9,28,0.06,0.03,0.05,1674,82,397,277
110510,CALIFORNIA STATE UNIVERSITY-SAN BERNARDINO,0,1,1995,Inf,0,799,505,294,58,16,42,0.08,0.05,0.07,1891,93,406,280
110510,CALIFORNIA STATE UNIVERSITY-SAN BERNARDINO,0,1,1996,Inf,0,882,554,328,78,18,60,0.1,0.05,0.09,1935,92,416,324
110510,CALIFORNIA STATE UNIVERSITY-SAN BERNARDINO,0,1,1997,Inf,0,890,559,331,83,26,57,0.1,0.08,0.09,1889,96,416,315
110510,CALIFORNIA STATE UNIVERSITY-SAN BERNARDINO,0,1,1998,Inf,0,1068,680,388,124,39,85,0.12,0.1,0.12,1779,110,421,390
110510,CALIFORNIA STATE UNIVERSITY-SAN BERNARDINO,0,1,1999,Inf,0,1049,679,370,105,30,75,0.11,0.08,0.1,0,150,440,342
110510,CALIFORNIA STATE UNIVERSITY-SAN BERNARDINO,0,1,2000,Inf,0,1146,750,396,142,33,109,0.14,0.08,0.12,0,141,451,373
110510,CALIFORNIA STATE UNIVERSITY-SAN BERNARDINO,0,1,2001,Inf,0,1273,774,499,127,36,91,0.11,0.07,0.1,0,168,463,387
110510,CALIFORNIA STATE UNIVERSITY-SAN BERNARDINO,0,1,2002,Inf,0,1161,751,410,142,32,110,0.14,0.08,0.12,0,149,488,323
110510,CALIFORNIA STATE UNIVERSITY-SAN BERNARDINO,0,1,2003,Inf,0,1335,918,417,178,45,133,0.14,0.11,0.13,0,167,479,386
110510,CALIFORNIA STATE UNIVERSITY-SAN BERNARDINO,0,1,2004,Inf,0,1587,1099,488,208,53,155,0.14,0.11,0.13,0,170,447,351
110510,California State University-San Bernardino,0,1,2005,Inf,0,1645,1092,553,212,75,137,0.12,0.14,0.13,0,158,444,393
110510,California State University-San Bernardino,0,1,2006,Inf,0,1774,1157,617,201,55,146,0.12,0.09,0.11,0,179,462,405
110510,California State University-San Bernardino,0,1,2007,Inf,0,1656,1098,558,156,43,113,0.1,0.08,0.09,0,196,468,334
110510,California State University-San Bernardino,0,1,2008,Inf,0,1916,1213,703,241,77,164,0.13,0.11,0.13,0,218,470,390
110510,California State University-San Bernardino,0,1,2009,Inf,0,1968,1275,693,265,75,190,0.14,0.11,0.13,0,231,452,304
110510,California State University-San Bernardino,0,1,2010,Inf,0,1747,1114,633,251,73,178,0.15,0.12,0.14,0,223,433,263
110529,CALIFORNIA STATE POLYTECHNIC UNIVERSITY POMONA,0,1,1991,Inf,0,1583,650,933,96,28,68,0.1,0.03,0.06,936,131,662,470
110529,CALIFORNIA STATE POLYTECHNIC UNIVERSITY POMONA,0,1,1992,Inf,0,1358,551,807,84,34,50,0.09,0.04,0.06,1384,134,629,373
110529,CALIFORNIA STATE POLYTECHNIC UNIVERSITY-POMONA,0,1,1993,Inf,0,1309,536,773,105,42,63,0.11,0.05,0.08,1674,133,610,383
110529,CALIFORNIA STATE POLYTECHNIC UNIVERSITY-POMONA,0,1,1995,Inf,0,1422,621,801,96,37,59,0.09,0.05,0.07,1891,147,612,374
110529,CALIFORNIA STATE POLYTECHNIC UNIVERSITY-POMONA,0,1,1996,Inf,0,1497,647,850,128,56,72,0.11,0.07,0.09,1935,147,595,393
110529,CALIFORNIA STATE POLYTECHNIC UNIVERSITY-POMONA,0,1,1997,Inf,0,1856,810,1046,157,56,101,0.12,0.05,0.08,1903,159,581,466
110529,CALIFORNIA STATE POLYTECHNIC UNIVERSITY-POMONA,0,1,1998,Inf,0,2033,855,1178,191,80,111,0.12,0.07,0.09,1855,167,571,516
110529,CALIFORNIA STATE POLYTECHNIC UNIVERSITY-POMONA,0,1,1999,Inf,0,2489,1008,1481,226,90,136,0.13,0.06,0.09,0,159,585,599
110529,CALIFORNIA STATE POLYTECHNIC UNIVERSITY-POMONA,0,1,2000,Inf,0,2600,1121,1479,265,113,152,0.13,0.08,0.1,0,222,595,578
110529,CALIFORNIA STATE POLYTECHNIC UNIVERSITY-POMONA,0,1,2001,Inf,0,2412,961,1451,229,91,138,0.14,0.06,0.09,0,252,606,535
110529,CALIFORNIA STATE POLYTECHNIC UNIVERSITY-POMONA,0,1,2002,Inf,0,2674,1080,1594,345,161,184,0.17,0.1,0.13,0,221,609,651
110529,CALIFORNIA STATE POLYTECHNIC UNIVERSITY-POMONA,0,1,2003,Inf,0,2558,1107,1451,384,172,212,0.19,0.12,0.15,0,216,596,693
110529,CALIFORNIA STATE POLYTECHNIC UNIVERSITY-POMONA,0,1,2004,Inf,0,2115,921,1194,412,188,224,0.24,0.16,0.19,0,270,549,588
110529,California State Polytechnic University-Pomona,0,1,2005,Inf,0,3089,1296,1793,380,157,223,0.17,0.09,0.12,0,229,559,773
110529,California State Polytechnic University-Pomona,0,1,2006,Inf,0,3138,1357,1781,341,128,213,0.15,0.07,0.11,0,250,563,769
110529,California State Polytechnic University-Pomona,0,1,2007,Inf,0,3414,1459,1955,343,118,225,0.15,0.06,0.1,0,249,594,770
110529,California State Polytechnic University-Pomona,0,1,2008,Inf,0,2538,1068,1470,299,135,164,0.15,0.09,0.12,0,275,570,680
110529,California State Polytechnic University-Pomona,0,1,2009,Inf,0,2728,1192,1536,401,134,267,0.22,0.09,0.15,0,287,562,714
110529,California State Polytechnic University-Pomona,0,1,2010,Inf,0,1923,835,1088,352,150,202,0.24,0.14,0.18,0,268,504,458
110538,CALIFORNIA STATE UNIVERSITY-CHICO,1,0,1991,NA,NA,1284,731,553,171,35,136,0.18,0.06,0.13,936,126,639,1009
110538,CALIFORNIA STATE UNIVERSITY-CHICO,1,0,1992,NA,NA,1325,758,567,148,34,114,0.15,0.06,0.11,1452,126,587,1018
110538,CALIFORNIA STATE UNIVERSITY-CHICO,1,0,1993,NA,NA,1244,754,490,169,27,142,0.18,0.06,0.14,1674,128,574,899
110538,CALIFORNIA STATE UNIVERSITY-CHICO,1,0,1995,NA,NA,1401,832,569,161,22,139,0.16,0.04,0.11,1891,131,545,940
110538,CALIFORNIA STATE UNIVERSITY-CHICO,1,0,1996,NA,NA,1524,874,650,173,35,138,0.15,0.05,0.11,1935,129,541,1018
110538,CALIFORNIA STATE UNIVERSITY-CHICO,1,0,1997,NA,NA,1618,948,670,246,45,201,0.21,0.07,0.15,2076,136,536,1125
110538,CALIFORNIA STATE UNIVERSITY-CHICO,1,0,1998,NA,NA,1850,1069,781,299,65,234,0.21,0.08,0.16,2026,143,552,1263
110538,CALIFORNIA STATE UNIVERSITY-CHICO,1,0,1999,NA,NA,2007,1139,868,304,67,237,0.2,0.08,0.15,0,150,571,1398
110538,CALIFORNIA STATE UNIVERSITY-CHICO,1,0,2000,NA,NA,1931,1079,852,336,79,257,0.23,0.09,0.17,0,203,579,1336
110538,CALIFORNIA STATE UNIVERSITY-CHICO,1,0,2001,NA,NA,2092,1175,917,314,64,250,0.21,0.07,0.15,0,230,587,1444
110538,CALIFORNIA STATE UNIVERSITY-CHICO,1,0,2002,NA,NA,1995,1125,870,372,95,277,0.24,0.11,0.19,0,173,572,1353
110538,CALIFORNIA STATE UNIVERSITY-CHICO,1,0,2003,NA,NA,1970,1140,830,322,71,251,0.22,0.09,0.16,0,179,525,1385
110538,CALIFORNIA STATE UNIVERSITY-CHICO,1,0,2004,NA,NA,2198,1266,932,436,102,334,0.26,0.11,0.2,0,179,498,1485
110538,California State University-Chico,1,0,2005,NA,NA,2300,1237,1063,439,118,321,0.25,0.11,0.19,0,182,506,1452
110538,California State University-Chico,1,0,2006,NA,NA,2430,1326,1104,420,103,317,0.23,0.09,0.17,0,182,530,1597
110538,California State University-Chico,1,0,2007,NA,NA,2710,1418,1292,458,138,320,0.22,0.11,0.17,0,193,559,1765
110538,California State University-Chico,1,0,2008,NA,NA,2727,1420,1307,537,163,374,0.26,0.12,0.2,0,214,565,1821
110538,California State University-Chico,1,0,2009,NA,NA,2468,1338,1130,561,159,402,0.3,0.14,0.23,0,218,531,1488
110538,California State University-Chico,1,0,2010,NA,NA,1880,1048,832,484,160,324,0.3,0.19,0.26,0,205,500,1015
110547,CALIFORNIA STATE UNIVERSITY-DOMINGUEZ HILLS,1,0,1991,NA,NA,337,227,110,9,2,7,0.03,0.02,0.03,936,68,285,50
110547,CALIFORNIA STATE UNIVERSITY-DOMINGUEZ HILLS,1,0,1992,NA,NA,485,336,149,16,6,10,0.02,0.04,0.03,1399,67,277,53
110547,CALIFORNIA STATE UNIVERSITY-DOMINGUEZ HILLS,1,0,1993,NA,NA,389,252,137,15,5,10,0.03,0.04,0.04,1674,70,268,46
110547,CALIFORNIA STATE UNIVERSITY-DOMINGUEZ HILLS,1,0,1995,NA,NA,467,335,132,19,4,15,0.04,0.03,0.04,1891,78,265,23
110547,CALIFORNIA STATE UNIVERSITY-DOMINGUEZ HILLS,1,0,1996,NA,NA,475,358,117,24,3,21,0.05,0.03,0.05,1935,82,276,14
110547,CALIFORNIA STATE UNIVERSITY-DOMINGUEZ HILLS,1,0,1997,NA,NA,512,363,149,17,2,15,0.04,0.01,0.03,1791,84,265,27
110547,CALIFORNIA STATE UNIVERSITY-DOMINGUEZ HILLS,1,0,1998,NA,NA,465,330,135,21,3,18,0.05,0.02,0.05,1748,89,277,20
110547,CALIFORNIA STATE UNIVERSITY-DOMINGUEZ HILLS,1,0,1999,NA,NA,453,319,134,26,5,21,0.06,0.04,0.06,0,96,294,24
110547,CALIFORNIA STATE UNIVERSITY-DOMINGUEZ HILLS,1,0,2000,NA,NA,495,355,140,31,7,24,0.06,0.05,0.06,0,118,290,25
110547,CALIFORNIA STATE UNIVERSITY-DOMINGUEZ HILLS,1,0,2001,NA,NA,561,391,170,26,6,20,0.05,0.04,0.05,0,125,287,25
110547,CALIFORNIA STATE UNIVERSITY-DOMINGUEZ HILLS,1,0,2002,NA,NA,630,466,164,28,6,22,0.04,0.04,0.04,0,110,295,30
110547,CALIFORNIA STATE UNIVERSITY-DOMINGUEZ HILLS,1,0,2003,NA,NA,639,458,181,31,5,26,0.05,0.03,0.05,0,121,310,25
110547,CALIFORNIA STATE UNIVERSITY-DOMINGUEZ HILLS,1,0,2004,NA,NA,673,459,214,35,10,25,0.05,0.05,0.05,0,123,288,36
110547,California State University-Dominguez Hills,1,0,2005,NA,NA,705,476,229,42,9,33,0.06,0.04,0.06,0,122,270,34
110547,California State University-Dominguez Hills,1,0,2006,NA,NA,984,716,268,41,8,33,0.04,0.03,0.04,0,124,268,41
110547,California State University-Dominguez Hills,1,0,2007,NA,NA,913,602,311,35,11,24,0.03,0.04,0.04,0,131,292,38
110547,California State University-Dominguez Hills,1,0,2008,NA,NA,889,599,290,42,14,28,0.04,0.05,0.05,0,142,282,35
110547,California State University-Dominguez Hills,1,0,2009,NA,NA,1069,703,366,66,13,53,0.07,0.04,0.06,0,149,293,34
110547,California State University-Dominguez Hills,1,0,2010,NA,NA,982,633,349,50,17,33,0.05,0.05,0.05,0,141,279,41
110556,CALIFORNIA STATE UNIVERSITY-FRESNO,1,0,1991,NA,NA,1648,902,746,173,61,112,0.12,0.08,0.1,936,144,734,711
110556,CALIFORNIA STATE UNIVERSITY-FRESNO,1,0,1992,NA,NA,1559,860,699,165,52,113,0.13,0.07,0.11,1446,151,643,666
110556,CALIFORNIA STATE UNIVERSITY-FRESNO,1,0,1993,NA,NA,1436,792,644,152,32,120,0.15,0.05,0.11,1674,148,649,522
110556,CALIFORNIA STATE UNIVERSITY-FRESNO,1,0,1995,NA,NA,1571,915,656,176,44,132,0.14,0.07,0.11,1891,155,637,537
110556,CALIFORNIA STATE UNIVERSITY-FRESNO,1,0,1996,NA,NA,1503,846,657,198,54,144,0.17,0.08,0.13,1935,154,630,469
110556,CALIFORNIA STATE UNIVERSITY-FRESNO,1,0,1997,NA,NA,1510,901,609,180,69,111,0.12,0.11,0.12,1802,163,637,486
110556,CALIFORNIA STATE UNIVERSITY-FRESNO,1,0,1998,NA,NA,1566,933,633,215,44,171,0.18,0.07,0.14,1754,171,625,488
110556,CALIFORNIA STATE UNIVERSITY-FRESNO,1,0,1999,NA,NA,1703,1002,701,225,56,169,0.16,0.08,0.13,0,176,646,573
110556,CALIFORNIA STATE UNIVERSITY-FRESNO,1,0,2000,NA,NA,1885,1138,747,227,67,160,0.14,0.09,0.12,0,262,646,629
110556,CALIFORNIA STATE UNIVERSITY-FRESNO,1,0,2001,NA,NA,1946,1179,767,275,74,201,0.17,0.1,0.14,0,278,646,704
110556,CALIFORNIA STATE UNIVERSITY-FRESNO,1,0,2002,NA,NA,2189,1274,915,346,109,237,0.18,0.12,0.16,0,225,677,825
110556,CALIFORNIA STATE UNIVERSITY-FRESNO,1,0,2003,NA,NA,2485,1503,982,353,101,252,0.16,0.1,0.14,0,237,648,915
110556,CALIFORNIA STATE UNIVERSITY-FRESNO,1,0,2004,NA,NA,2243,1351,892,378,102,276,0.2,0.11,0.17,0,234,601,839
110556,California State University-Fresno,1,0,2005,NA,NA,2356,1403,953,323,106,217,0.15,0.11,0.14,0,219,636,785
110556,California State University-Fresno,1,0,2006,NA,NA,2528,1501,1027,344,108,236,0.15,0.11,0.14,0,259,664,843
110556,California State University-Fresno,1,0,2007,NA,NA,2552,1526,1026,350,112,238,0.15,0.11,0.14,0,207,704,797
110556,California State University-Fresno,1,0,2008,NA,NA,2731,1604,1127,402,121,281,0.17,0.11,0.15,0,284,703,847
110556,California State University-Fresno,1,0,2009,NA,NA,2619,1574,1045,407,123,284,0.18,0.12,0.16,0,285,653,780
110556,California State University-Fresno,1,0,2010,NA,NA,2582,1551,1031,420,116,304,0.19,0.11,0.16,0,287,642,667
110565,CALIFORNIA STATE UNIVERSITY-FULLERTON,1,0,1991,NA,NA,1847,1094,753,137,30,107,0.09,0.04,0.07,936,136,686,714
110565,CALIFORNIA STATE UNIVERSITY-FULLERTON,1,0,1992,NA,NA,1589,926,663,108,27,81,0.08,0.04,0.07,1480,141,645,562
110565,CALIFORNIA STATE UNIVERSITY-FULLERTON,1,0,1993,NA,NA,1309,748,561,112,40,72,0.09,0.07,0.09,1674,137,623,431
110565,CALIFORNIA STATE UNIVERSITY-FULLERTON,1,0,1995,NA,NA,1832,1036,796,148,41,107,0.1,0.05,0.08,1891,154,612,556
110565,CALIFORNIA STATE UNIVERSITY-FULLERTON,1,0,1996,NA,NA,2028,1158,870,199,48,151,0.13,0.06,0.1,1935,149,618,610
110565,CALIFORNIA STATE UNIVERSITY-FULLERTON,1,0,1997,NA,NA,2192,1317,875,215,48,167,0.12,0.05,0.1,1936,172,602,625
110565,CALIFORNIA STATE UNIVERSITY-FULLERTON,1,0,1998,NA,NA,2146,1240,906,274,65,209,0.16,0.07,0.13,1858,177,621,636
110565,CALIFORNIA STATE UNIVERSITY-FULLERTON,1,0,1999,NA,NA,2544,1543,1001,349,63,286,0.18,0.06,0.14,0,234,646,758
110565,CALIFORNIA STATE UNIVERSITY-FULLERTON,1,0,2000,NA,NA,2655,1609,1046,381,83,298,0.18,0.08,0.14,0,248,690,843
110565,CALIFORNIA STATE UNIVERSITY-FULLERTON,1,0,2001,NA,NA,2772,1673,1099,416,86,330,0.19,0.08,0.15,0,288,735,846
110565,CALIFORNIA STATE UNIVERSITY-FULLERTON,1,0,2002,NA,NA,3291,2039,1252,481,111,370,0.18,0.09,0.15,0,302,776,1076
110565,CALIFORNIA STATE UNIVERSITY-FULLERTON,1,0,2003,NA,NA,3098,1873,1225,481,107,374,0.19,0.09,0.16,0,280,755,1018
110565,CALIFORNIA STATE UNIVERSITY-FULLERTON,1,0,2004,NA,NA,3539,2094,1445,583,148,435,0.2,0.1,0.16,0,287,719,1117
110565,California State University-Fullerton,1,0,2005,NA,NA,3816,2241,1575,524,134,390,0.17,0.09,0.14,0,271,757,1127
110565,California State University-Fullerton,1,0,2006,NA,NA,3736,2262,1474,500,122,378,0.16,0.08,0.13,0,302,826,1045
110565,California State University-Fullerton,1,0,2007,NA,NA,4040,2430,1610,550,135,415,0.17,0.08,0.14,0,341,894,1078
110565,California State University-Fullerton,1,0,2008,NA,NA,4519,2673,1846,630,180,450,0.16,0.1,0.14,0,387,879,1275
110565,California State University-Fullerton,1,0,2009,NA,NA,3842,2233,1609,666,180,486,0.21,0.11,0.17,0,377,866,1034
110565,California State University-Fullerton,1,0,2010,NA,NA,3749,2160,1589,660,173,487,0.22,0.11,0.18,0,368,848,975
110574,CALIFORNIA STATE UNIVERSITY-HAYWARD,0,1,1991,Inf,0,649,445,204,87,22,65,0.14,0.11,0.13,936,89,435,217
110574,CALIFORNIA STATE UNIVERSITY-HAYWARD,0,1,1992,Inf,0,572,394,178,76,17,59,0.14,0.1,0.13,1423,91,388,135
110574,CALIFORNIA STATE UNIVERSITY-HAYWARD,0,1,1993,Inf,0,553,371,182,59,11,48,0.12,0.06,0.11,1674,91,383,134
110574,CALIFORNIA STATE UNIVERSITY-HAYWARD,0,1,1995,Inf,0,542,331,211,55,22,33,0.09,0.1,0.1,1891,105,381,119
110574,CALIFORNIA STATE UNIVERSITY-HAYWARD,0,1,1996,Inf,0,661,420,241,83,26,57,0.13,0.11,0.13,1935,106,384,129
110574,CALIFORNIA STATE UNIVERSITY-HAYWARD,0,1,1997,Inf,0,711,451,260,94,26,68,0.15,0.1,0.13,1812,113,352,128
110574,CALIFORNIA STATE UNIVERSITY-HAYWARD,0,1,1998,Inf,0,732,470,262,106,24,82,0.17,0.09,0.14,1746,119,350,159
110574,CALIFORNIA STATE UNIVERSITY-HAYWARD,0,1,1999,Inf,0,714,466,248,119,26,93,0.19,0.1,0.17,0,125,355,147
110574,CALIFORNIA STATE UNIVERSITY-HAYWARD,0,1,2000,Inf,0,669,452,217,109,26,83,0.18,0.12,0.16,0,146,353,156
110574,CALIFORNIA STATE UNIVERSITY-HAYWARD,0,1,2001,Inf,0,692,435,257,75,17,58,0.13,0.07,0.11,0,175,351,131
110574,CALIFORNIA STATE UNIVERSITY-HAYWARD,0,1,2002,Inf,0,746,473,273,119,43,76,0.16,0.16,0.16,0,153,336,164
110574,CALIFORNIA STATE UNIVERSITY-HAYWARD,0,1,2003,Inf,0,672,415,257,111,32,79,0.19,0.12,0.17,0,158,330,140
110574,CALIFORNIA STATE UNIVERSITY-EAST BAY,0,1,2004,Inf,0,840,516,324,122,38,84,0.16,0.12,0.15,0,152,312,159
110574,California State University-East Bay,0,1,2005,Inf,0,686,414,272,110,39,71,0.17,0.14,0.16,0,142,322,138
110574,California State University-East Bay,0,1,2006,Inf,0,881,506,375,131,48,83,0.16,0.13,0.15,0,158,334,126
110574,California State University-East Bay,0,1,2007,Inf,0,1032,602,430,111,49,62,0.1,0.11,0.11,0,171,350,124
110574,California State University-East Bay,0,1,2008,Inf,0,1356,828,528,141,45,96,0.11,0.09,0.1,0,187,372,188
110574,California State University-East Bay,0,1,2009,Inf,0,1436,884,552,184,54,130,0.14,0.1,0.13,0,201,354,187
110574,California State University-East Bay,0,1,2010,Inf,0,1192,751,441,168,47,121,0.16,0.11,0.14,0,179,327,165
110583,CALIFORNIA STATE UNIVERSITY-LONG BEACH,1,0,1991,NA,NA,2142,1283,859,88,25,63,0.04,0.03,0.04,936,196,861,791
110583,CALIFORNIA STATE UNIVERSITY-LONG BEACH,1,0,1992,NA,NA,1565,961,604,79,27,52,0.05,0.04,0.05,1425,191,793,497
110583,CALIFORNIA STATE UNIVERSITY-LONG BEACH,1,0,1993,NA,NA,1835,1125,710,80,21,59,0.05,0.03,0.04,1674,189,780,439
110583,CALIFORNIA STATE UNIVERSITY-LONG BEACH,1,0,1995,NA,NA,2057,1307,750,88,26,62,0.04,0.03,0.04,1891,200,773,515
110583,CALIFORNIA STATE UNIVERSITY-LONG BEACH,1,0,1996,NA,NA,2299,1407,892,152,38,114,0.08,0.04,0.07,1935,208,775,641
110583,CALIFORNIA STATE UNIVERSITY-LONG BEACH,1,0,1997,NA,NA,2498,1597,901,205,60,145,0.09,0.07,0.08,1844,213,779,706
110583,CALIFORNIA STATE UNIVERSITY-LONG BEACH,1,0,1998,NA,NA,2652,1707,945,285,61,224,0.13,0.06,0.11,1766,227,782,809
110583,CALIFORNIA STATE UNIVERSITY-LONG BEACH,1,0,1999,NA,NA,3309,2128,1181,361,75,286,0.13,0.06,0.11,0,244,815,1068
110583,CALIFORNIA STATE UNIVERSITY-LONG BEACH,1,0,2000,NA,NA,3214,2038,1176,375,87,288,0.14,0.07,0.12,0,328,869,1078
110583,CALIFORNIA STATE UNIVERSITY-LONG BEACH,1,0,2001,NA,NA,4324,2751,1573,420,117,303,0.11,0.07,0.1,0,376,924,1474
110583,CALIFORNIA STATE UNIVERSITY-LONG BEACH,1,0,2002,NA,NA,2912,1871,1041,365,91,274,0.14,0.09,0.13,0,288,947,1064
110583,CALIFORNIA STATE UNIVERSITY-LONG BEACH,1,0,2003,NA,NA,3339,2236,1103,432,103,329,0.14,0.09,0.13,0,312,964,1233
110583,CALIFORNIA STATE UNIVERSITY-LONG BEACH,1,0,2004,NA,NA,3300,2222,1078,406,103,303,0.13,0.1,0.12,0,314,918,1000
110583,California State University-Long Beach,1,0,2005,NA,NA,4241,2666,1575,524,153,371,0.13,0.1,0.12,0,313,968,1348
110583,California State University-Long Beach,1,0,2006,NA,NA,4334,2757,1577,550,175,375,0.13,0.11,0.13,0,353,987,1307
110583,California State University-Long Beach,1,0,2007,NA,NA,4134,2620,1514,581,166,415,0.15,0.11,0.14,0,363,1030,1135
110583,California State University-Long Beach,1,0,2008,NA,NA,4536,2856,1680,676,183,493,0.17,0.11,0.15,0,397,1012,1324
110583,California State University-Long Beach,1,0,2009,NA,NA,3473,2133,1340,551,172,379,0.17,0.13,0.16,0,412,1001,779
110583,California State University-Long Beach,1,0,2010,NA,NA,3913,2310,1603,585,189,396,0.17,0.12,0.15,0,388,953,808
110592,CALIFORNIA STATE UNIVERSITY-LOS ANGELES,0,1,1991,Inf,0,1491,938,553,41,9,32,0.03,0.02,0.03,936,142,616,75
110592,CALIFORNIA STATE UNIVERSITY-LOS ANGELES,0,1,1992,Inf,0,1206,738,468,45,16,29,0.03,0.03,0.04,1427,139,550,47
110592,CALIFORNIA STATE UNIVERSITY-LOS ANGELES,0,1,1993,Inf,0,1133,697,436,34,11,23,0.03,0.03,0.03,1674,133,579,33
110592,CALIFORNIA STATE UNIVERSITY-LOS ANGELES,0,1,1995,Inf,0,1243,766,477,49,12,37,0.04,0.03,0.04,1891,142,565,62
110592,CALIFORNIA STATE UNIVERSITY-LOS ANGELES,0,1,1996,Inf,0,1313,763,550,51,15,36,0.04,0.03,0.04,1935,146,555,66
110592,CALIFORNIA STATE UNIVERSITY-LOS ANGELES,0,1,1997,Inf,0,1274,828,446,82,17,65,0.07,0.04,0.06,1758,145,573,64
110592,CALIFORNIA STATE UNIVERSITY-LOS ANGELES,0,1,1998,Inf,0,1255,789,466,103,22,81,0.1,0.05,0.08,1679,158,569,80
110592,CALIFORNIA STATE UNIVERSITY-LOS ANGELES,0,1,1999,Inf,0,1186,750,436,111,32,79,0.1,0.07,0.09,0,176,592,86
110592,CALIFORNIA STATE UNIVERSITY-LOS ANGELES,0,1,2000,Inf,0,1184,755,429,126,24,102,0.13,0.06,0.11,0,207,586,75
110592,CALIFORNIA STATE UNIVERSITY-LOS ANGELES,0,1,2001,Inf,0,1223,767,456,117,26,91,0.11,0.06,0.1,0,231,581,70
110592,CALIFORNIA STATE UNIVERSITY-LOS ANGELES,0,1,2002,Inf,0,1404,906,498,116,34,82,0.09,0.07,0.08,0,207,599,97
110592,CALIFORNIA STATE UNIVERSITY-LOS ANGELES,0,1,2003,Inf,0,1305,845,460,115,32,83,0.09,0.07,0.09,0,216,600,83
110592,CALIFORNIA STATE UNIVERSITY-LOS ANGELES,0,1,2004,Inf,0,1087,687,400,87,22,65,0.09,0.06,0.08,0,215,558,61
110592,California State University-Los Angeles,0,1,2005,Inf,0,1253,823,430,111,31,80,0.09,0.07,0.09,0,209,581,60
110592,California State University-Los Angeles,0,1,2006,Inf,0,1542,961,581,113,36,77,0.08,0.06,0.07,0,219,565,76
110592,California State University-Los Angeles,0,1,2007,Inf,0,1767,1106,661,119,40,79,0.07,0.06,0.07,0,231,566,65
110592,California State University-Los Angeles,0,1,2008,Inf,0,1676,1014,662,105,40,65,0.06,0.06,0.06,0,240,579,67
110592,California State University-Los Angeles,0,1,2009,Inf,0,1877,1173,704,127,40,87,0.07,0.06,0.07,0,259,579,81
110592,California State University-Los Angeles,0,1,2010,Inf,0,2013,1222,791,127,48,79,0.06,0.06,0.06,0,228,556,80
110617,CALIFORNIA STATE UNIVERSITY-SACRAMENTO,1,0,1991,NA,NA,1210,694,516,108,28,80,0.11,0.05,0.09,936,159,808,678
110617,CALIFORNIA STATE UNIVERSITY-SACRAMENTO,1,0,1992,NA,NA,922,513,409,71,20,51,0.09,0.05,0.08,1460,160,726,418
110617,CALIFORNIA STATE UNIVERSITY-SACRAMENTO,1,0,1993,NA,NA,1086,635,451,51,8,43,0.06,0.02,0.05,1674,163,721,496
110617,CALIFORNIA STATE UNIVERSITY-SACRAMENTO,1,0,1995,NA,NA,1219,735,484,96,24,72,0.09,0.05,0.08,1891,177,717,473
110617,CALIFORNIA STATE UNIVERSITY-SACRAMENTO,1,0,1996,NA,NA,1396,826,570,84,23,61,0.07,0.04,0.06,1935,173,720,524
110617,CALIFORNIA STATE UNIVERSITY-SACRAMENTO,1,0,1997,NA,NA,1350,777,573,95,31,64,0.08,0.05,0.07,1982,194,713,505
110617,CALIFORNIA STATE UNIVERSITY-SACRAMENTO,1,0,1998,NA,NA,1467,828,639,136,30,106,0.12,0.05,0.09,1934,197,706,589
110617,CALIFORNIA STATE UNIVERSITY-SACRAMENTO,1,0,1999,NA,NA,1753,1013,740,159,39,120,0.11,0.05,0.09,0,215,731,704
110617,CALIFORNIA STATE UNIVERSITY-SACRAMENTO,1,0,2000,NA,NA,2055,1198,857,178,36,142,0.11,0.04,0.09,0,293,728,741
110617,CALIFORNIA STATE UNIVERSITY-SACRAMENTO,1,0,2001,NA,NA,2278,1387,891,221,49,172,0.12,0.05,0.1,0,321,725,891
110617,CALIFORNIA STATE UNIVERSITY-SACRAMENTO,1,0,2002,NA,NA,2378,1395,983,221,56,165,0.11,0.06,0.09,0,272,801,944
110617,CALIFORNIA STATE UNIVERSITY-SACRAMENTO,1,0,2003,NA,NA,2347,1415,932,227,62,165,0.11,0.07,0.1,0,289,811,941
110617,CALIFORNIA STATE UNIVERSITY-SACRAMENTO,1,0,2004,NA,NA,2268,1375,893,240,57,183,0.13,0.06,0.11,0,295,800,884
110617,California State University-Sacramento,1,0,2005,NA,NA,2436,1483,953,256,73,183,0.12,0.08,0.11,0,294,765,911
110617,California State University-Sacramento,1,0,2006,NA,NA,2590,1570,1020,263,79,184,0.11,0.08,0.1,0,288,786,901
110617,California State University-Sacramento,1,0,2007,NA,NA,2357,1426,931,194,64,130,0.09,0.07,0.08,0,310,783,682
110617,California State University-Sacramento,1,0,2008,NA,NA,2536,1493,1043,191,50,141,0.09,0.05,0.08,0,334,779,869
110617,California State University-Sacramento,1,0,2009,NA,NA,2954,1712,1242,196,50,146,0.08,0.04,0.07,0,346,776,906
110617,California State University-Sacramento,1,0,2010,NA,NA,2625,1548,1077,238,69,169,0.1,0.06,0.09,0,340,723,783
113698,DOMINICAN COLLEGE OF SAN RAFAEL,1,0,1991,NA,NA,66,50,16,22,3,19,0.38,0.19,0.33,10390,11,42,44
113698,DOMINICAN COLLEGE OF SAN RAFAEL,1,0,1992,NA,NA,65,45,20,24,8,16,0.35000000000000003,0.4,0.37,11280,14,42,44
113698,DOMINICAN COLLEGE OF SAN RAFAEL,1,0,1993,NA,NA,75,46,29,17,4,13,0.28,0.14,0.23,12180,14,40,49
113698,DOMINICAN COLLEGE OF SAN RAFAEL,1,0,1995,NA,NA,69,51,18,27,5,22,0.43,0.28,0.39,13890,18,46,49
113698,DOMINICAN COLLEGE OF SAN RAFAEL,1,0,1996,NA,NA,58,41,17,23,6,17,0.41000000000000003,0.35,0.4,14670,20,39,31
113698,DOMINICAN COLLEGE OF SAN RAFAEL,1,0,1997,NA,NA,74,55,19,24,5,19,0.34,0.26,0.32,15424,19,44,38
113698,DOMINICAN COLLEGE OF SAN RAFAEL,1,0,1998,NA,NA,72,58,14,30,6,24,0.41000000000000003,0.43,0.42,16160,20,49,45
113698,DOMINICAN COLLEGE OF SAN RAFAEL,1,0,1999,NA,NA,111,88,23,50,10,40,0.45,0.43,0.45,16512,19,43,67
113698,DOMINICAN UNIVERSITY OF CALIFORNIA,1,0,2000,NA,NA,113,86,27,48,13,35,0.4,0.48,0.42,17256,20,48,58
113698,DOMINICAN UNIVERSITY OF CALIFORNIA,1,0,2001,NA,NA,127,90,37,51,13,38,0.42,0.35,0.4,18648,23,54,59
113698,DOMINICAN UNIVERSITY OF CALIFORNIA,1,0,2002,NA,NA,202,145,57,75,19,56,0.38,0.33,0.37,20320,26,58,78
113698,DOMINICAN UNIVERSITY OF CALIFORNIA,1,0,2003,NA,NA,244,188,56,98,24,74,0.39,0.43,0.4,22250,28,72,88
113698,DOMINICAN UNIVERSITY OF CALIFORNIA,1,0,2004,NA,NA,276,205,71,119,24,95,0.46,0.34,0.43,24254,29,65,109
113698,Dominican University of California,1,0,2005,NA,NA,227,168,59,98,22,76,0.45,0.37,0.43,25950,30,67,82
113698,Dominican University of California,1,0,2006,NA,NA,263,193,70,100,18,82,0.42,0.26,0.38,27770,32,78,99
113698,Dominican University of California,1,0,2007,NA,NA,297,225,72,107,23,84,0.37,0.32,0.36,30270,39,73,100
113698,Dominican University of California,1,0,2008,NA,NA,267,202,65,146,31,115,0.56,0.48,0.55,32090,42,79,71
113698,Dominican University of California,1,0,2009,NA,NA,289,207,82,152,25,127,0.61,0.3,0.53,33540,43,81,98
113698,Dominican University of California,1,0,2010,NA,NA,338,255,83,192,45,147,0.5700000000000001,0.54,0.57,35220,48,83,91
115755,HUMBOLDT STATE UNIVERSITY,1,0,1991,NA,NA,862,468,394,61,19,42,0.08,0.05,0.07,936,72,342,649
115755,HUMBOLDT STATE UNIVERSITY,1,0,1992,NA,NA,779,421,358,45,16,29,0.06,0.04,0.06,1467,75,324,560
115755,HUMBOLDT STATE UNIVERSITY,1,0,1993,NA,NA,553,324,229,60,9,51,0.15,0.04,0.11,1674,76,301,390
115755,HUMBOLDT STATE UNIVERSITY,1,0,1995,NA,NA,908,503,405,69,18,51,0.1,0.04,0.08,1891,78,311,644
115755,HUMBOLDT STATE UNIVERSITY,1,0,1996,NA,NA,823,471,352,62,13,49,0.1,0.04,0.08,1935,80,315,529
115755,HUMBOLDT STATE UNIVERSITY,1,0,1997,NA,NA,718,401,317,85,14,71,0.17,0.04,0.12,1923,86,309,481
115755,HUMBOLDT STATE UNIVERSITY,1,0,1998,NA,NA,731,405,326,71,24,47,0.11,0.07,0.1,1905,89,319,477
115755,HUMBOLDT STATE UNIVERSITY,1,0,1999,NA,NA,751,436,315,89,25,64,0.14,0.08,0.12,0,93,317,511
115755,HUMBOLDT STATE UNIVERSITY,1,0,2000,NA,NA,769,460,309,94,32,62,0.13,0.1,0.12,0,121,313,535
115755,HUMBOLDT STATE UNIVERSITY,1,0,2001,NA,NA,725,416,309,81,18,63,0.15,0.06,0.11,0,128,309,461
115755,HUMBOLDT STATE UNIVERSITY,1,0,2002,NA,NA,836,505,331,97,28,69,0.13,0.08,0.12,0,106,303,499
115755,HUMBOLDT STATE UNIVERSITY,1,0,2003,NA,NA,853,481,372,97,26,71,0.14,0.07,0.11,0,111,288,506
115755,HUMBOLDT STATE UNIVERSITY,1,0,2004,NA,NA,760,427,333,66,18,48,0.11,0.05,0.09,0,114,288,426
115755,Humboldt State University,1,0,2005,NA,NA,813,461,352,99,32,67,0.14,0.09,0.12,0,115,289,433
115755,Humboldt State University,1,0,2006,NA,NA,966,550,416,132,46,86,0.15,0.11,0.14,0,114,299,485
115755,Humboldt State University,1,0,2007,NA,NA,1039,551,488,112,39,73,0.13,0.08,0.11,0,123,284,472
115755,Humboldt State University,1,0,2008,NA,NA,1168,661,507,147,37,110,0.16,0.07,0.13,0,125,279,555
115755,Humboldt State University,1,0,2009,NA,NA,1345,745,600,214,57,157,0.21,0.1,0.16,0,136,272,741
115755,Humboldt State University,1,0,2010,NA,NA,1282,701,581,188,65,123,0.17,0.11,0.15,0,136,250,644
119173,MOUNT SAINT MARY'S COLLEGE,1,0,1991,NA,NA,190,190,0,32,0,32,0.16,NA,0.17,9950,18,54,29
119173,MOUNT SAINT MARY'S COLLEGE,1,0,1992,NA,NA,217,217,0,64,0,64,0.29,NA,0.29,10830,19,58,29
119173,MOUNT SAINT MARYS COLLEGE,1,0,1993,NA,NA,276,273,3,56,0,56,0.2,0,0.2,11690,22,52,39
119173,MOUNT SAINT MARYS COLLEGE,1,0,1995,NA,NA,222,220,2,50,2,48,0.21,1,0.23,13812,28,72,30
119173,MOUNT SAINT MARYS COLLEGE,1,0,1996,NA,NA,112,112,0,61,0,61,0.54,NA,0.54,14014,30,65,30
119173,MOUNT SAINT MARYS COLLEGE,1,0,1997,NA,NA,258,258,0,82,0,82,0.31,NA,0.32,14716,30,76,44
119173,MOUNT SAINT MARYS COLLEGE,1,0,1998,NA,NA,295,293,2,62,0,62,0.21,0,0.21,15452,27,82,43
119173,MOUNT ST MARY'S COLLEGE,1,0,1999,NA,NA,294,293,1,57,0,57,0.19,0,0.19,16776,30,76,26
119173,MOUNT ST MARY'S COLLEGE,1,0,2000,NA,NA,297,296,1,67,1,66,0.22,1,0.23,17036,31,75,33
119173,MOUNT ST MARY'S COLLEGE,1,0,2001,NA,NA,328,325,3,47,1,46,0.14,0.33,0.14,17888,34,75,38
119173,MOUNT ST MARY'S COLLEGE,1,0,2002,NA,NA,127,123,4,64,1,63,0.51,0.25,0.5,18782,33,55,21
119173,MOUNT ST MARY'S COLLEGE,1,0,2003,NA,NA,339,330,9,84,4,80,0.24,0.44,0.25,19722,36,71,40
119173,MOUNT ST MARY'S COLLEGE,1,0,2004,NA,NA,364,352,12,93,4,89,0.25,0.33,0.26,20708,38,70,33
119173,Mount St Mary's College,1,0,2005,NA,NA,393,378,15,68,3,65,0.17,0.2,0.17,22054,40,74,46
119173,Mount St Mary's College,1,0,2006,NA,NA,345,336,9,76,1,75,0.22,0.11,0.22,23380,46,77,26
119173,Mount St Mary's College,1,0,2007,NA,NA,348,331,17,93,7,86,0.25,0.41,0.27,24550,46,81,20
119173,Mount St Mary's College,1,0,2008,NA,NA,313,302,11,84,2,82,0.27,0.18,0.27,26280,48,83,21
119173,Mount St Mary's College,1,0,2009,NA,NA,367,351,16,109,5,104,0.29,0.31,0.3,27840,54,90,17
119173,Mount St Mary's College,1,0,2010,NA,NA,525,507,18,140,3,137,0.27,0.17,0.27,29232,54,95,29
120184,COLLEGE OF NOTRE DAME,1,0,1991,NA,NA,71,51,20,25,6,19,0.37,0.3,0.35,10165,10,55,32
120184,COLLEGE OF NOTRE DAME,1,0,1992,NA,NA,85,54,31,34,14,20,0.37,0.45,0.4,11015,11,57,32
120184,COLLEGE OF NOTRE DAME,1,0,1993,NA,NA,96,76,20,36,5,31,0.4,0.25,0.38,11750,13,59,39
120184,COLLEGE OF NOTRE DAME,1,0,1995,NA,NA,115,79,36,44,9,35,0.44,0.25,0.38,13535,17,60,42
120184,COLLEGE OF NOTRE DAME,1,0,1996,NA,NA,124,75,49,49,16,33,0.44,0.33,0.4,14400,18,60,40
120184,COLLEGE OF NOTRE DAME,1,0,1997,NA,NA,129,79,50,38,15,23,0.29,0.3,0.29,14976,16,62,41
120184,COLLEGE OF NOTRE DAME,1,0,1998,NA,NA,130,80,50,52,14,38,0.47000000000000003,0.28,0.4,15576,18,63,40
120184,COLLEGE OF NOTRE DAME,1,0,1999,NA,NA,129,85,44,50,17,33,0.38,0.39,0.39,16200,18,66,38
120184,COLLEGE OF NOTRE DAME,1,0,2000,NA,NA,137,99,38,54,15,39,0.39,0.39,0.39,16850,20,61,49
120184,NOTRE DAME DE NAMUR UNIVERSITY,1,0,2001,NA,NA,111,85,26,55,10,45,0.52,0.38,0.5,18200,22,57,29
120184,NOTRE DAME DE NAMUR UNIVERSITY,1,0,2002,NA,NA,97,57,40,42,12,30,0.52,0.3,0.43,19110,23,51,43
120184,NOTRE DAME DE NAMUR UNIVERSITY,1,0,2003,NA,NA,190,106,84,90,36,54,0.5,0.43,0.47,20050,23,57,70
120184,NOTRE DAME DE NAMUR UNIVERSITY,1,0,2004,NA,NA,161,108,53,68,19,49,0.45,0.36,0.42,21350,23,52,78
120184,Notre Dame de Namur University,1,0,2005,NA,NA,144,95,49,59,14,45,0.47000000000000003,0.29,0.41,22520,26,50,50
120184,Notre Dame de Namur University,1,0,2006,NA,NA,134,93,41,51,15,36,0.38,0.37,0.38,23650,26,53,59
120184,Notre Dame de Namur University,1,0,2007,NA,NA,96,57,39,35,12,23,0.4,0.31,0.36,24450,27,54,30
120184,Notre Dame de Namur University,1,0,2008,NA,NA,147,85,62,63,21,42,0.49,0.34,0.43,25300,28,54,32
120184,Notre Dame de Namur University,1,0,2009,NA,NA,116,78,38,33,10,23,0.29,0.26,0.28,26830,27,55,26
120184,Notre Dame de Namur University,1,0,2010,NA,NA,145,94,51,50,15,35,0.37,0.29,0.34,28200,27,59,31
121309,POINT LOMA NAZARENE COLLEGE,0,1,1991,1992,0,317,194,123,103,34,69,0.35000000000000003,0.28,0.32,8058,29,92,243
121309,POINT LOMA NAZARENE COLLEGE,1,0,1992,1992,1,374,248,126,94,27,67,0.27,0.21,0.25,8838,28,91,317
121309,POINT LOMA NAZARENE COLLEGE,1,0,1993,1992,1,425,255,170,127,34,93,0.36,0.2,0.3,9542,32,94,361
121309,POINT LOMA NAZARENE COLLEGE,1,0,1995,1992,1,475,313,162,185,57,128,0.4,0.35,0.39,10880,37,101,405
121309,POINT LOMA NAZARENE COLLEGE,1,0,1996,1992,1,515,313,202,218,70,148,0.47000000000000003,0.35,0.42,11824,39,100,445
121309,POINT LOMA NAZARENE COLLEGE,1,0,1997,1992,1,494,306,188,187,64,123,0.4,0.34,0.38,12464,33,108,424
121309,POINT LOMA NAZARENE UNIVERSITY,1,0,1998,1992,1,598,375,223,261,87,174,0.46,0.39,0.44,12650,36,109,499
121309,POINT LOMA NAZARENE UNIVERSITY,1,0,1999,1992,1,613,392,221,332,117,215,0.54,0.53,0.54,13186,41,117,520
121309,POINT LOMA NAZARENE UNIVERSITY,1,0,2000,1992,1,539,312,227,274,101,173,0.55,0.44,0.51,13900,43,120,457
121309,POINT LOMA NAZARENE UNIVERSITY,1,0,2001,1992,1,545,346,199,327,106,221,0.63,0.53,0.6,14800,47,124,478
121309,POINT LOMA NAZARENE UNIVERSITY,1,0,2002,1992,1,535,324,211,321,111,210,0.64,0.53,0.6,15760,49,128,459
121309,POINT LOMA NAZARENE UNIVERSITY,1,0,2003,1992,1,566,356,210,353,119,234,0.65,0.57,0.62,18000,53,134,455
121309,POINT LOMA NAZARENE UNIVERSITY,1,0,2004,1992,1,535,339,196,395,141,254,0.74,0.72,0.74,19040,58,135,425
121309,Point Loma Nazarene University,1,0,2005,1992,1,562,339,223,348,125,223,0.65,0.56,0.62,20200,61,139,446
121309,Point Loma Nazarene University,1,0,2006,1992,1,537,342,195,352,118,234,0.68,0.61,0.66,21620,64,145,412
121309,Point Loma Nazarene University,1,0,2007,1992,1,530,336,194,327,109,218,0.64,0.56,0.62,23200,70,151,420
121309,Point Loma Nazarene University,1,0,2008,1992,1,538,327,211,318,116,202,0.61,0.55,0.59,24580,74,146,425
121309,Point Loma Nazarene University,1,0,2009,1992,1,533,343,190,338,113,225,0.65,0.59,0.63,25300,75,154,390
121309,Point Loma Nazarene University,1,0,2010,1992,1,588,360,228,367,130,237,0.65,0.57,0.62,26500,74,142,409
121345,POMONA COLLEGE,1,0,1991,NA,NA,359,164,195,294,155,139,0.84,0.79,0.82,14800,51,145,209
121345,POMONA COLLEGE,1,0,1992,NA,NA,382,192,190,316,148,168,0.87,0.78,0.83,15700,48,160,212
121345,POMONA COLLEGE,1,0,1993,NA,NA,390,183,207,317,167,150,0.81,0.81,0.81,16720,50,161,205
121345,POMONA COLLEGE,1,0,1995,NA,NA,392,190,202,336,166,170,0.89,0.82,0.86,18600,53,154,209
121345,POMONA COLLEGE,1,0,1996,NA,NA,396,187,209,331,173,158,0.84,0.83,0.84,19530,59,154,190
121345,POMONA COLLEGE,1,0,1997,NA,NA,393,195,198,338,166,172,0.88,0.84,0.86,20500,54,152,210
121345,POMONA COLLEGE,1,0,1998,NA,NA,396,182,214,321,168,153,0.84,0.79,0.81,21420,58,161,211
121345,POMONA COLLEGE,1,0,1999,NA,NA,390,194,196,338,167,171,0.88,0.85,0.87,22940,61,155,224
121345,POMONA COLLEGE,1,0,2000,NA,NA,398,208,190,346,163,183,0.87,0.86,0.87,23910,68,156,238
121345,POMONA COLLEGE,1,0,2001,NA,NA,393,192,201,339,173,166,0.86,0.86,0.86,24750,73,157,234
121345,POMONA COLLEGE,1,0,2002,NA,NA,374,191,183,338,158,180,0.9400000000000001,0.86,0.9,25730,79,168,224
121345,POMONA COLLEGE,1,0,2003,NA,NA,398,202,196,354,170,184,0.91,0.87,0.89,26890,81,174,208
121345,POMONA COLLEGE,1,0,2004,NA,NA,393,196,197,356,181,175,0.89,0.92,0.91,28100,85,181,204
121345,Pomona College,1,0,2005,NA,NA,382,193,189,347,169,178,0.92,0.89,0.91,29650,92,190,186
121345,Pomona College,1,0,2006,NA,NA,378,190,188,337,162,175,0.92,0.86,0.89,31580,97,197,185
121345,Pomona College,1,0,2007,NA,NA,375,188,187,348,172,176,0.93,0.92,0.93,33635,107,204,173
121345,Pomona College,1,0,2008,NA,NA,382,194,188,344,168,176,0.9,0.89,0.9,35318,117,199,174
121345,Pomona College,1,0,2009,NA,NA,389,190,199,355,180,175,0.92,0.9,0.91,36710,122,200,166
121345,Pomona College,1,0,2010,NA,NA,401,217,184,369,169,200,0.92,0.92,0.92,38087,119,200,191
122409,SAN DIEGO STATE UNIVERSITY,1,0,1991,NA,NA,2479,1440,1039,151,39,112,0.07,0.04,0.06,936,227,1018,1325
122409,SAN DIEGO STATE UNIVERSITY,1,0,1992,NA,NA,1974,1129,845,154,45,109,0.09,0.05,0.08,1500,227,940,947
122409,SAN DIEGO STATE UNIVERSITY,1,0,1993,NA,NA,1973,1081,892,126,25,101,0.09,0.03,0.06,1674,224,909,842
122409,SAN DIEGO STATE UNIVERSITY,1,0,1995,NA,NA,2840,1716,1124,212,58,154,0.08,0.05,0.07,1891,232,894,1238
122409,SAN DIEGO STATE UNIVERSITY,1,0,1996,NA,NA,2908,1752,1156,208,55,153,0.08,0.05,0.07,1935,239,891,1234
122409,SAN DIEGO STATE UNIVERSITY,1,0,1997,NA,NA,3008,1766,1242,280,73,207,0.11,0.06,0.09,1932,259,904,1347
122409,SAN DIEGO STATE UNIVERSITY,1,0,1998,NA,NA,3128,1815,1313,308,79,229,0.12,0.06,0.1,1784,270,907,1419
122409,SAN DIEGO STATE UNIVERSITY,1,0,1999,NA,NA,2834,1574,1260,394,119,275,0.17,0.09,0.14,0,455,934,1433
122409,SAN DIEGO STATE UNIVERSITY,1,0,2000,NA,NA,2719,1598,1121,472,130,342,0.21,0.12,0.17,0,491,984,1441
122409,SAN DIEGO STATE UNIVERSITY,1,0,2001,NA,NA,3338,1986,1352,664,178,486,0.24,0.13,0.2,0,552,1035,1694
122409,SAN DIEGO STATE UNIVERSITY,1,0,2002,NA,NA,3662,2217,1445,879,237,642,0.28,0.16,0.24,0,358,1042,1890
122409,SAN DIEGO STATE UNIVERSITY,1,0,2003,NA,NA,3418,2106,1312,973,286,687,0.32,0.22,0.28,0,376,977,1859
122409,SAN DIEGO STATE UNIVERSITY,1,0,2004,NA,NA,3527,2128,1399,1073,307,766,0.36,0.22,0.3,0,375,886,1905
122409,San Diego State University,1,0,2005,NA,NA,3439,2039,1400,1011,323,688,0.33,0.23,0.29,0,380,931,1807
122409,San Diego State University,1,0,2006,NA,NA,4109,2458,1651,1309,382,927,0.37,0.23,0.32,0,409,964,2158
122409,San Diego State University,1,0,2007,NA,NA,4506,2685,1821,1472,449,1023,0.38,0.25,0.33,0,442,959,2312
122409,San Diego State University,1,0,2008,NA,NA,3578,2086,1492,1053,346,707,0.33,0.23,0.29,0,461,966,1577
122409,San Diego State University,1,0,2009,NA,NA,3291,1881,1410,990,332,658,0.34,0.24,0.3,0,485,900,1389
122409,San Diego State University,1,0,2010,NA,NA,3031,1802,1229,1017,352,665,0.36,0.29,0.34,0,448,849,1332
122436,UNIVERSITY OF SAN DIEGO,1,0,1991,NA,NA,882,528,354,471,181,290,0.54,0.51,0.53,11440,87,254,645
122436,UNIVERSITY OF SAN DIEGO,1,0,1992,NA,NA,929,524,405,462,175,287,0.54,0.43,0.5,12240,95,263,636
122436,UNIVERSITY OF SAN DIEGO,1,0,1993,NA,NA,890,516,374,468,171,297,0.5700000000000001,0.46,0.53,12970,101,265,619
122436,UNIVERSITY OF SAN DIEGO,1,0,1995,NA,NA,978,597,381,500,186,314,0.52,0.49,0.51,14320,114,271,674
122436,UNIVERSITY OF SAN DIEGO,1,0,1996,NA,NA,1042,569,473,542,213,329,0.5700000000000001,0.45,0.52,14960,113,274,734
122436,UNIVERSITY OF SAN DIEGO,1,0,1997,NA,NA,1036,630,406,589,194,395,0.62,0.48,0.57,15780,118,283,736
122436,UNIVERSITY OF SAN DIEGO,1,0,1998,NA,NA,1028,614,414,610,222,388,0.63,0.54,0.59,16470,104,288,719
122436,UNIVERSITY OF SAN DIEGO,1,0,1999,NA,NA,990,621,369,611,204,407,0.65,0.55,0.62,17780,100,294,726
122436,UNIVERSITY OF SAN DIEGO,1,0,2000,NA,NA,1024,642,382,656,225,431,0.67,0.59,0.64,19020,126,305,745
122436,UNIVERSITY OF SAN DIEGO,1,0,2001,NA,NA,1003,646,357,635,217,418,0.64,0.61,0.63,20350,140,316,677
122436,UNIVERSITY OF SAN DIEGO,1,0,2002,NA,NA,1049,681,368,672,219,453,0.66,0.6,0.64,21880,159,328,732
122436,UNIVERSITY OF SAN DIEGO,1,0,2003,NA,NA,1059,718,341,695,208,487,0.67,0.61,0.66,23410,172,341,726
122436,UNIVERSITY OF SAN DIEGO,1,0,2004,NA,NA,1174,705,469,706,259,447,0.63,0.55,0.6,24860,186,340,830
122436,University of San Diego,1,0,2005,NA,NA,1131,710,421,726,238,488,0.68,0.57,0.64,26350,202,359,760
122436,University of San Diego,1,0,2006,NA,NA,1103,703,400,714,214,500,0.71,0.54,0.65,30480,217,363,702
122436,University of San Diego,1,0,2007,NA,NA,1089,635,454,704,254,450,0.7000000000000001,0.56,0.65,32300,228,367,654
122436,University of San Diego,1,0,2008,NA,NA,1259,771,488,838,289,549,0.71,0.59,0.67,34000,240,369,810
122436,University of San Diego,1,0,2009,NA,NA,1081,621,460,714,259,455,0.73,0.56,0.66,35870,250,381,645
122436,University of San Diego,1,0,2010,NA,NA,1148,662,486,752,280,472,0.71,0.58,0.66,36950,249,393,729
122597,SAN FRANCISCO STATE UNIVERSITY,1,0,1991,NA,NA,1219,774,445,72,28,44,0.05,0.06,0.06,936,173,807,308
122597,SAN FRANCISCO STATE UNIVERSITY,1,0,1992,NA,NA,1125,693,432,73,19,54,0.07,0.04,0.06,1444,177,727,276
122597,SAN FRANCISCO STATE UNIVERSITY,1,0,1993,NA,NA,1141,668,473,60,16,44,0.06,0.03,0.05,1674,177,709,263
122597,SAN FRANCISCO STATE UNIVERSITY,1,0,1995,NA,NA,1539,966,573,89,26,63,0.06,0.05,0.06,1891,213,728,349
122597,SAN FRANCISCO STATE UNIVERSITY,1,0,1996,NA,NA,1727,1102,625,111,35,76,0.06,0.06,0.06,1935,221,760,393
122597,SAN FRANCISCO STATE UNIVERSITY,1,0,1997,NA,NA,1732,1086,646,115,36,79,0.07,0.06,0.07,1978,260,767,380
122597,SAN FRANCISCO STATE UNIVERSITY,1,0,1998,NA,NA,1805,1143,662,134,23,111,0.09,0.03,0.07,1884,270,772,413
122597,SAN FRANCISCO STATE UNIVERSITY,1,0,1999,NA,NA,1898,1158,740,178,54,124,0.1,0.07,0.09,0,270,793,491
122597,SAN FRANCISCO STATE UNIVERSITY,1,0,2000,NA,NA,1870,1212,658,205,54,151,0.12,0.08,0.11,0,321,781,474
122597,SAN FRANCISCO STATE UNIVERSITY,1,0,2001,NA,NA,1820,1157,663,209,58,151,0.13,0.09,0.11,0,330,769,477
122597,SAN FRANCISCO STATE UNIVERSITY,1,0,2002,NA,NA,2130,1378,752,211,52,159,0.11,0.07,0.1,0,318,784,510
122597,SAN FRANCISCO STATE UNIVERSITY,1,0,2003,NA,NA,2291,1474,817,267,69,198,0.13,0.08,0.12,0,334,792,685
122597,SAN FRANCISCO STATE UNIVERSITY,1,0,2004,NA,NA,2739,1770,969,390,114,276,0.15,0.12,0.14,0,349,767,843
122597,San Francisco State University,1,0,2005,NA,NA,2999,1942,1057,360,105,255,0.13,0.1,0.12,0,363,775,981
122597,San Francisco State University,1,0,2006,NA,NA,3117,2017,1100,418,128,290,0.14,0.12,0.13,0,372,787,1019
122597,San Francisco State University,1,0,2007,NA,NA,3341,2123,1218,424,118,306,0.14,0.1,0.13,0,401,845,1118
122597,San Francisco State University,1,0,2008,NA,NA,3512,2334,1178,524,145,379,0.16,0.12,0.15,0,431,860,1157
122597,San Francisco State University,1,0,2009,NA,NA,3855,2497,1358,704,178,526,0.21,0.13,0.18,0,437,852,1182
122597,San Francisco State University,1,0,2010,NA,NA,3609,2179,1430,648,210,438,0.2,0.15,0.18,0,425,803,1049
122612,UNIVERSITY OF SAN FRANCISCO,1,0,1991,NA,NA,459,299,160,205,72,133,0.44,0.45,0.45,11040,76,240,227
122612,UNIVERSITY OF SAN FRANCISCO,1,0,1992,NA,NA,492,319,173,233,75,158,0.49,0.43,0.47,11816,91,261,219
122612,UNIVERSITY OF SAN FRANCISCO,1,0,1993,NA,NA,530,359,171,225,61,164,0.45,0.36,0.42,12578,99,262,208
122612,UNIVERSITY OF SAN FRANCISCO,1,0,1995,NA,NA,550,350,200,237,71,166,0.47000000000000003,0.36,0.43,14108,115,284,196
122612,UNIVERSITY OF SAN FRANCISCO,1,0,1996,NA,NA,616,413,203,307,89,218,0.52,0.44,0.5,14920,118,290,214
122612,UNIVERSITY OF SAN FRANCISCO,1,0,1997,NA,NA,600,385,215,285,96,189,0.49,0.45,0.48,15850,130,303,210
122612,UNIVERSITY OF SAN FRANCISCO,1,0,1998,NA,NA,640,436,204,296,80,216,0.49,0.39,0.46,16630,134,303,249
122612,UNIVERSITY OF SAN FRANCISCO,1,0,1999,NA,NA,757,500,257,379,109,270,0.54,0.42,0.5,17710,142,332,328
122612,UNIVERSITY OF SAN FRANCISCO,1,0,2000,NA,NA,757,518,239,363,100,263,0.5,0.42,0.48,18860,151,321,315
122612,UNIVERSITY OF SAN FRANCISCO,1,0,2001,NA,NA,840,572,268,411,114,297,0.51,0.43,0.49,20190,137,310,357
122612,UNIVERSITY OF SAN FRANCISCO,1,0,2002,NA,NA,839,582,257,431,132,299,0.51,0.51,0.51,21660,151,326,303
122612,UNIVERSITY OF SAN FRANCISCO,1,0,2003,NA,NA,914,632,282,452,131,321,0.5,0.46,0.49,23220,160,345,351
122612,UNIVERSITY OF SAN FRANCISCO,1,0,2004,NA,NA,929,614,315,518,151,367,0.59,0.48,0.56,24800,176,344,358
122612,University of San Francisco,1,0,2005,NA,NA,932,665,267,542,131,411,0.61,0.49,0.58,26680,186,348,372
122612,University of San Francisco,1,0,2006,NA,NA,1073,733,340,582,166,416,0.56,0.49,0.54,28420,196,367,417
122612,University of San Francisco,1,0,2007,NA,NA,1052,680,372,595,179,416,0.61,0.48,0.57,30840,209,371,428
122612,University of San Francisco,1,0,2008,NA,NA,1036,686,350,632,196,436,0.63,0.56,0.61,33160,227,380,439
122612,University of San Francisco,1,0,2009,NA,NA,1073,744,329,648,172,476,0.63,0.52,0.6,34430,242,386,416
122612,University of San Francisco,1,0,2010,NA,NA,1171,750,421,721,233,488,0.65,0.55,0.62,36000,241,394,413
122931,SANTA CLARA UNIVERSITY,0,1,1991,Inf,0,928,457,471,675,335,340,0.74,0.71,0.73,11271,100,317,620
122931,SANTA CLARA UNIVERSITY,0,1,1992,Inf,0,900,458,442,661,303,358,0.78,0.69,0.73,12150,104,326,552
122931,SANTA CLARA UNIVERSITY,0,1,1993,Inf,0,888,489,399,657,287,370,0.75,0.72,0.74,12879,114,324,492
122931,SANTA CLARA UNIVERSITY,0,1,1995,Inf,0,1043,558,485,757,329,428,0.76,0.68,0.73,14604,126,322,580
122931,SANTA CLARA UNIVERSITY,0,1,1996,Inf,0,1075,586,489,798,349,449,0.76,0.71,0.74,15450,135,344,618
122931,SANTA CLARA UNIVERSITY,0,1,1997,Inf,0,1004,543,461,766,328,438,0.8,0.71,0.76,16455,116,359,592
122931,SANTA CLARA UNIVERSITY,0,1,1998,Inf,0,1032,570,462,783,331,452,0.79,0.72,0.76,17442,123,369,588
122931,SANTA CLARA UNIVERSITY,0,1,1999,Inf,0,1101,619,482,854,358,496,0.8,0.74,0.78,19095,129,399,649
122931,SANTA CLARA UNIVERSITY,0,1,2000,Inf,0,1025,544,481,814,366,448,0.8200000000000001,0.76,0.79,20337,140,405,601
122931,SANTA CLARA UNIVERSITY,0,1,2001,Inf,0,1017,556,461,799,339,460,0.8200000000000001,0.74,0.79,22572,153,411,597
122931,SANTA CLARA UNIVERSITY,0,1,2002,Inf,0,1116,659,457,873,342,531,0.8,0.75,0.78,23925,166,413,694
122931,SANTA CLARA UNIVERSITY,0,1,2003,Inf,0,892,509,383,690,284,406,0.79,0.74,0.77,25365,176,416,566
122931,SANTA CLARA UNIVERSITY,0,1,2004,Inf,0,1171,658,513,941,392,549,0.8300000000000001,0.76,0.8,27135,185,423,693
122931,Santa Clara University,0,1,2005,Inf,0,1197,667,530,917,384,533,0.79,0.72,0.77,28899,192,447,699
122931,Santa Clara University,0,1,2006,Inf,0,1340,740,600,1055,448,607,0.8200000000000001,0.75,0.79,30900,202,474,655
122931,Santa Clara University,0,1,2007,Inf,0,1201,619,582,923,431,492,0.79,0.74,0.77,33000,216,506,548
122931,Santa Clara University,0,1,2008,Inf,0,1220,623,597,951,436,515,0.8200000000000001,0.73,0.78,34950,233,512,471
122931,Santa Clara University,0,1,2009,Inf,0,1084,571,513,830,371,459,0.8,0.72,0.77,36000,251,434,412
122931,Santa Clara University,0,1,2010,Inf,0,1295,644,651,1056,498,558,0.86,0.76,0.82,37368,253,448,639
123554,SAINT MARY'S COLLEGE OF CALIFORNIA,1,0,1991,NA,NA,437,241,196,247,101,146,0.6,0.52,0.57,11036,42,123,292
123554,SAINT MARY'S COLLEGE OF CALIFORNIA,1,0,1992,NA,NA,472,257,215,289,126,163,0.63,0.59,0.61,11966,43,135,324
123554,SAINT MARYS COLLEGE OF CALIFORNIA,1,0,1993,NA,NA,464,249,215,294,128,166,0.66,0.6,0.63,12636,49,135,301
123554,SAINT MARYS COLLEGE OF CALIFORNIA,1,0,1995,NA,NA,474,256,218,306,141,165,0.64,0.65,0.65,14250,55,160,326
123554,SAINT MARYS COLLEGE OF CALIFORNIA,1,0,1996,NA,NA,488,288,200,307,102,205,0.71,0.51,0.63,15098,53,155,317
123554,SAINT MARYS COLLEGE OF CALIFORNIA,1,0,1997,NA,NA,596,348,248,390,144,246,0.7000000000000001,0.58,0.65,15880,52,164,388
123554,SAINT MARYS COLLEGE OF CALIFORNIA,1,0,1998,NA,NA,573,343,230,352,125,227,0.66,0.54,0.61,16809,55,172,386
123554,SAINT MARYS COLLEGE OF CALIFORNIA,1,0,1999,NA,NA,629,363,266,369,142,227,0.62,0.53,0.59,17340,59,175,404
123554,SAINT MARYS COLLEGE OF CALIFORNIA,1,0,2000,NA,NA,620,366,254,368,149,219,0.59,0.59,0.59,18120,62,178,388
123554,SAINT MARYS COLLEGE OF CALIFORNIA,1,0,2001,NA,NA,580,352,228,350,129,221,0.62,0.57,0.6,19390,67,182,344
123554,SAINT MARYS COLLEGE OF CALIFORNIA,1,0,2002,NA,NA,663,408,255,381,141,240,0.58,0.55,0.57,20750,72,185,389
123554,SAINT MARYS COLLEGE OF CALIFORNIA,1,0,2003,NA,NA,562,317,245,285,106,179,0.56,0.43,0.51,23640,81,199,327
123554,SAINT MARYS COLLEGE OF CALIFORNIA,1,0,2004,NA,NA,603,388,215,319,102,217,0.55,0.47,0.53,25000,88,198,299
123554,Saint Marys College of California,1,0,2005,NA,NA,659,399,260,313,107,206,0.51,0.41,0.47,27130,91,197,347
123554,Saint Marys College of California,1,0,2006,NA,NA,600,384,216,292,105,187,0.48,0.49,0.49,28900,88,200,299
123554,Saint Marys College of California,1,0,2007,NA,NA,600,366,234,283,102,181,0.49,0.44,0.47,30930,93,207,342
123554,Saint Marys College of California,1,0,2008,NA,NA,665,436,229,349,100,249,0.5700000000000001,0.44,0.52,33100,99,207,326
123554,Saint Marys College of California,1,0,2009,NA,NA,567,354,213,320,101,219,0.61,0.47,0.56,33760,103,202,254
123554,Saint Marys College of California,1,0,2010,NA,NA,694,421,273,387,139,248,0.58,0.51,0.56,35280,100,189,308
123572,SONOMA STATE UNIVERSITY,1,0,1991,NA,NA,680,429,251,95,18,77,0.17,0.07,0.14,936,57,260,459
123572,SONOMA STATE UNIVERSITY,1,0,1992,NA,NA,591,380,211,97,20,77,0.2,0.09,0.16,1474,59,241,407
123572,SONOMA STATE UNIVERSITY,1,0,1993,NA,NA,539,362,177,82,18,64,0.17,0.1,0.15,1674,57,233,355
123572,SONOMA STATE UNIVERSITY,1,0,1995,NA,NA,681,441,240,131,41,90,0.2,0.17,0.19,1891,61,238,459
123572,SONOMA STATE UNIVERSITY,1,0,1996,NA,NA,781,502,279,156,36,120,0.23,0.13,0.2,1935,65,243,538
123572,SONOMA STATE UNIVERSITY,1,0,1997,NA,NA,872,581,291,192,43,149,0.25,0.15,0.22,2110,75,234,586
123572,SONOMA STATE UNIVERSITY,1,0,1998,NA,NA,823,557,266,177,37,140,0.25,0.14,0.22,2082,72,249,545
123572,SONOMA STATE UNIVERSITY,1,0,1999,NA,NA,844,555,289,161,24,137,0.24,0.08,0.19,0,83,243,551
123572,SONOMA STATE UNIVERSITY,1,0,2000,NA,NA,1064,714,350,236,46,190,0.26,0.13,0.22,0,110,248,705
123572,SONOMA STATE UNIVERSITY,1,0,2001,NA,NA,1018,673,345,258,53,205,0.3,0.15,0.25,0,118,254,691
123572,SONOMA STATE UNIVERSITY,1,0,2002,NA,NA,1210,816,394,289,53,236,0.28,0.13,0.24,0,124,254,825
123572,SONOMA STATE UNIVERSITY,1,0,2003,NA,NA,1287,838,449,341,80,261,0.31,0.18,0.26,0,132,267,918
123572,SONOMA STATE UNIVERSITY,1,0,2004,NA,NA,1102,713,389,344,76,268,0.37,0.2,0.31,0,146,240,778
123572,Sonoma State University,1,0,2005,NA,NA,1043,697,346,309,69,240,0.34,0.2,0.3,0,141,263,719
123572,Sonoma State University,1,0,2006,NA,NA,1513,1033,480,410,104,306,0.29,0.22,0.27,0,142,266,985
123572,Sonoma State University,1,0,2007,NA,NA,1673,1073,600,434,97,337,0.31,0.16,0.26,0,153,273,1150
123572,Sonoma State University,1,0,2008,NA,NA,1631,1058,573,444,96,348,0.32,0.17,0.27,0,148,274,1136
123572,Sonoma State University,1,0,2009,NA,NA,1465,953,512,413,94,319,0.33,0.18,0.28,0,150,272,913
123572,Sonoma State University,1,0,2010,NA,NA,1547,925,622,430,106,324,0.35000000000000003,0.17,0.28,0,143,254,878
126562,UNIVERSITY OF COLORADO AT DENVER,1,0,1991,NA,NA,262,152,110,25,7,18,0.11,0.06,0.1,1808,63,347,128
126562,UNIVERSITY OF COLORADO AT DENVER,1,0,1992,NA,NA,272,175,97,29,6,23,0.13,0.06,0.11,1917,66,355,131
126562,UNIVERSITY OF COLORADO AT DENVER,1,0,1993,NA,NA,243,141,102,38,9,29,0.2,0.09,0.16,1955,75,368,131
126562,UNIVERSITY OF COLORADO AT DENVER,1,0,1995,NA,NA,266,166,100,41,14,27,0.16,0.14,0.15,2098,81,374,124
126562,UNIVERSITY OF COLORADO AT DENVER,1,0,1996,NA,NA,373,215,158,54,20,34,0.15,0.13,0.14,2183,88,382,229
126562,UNIVERSITY OF COLORADO AT DENVER,1,0,1997,NA,NA,439,245,194,63,23,40,0.16,0.12,0.14,2191,94,411,231
126562,UNIVERSITY OF COLORADO AT DENVER,1,0,1998,NA,NA,394,223,171,58,17,41,0.18,0.1,0.15,2255,100,392,202
126562,UNIVERSITY OF COLORADO AT DENVER,1,0,1999,NA,NA,478,259,219,76,30,46,0.17,0.14,0.16,2068,107,417,253
126562,UNIVERSITY OF COLORADO AT DENVER,1,0,2000,NA,NA,515,296,219,71,23,48,0.16,0.11,0.14,2298,114,423,271
126562,UNIVERSITY OF COLORADO AT DENVER,1,0,2001,NA,NA,492,288,204,63,27,36,0.12,0.13,0.13,2934,128,429,287
126562,UNIVERSITY OF COLORADO AT DENVER,1,0,2002,NA,NA,580,326,254,86,26,60,0.18,0.1,0.15,2752,131,509,356
126562,UNIVERSITY OF COLORADO AT DENVER,1,0,2003,NA,NA,624,353,271,104,36,68,0.19,0.13,0.17,3028,118,465,380
126562,UNIVERSITY OF COLORADO AT DENVER,1,0,2004,NA,NA,686,387,299,101,34,67,0.17,0.11,0.15,3300,118,450,414
126562,University of Colorado at Denver and Health Sciences Center,1,0,2005,NA,NA,744,414,330,108,30,78,0.18,0.09,0.15,4224,831,616,435
126562,University of Colorado at Denver and Health Sciences Center,1,0,2006,NA,NA,885,510,375,155,52,103,0.2,0.14,0.18,4330,906,637,514
126562,University of Colorado Denver,1,0,2007,NA,NA,1010,571,439,163,66,97,0.16,0.15,0.16,5054,984,639,565
126562,University of Colorado Denver,1,0,2008,NA,NA,1036,603,433,156,68,88,0.14,0.16,0.15,5484,1067,705,597
126562,University of Colorado Denver,1,0,2009,NA,NA,1037,556,481,172,64,108,0.19,0.13,0.17,5712,1161,755,524
126562,University of Colorado Denver,1,0,2010,NA,NA,1020,551,469,210,76,134,0.24,0.16,0.21,6216,1198,816,522
126580,UNIVERSITY OF COLORADO-COLORADO SPRINGS,1,0,1991,NA,NA,319,183,136,36,12,24,0.13,0.09,0.11,2044,33,156,270
126580,UNIVERSITY OF COLORADO-COLORADO SPRINGS,1,0,1992,NA,NA,313,174,139,29,9,20,0.11,0.06,0.09,2167,35,159,241
126580,UNIVERSITY OF COLORADO AT COLORADO SPRINGS,1,0,1993,NA,NA,306,164,142,46,18,28,0.17,0.13,0.15,2225,36,161,252
126580,UNIVERSITY OF COLORADO AT COLORADO SPRINGS,1,0,1995,NA,NA,363,197,166,88,36,52,0.26,0.22,0.24,2375,38,181,283
126580,UNIVERSITY OF COLORADO AT COLORADO SPRINGS,1,0,1996,NA,NA,375,227,148,63,18,45,0.19,0.12,0.17,2439,39,180,295
126580,UNIVERSITY OF COLORADO AT COLORADO SPRINGS,1,0,1997,NA,NA,519,298,221,83,27,56,0.18,0.12,0.16,2681,45,208,400
126580,UNIVERSITY OF COLORADO AT COLORADO SPRINGS,1,0,1998,NA,NA,635,372,263,154,53,101,0.27,0.2,0.24,2681,52,219,500
126580,UNIVERSITY OF COLORADO AT COLORADO SPRINGS,1,0,1999,NA,NA,682,395,287,104,35,69,0.17,0.12,0.15,2234,123,206,524
126580,UNIVERSITY OF COLORADO AT COLORADO SPRINGS,1,0,2000,NA,NA,718,457,261,162,38,124,0.27,0.15,0.23,2690,58,214,551
126580,UNIVERSITY OF COLORADO AT COLORADO SPRINGS,1,0,2001,NA,NA,785,453,332,171,54,117,0.25,0.16,0.22,2864,64,222,596
126580,UNIVERSITY OF COLORADO AT COLORADO SPRINGS,1,0,2002,NA,NA,834,501,333,211,66,145,0.28,0.2,0.25,3154,75,259,658
126580,UNIVERSITY OF COLORADO AT COLORADO SPRINGS,1,0,2003,NA,NA,892,552,340,193,43,150,0.27,0.13,0.22,3026,71,251,694
126580,UNIVERSITY OF COLORADO AT COLORADO SPRINGS,1,0,2004,NA,NA,939,562,377,198,54,144,0.25,0.14,0.21,3296,76,266,726
126580,University of Colorado at Colorado Springs,1,0,2005,NA,NA,947,595,352,210,50,160,0.26,0.14,0.22,3966,82,296,737
126580,University of Colorado at Colorado Springs,1,0,2006,NA,NA,914,531,383,216,75,141,0.26,0.2,0.24,4054,83,247,693
126580,University of Colorado at Colorado Springs,1,0,2007,NA,NA,933,511,422,247,89,158,0.3,0.21,0.26,4338,91,263,676
126580,University of Colorado at Colorado Springs,1,0,2008,NA,NA,1075,577,498,288,110,178,0.3,0.22,0.27,4464,103,305,815
126580,University of Colorado at Colorado Springs,1,0,2009,NA,NA,1035,543,492,247,98,149,0.27,0.2,0.24,4680,109,317,742
126580,University of Colorado at Colorado Springs,1,0,2010,NA,NA,1123,568,555,284,112,172,0.3,0.2,0.25,5016,118,317,798
126614,UNIVERSITY OF COLORADO AT BOULDER,1,0,1991,NA,NA,3421,1631,1790,1268,550,718,0.44,0.31,0.37,3066,376,909,2666
126614,UNIVERSITY OF COLORADO AT BOULDER,1,0,1992,NA,NA,3559,1700,1859,1198,514,684,0.4,0.28,0.34,2560,416,1024,2818
126614,UNIVERSITY OF COLORADO AT BOULDER,1,0,1993,NA,NA,3440,1693,1747,1215,509,706,0.41000000000000003,0.29,0.35,2574,440,1081,2656
126614,UNIVERSITY OF COLORADO AT BOULDER,1,0,1995,NA,NA,4170,2020,2150,1454,602,852,0.42,0.28,0.35,2770,473,1093,3359
126614,UNIVERSITY OF COLORADO AT BOULDER,1,0,1996,NA,NA,3953,1983,1970,1529,623,906,0.45,0.32,0.39,2840,501,1084,3224
126614,UNIVERSITY OF COLORADO AT BOULDER,1,0,1997,NA,NA,4259,2157,2102,1565,633,932,0.43,0.3,0.37,2939,526,1063,3456
126614,UNIVERSITY OF COLORADO AT BOULDER,1,0,1998,NA,NA,4263,2037,2226,1545,647,898,0.44,0.29,0.36,3038,575,1094,3483
126614,UNIVERSITY OF COLORADO AT BOULDER,1,0,1999,NA,NA,4545,2303,2242,1728,700,1028,0.44,0.31,0.38,2444,576,1076,3768
126614,UNIVERSITY OF COLORADO AT BOULDER,1,0,2000,NA,NA,5047,2445,2602,1937,829,1108,0.45,0.32,0.38,2514,639,1076,4131
126614,UNIVERSITY OF COLORADO AT BOULDER,1,0,2001,NA,NA,4962,2396,2566,2013,887,1126,0.46,0.35,0.41,2614,662,1076,3899
126614,UNIVERSITY OF COLORADO AT BOULDER,1,0,2002,NA,NA,5377,2607,2770,2218,1001,1217,0.46,0.36,0.41,2776,671,1127,4294
126614,UNIVERSITY OF COLORADO AT BOULDER,1,0,2003,NA,NA,5515,2761,2754,2267,966,1301,0.47000000000000003,0.35,0.41,3192,692,1105,4461
126614,UNIVERSITY OF COLORADO AT BOULDER,1,0,2004,NA,NA,5124,2484,2640,2093,909,1184,0.47000000000000003,0.34,0.41,3480,711,1108,4025
126614,University of Colorado at Boulder,1,0,2005,NA,NA,5007,2364,2643,2007,900,1107,0.46,0.34,0.4,4446,768,1115,3977
126614,University of Colorado at Boulder,1,0,2006,NA,NA,5606,2688,2918,2336,1016,1320,0.49,0.35,0.42,4554,790,1166,4416
126614,University of Colorado at Boulder,1,0,2007,NA,NA,5540,2734,2806,2456,1059,1397,0.51,0.38,0.44,5418,836,1223,4405
126614,University of Colorado at Boulder,1,0,2008,NA,NA,5811,2890,2921,2678,1158,1520,0.52,0.4,0.46,5922,875,1368,4568
126614,University of Colorado at Boulder,1,0,2009,NA,NA,5515,2719,2796,2598,1102,1496,0.55,0.39,0.47,6446,941,1395,4285
126614,University of Colorado Boulder,1,0,2010,NA,NA,5138,2403,2735,2438,1094,1344,0.55,0.4,0.47,7018,994,1385,4000
126818,COLORADO STATE UNIVERSITY,1,0,1991,NA,NA,2155,1144,1011,516,173,343,0.29,0.17,0.24,2362,311,935,1773
126818,COLORADO STATE UNIVERSITY,1,0,1992,NA,NA,2202,1150,1052,575,205,370,0.32,0.19,0.26,2511,334,937,1872
126818,COLORADO STATE UNIVERSITY,1,0,1993,NA,NA,2168,1160,1008,611,210,401,0.34,0.21,0.28,2558,338,926,1803
126818,COLORADO STATE UNIVERSITY,1,0,1995,NA,NA,2546,1354,1192,805,287,518,0.38,0.24,0.32,2771,393,935,2155
126818,COLORADO STATE UNIVERSITY,1,0,1996,NA,NA,2695,1511,1184,847,307,540,0.35000000000000003,0.26,0.31,2847,411,948,2299
126818,COLORADO STATE UNIVERSITY,1,0,1997,NA,NA,2615,1435,1180,861,304,557,0.38,0.26,0.33,2925,418,939,2230
126818,COLORADO STATE UNIVERSITY,1,0,1998,NA,NA,3028,1772,1256,1028,301,727,0.41000000000000003,0.24,0.34,2986,475,919,2590
126818,COLORADO STATE UNIVERSITY,1,0,1999,NA,NA,3076,1702,1374,1054,371,683,0.4,0.27,0.34,2340,467,921,2642
126818,COLORADO STATE UNIVERSITY,1,0,2000,NA,NA,3240,1862,1378,1119,370,749,0.4,0.27,0.35,2408,503,927,2710
126818,COLORADO STATE UNIVERSITY,1,0,2001,NA,NA,3683,2061,1622,1285,420,865,0.41000000000000003,0.26,0.35,2502,516,934,3112
126818,COLORADO STATE UNIVERSITY,1,0,2002,NA,NA,3783,2121,1662,1340,442,898,0.42,0.27,0.35,2655,583,898,3159
126818,COLORADO STATE UNIVERSITY,1,0,2003,NA,NA,3730,2012,1718,1319,483,836,0.41000000000000003,0.28,0.35,2908,602,1088,3142
126818,COLORADO STATE UNIVERSITY,1,0,2004,NA,NA,4047,2216,1831,1484,522,962,0.43,0.29,0.37,2940,603,1099,3412
126818,Colorado State University,1,0,2005,NA,NA,3622,2036,1586,1278,406,872,0.42,0.26,0.35,3381,586,1099,2994
126818,Colorado State University,1,0,2006,NA,NA,3825,2166,1659,1448,441,1007,0.46,0.27,0.38,3466,622,1122,3136
126818,Colorado State University,1,0,2007,NA,NA,4352,2387,1965,1609,564,1045,0.43,0.29,0.37,4040,662,1136,3659
126818,Colorado State University,1,0,2008,NA,NA,4386,2435,1951,1693,567,1126,0.46,0.29,0.39,4424,738,1184,3479
126818,Colorado State University,1,0,2009,NA,NA,4274,2360,1914,1732,593,1139,0.48,0.31,0.41,4822,782,1175,3303
126818,Colorado State University-Fort Collins,1,0,2010,NA,NA,4321,2414,1907,1820,656,1164,0.48,0.34,0.42,5256,777,1175,3339
127060,UNIVERSITY OF DENVER,0,1,1991,Inf,0,504,265,239,280,123,157,0.59,0.51,0.56,12990,107,375,396
127060,UNIVERSITY OF DENVER,0,1,1992,Inf,0,555,284,271,303,130,173,0.6,0.48,0.55,13572,114,374,425
127060,UNIVERSITY OF DENVER,0,1,1993,Inf,0,576,306,270,332,144,188,0.61,0.53,0.58,14472,122,378,438
127060,UNIVERSITY OF DENVER,0,1,1995,Inf,0,654,330,324,376,175,201,0.6,0.54,0.57,16056,143,389,506
127060,UNIVERSITY OF DENVER,0,1,1996,Inf,0,717,372,345,389,168,221,0.59,0.49,0.54,16848,155,402,515
127060,UNIVERSITY OF DENVER,0,1,1997,Inf,0,689,354,335,387,173,214,0.6,0.52,0.56,17640,149,403,495
127060,UNIVERSITY OF DENVER,0,1,1998,Inf,0,768,393,375,414,185,229,0.58,0.49,0.54,18468,149,405,598
127060,UNIVERSITY OF DENVER,0,1,1999,Inf,0,812,410,402,420,181,239,0.58,0.45,0.52,18936,157,402,671
127060,UNIVERSITY OF DENVER,0,1,2000,Inf,0,926,505,421,526,214,312,0.61,0.51,0.57,20052,181,413,764
127060,UNIVERSITY OF DENVER,0,1,2001,Inf,0,933,486,447,561,249,312,0.64,0.56,0.6,21456,201,425,749
127060,UNIVERSITY OF DENVER,0,1,2002,Inf,0,988,527,461,571,235,336,0.63,0.51,0.58,22680,209,439,803
127060,UNIVERSITY OF DENVER,0,1,2003,Inf,0,1010,549,461,540,216,324,0.59,0.47,0.53,24264,227,440,850
127060,UNIVERSITY OF DENVER,0,1,2004,Inf,0,1124,588,536,633,286,347,0.59,0.53,0.56,25956,245,463,924
127060,University of Denver,0,1,2005,Inf,0,1089,608,481,655,251,404,0.66,0.52,0.6,27756,261,488,895
127060,University of Denver,0,1,2006,Inf,0,1135,615,520,692,290,402,0.65,0.56,0.61,29628,279,534,900
127060,University of Denver,0,1,2007,Inf,0,1130,619,511,752,321,431,0.6900000000000001,0.63,0.67,31428,292,574,727
127060,University of Denver,0,1,2008,Inf,0,1131,633,498,743,317,426,0.67,0.64,0.66,32976,312,586,796
127060,University of Denver,0,1,2009,Inf,0,1196,684,512,797,314,483,0.7000000000000001,0.61,0.67,34596,325,612,829
127060,University of Denver,0,1,2010,Inf,0,1215,663,552,806,320,486,0.73,0.58,0.66,35604,327,635,866
127185,FORT LEWIS COLLEGE,0,1,1991,2000,0,935,424,511,67,30,37,0.08,0.06,0.07,1550,26,167,731
127185,FORT LEWIS COLLEGE,0,1,1992,2000,0,1004,439,565,118,49,69,0.15,0.09,0.12,1701,28,170,785
127185,FORT LEWIS COLLEGE,0,1,1993,2000,0,1078,438,640,95,39,56,0.12,0.06,0.09,1777,32,165,851
127185,FORT LEWIS COLLEGE,0,1,1995,2000,0,1010,434,576,96,26,70,0.16,0.05,0.1,1904,35,174,777
127185,FORT LEWIS COLLEGE,0,1,1996,2000,0,1124,493,631,122,43,79,0.16,0.07,0.11,2050,37,165,890
127185,FORT LEWIS COLLEGE,0,1,1997,2000,0,1056,450,606,97,39,58,0.12,0.06,0.09,2084,38,175,797
127185,FORT LEWIS COLLEGE,0,1,1998,2000,0,970,405,565,108,46,62,0.15,0.08,0.11,2110,41,174,722
127185,FORT LEWIS COLLEGE,0,1,1999,2000,0,1019,429,590,102,37,65,0.15,0.06,0.1,1676,46,175,728
127185,FORT LEWIS COLLEGE,1,0,2000,2000,1,938,428,510,120,45,75,0.17,0.09,0.13,1724,45,178,674
127185,FORT LEWIS COLLEGE,1,0,2001,2000,1,1047,469,578,139,50,89,0.18,0.09,0.13,1792,49,181,702
127185,FORT LEWIS COLLEGE,1,0,2002,2000,1,1035,467,568,147,59,88,0.18,0.1,0.14,1902,48,177,730
127185,FORT LEWIS COLLEGE,1,0,2003,2000,1,899,422,477,138,51,87,0.2,0.11,0.15,2020,51,176,622
127185,FORT LEWIS COLLEGE,1,0,2004,2000,1,930,448,482,181,67,114,0.25,0.14,0.19,2270,47,185,645
127185,Fort Lewis College,1,0,2005,2000,1,860,386,474,161,70,91,0.23,0.15,0.19,4862,51,190,580
127185,Fort Lewis College,1,0,2006,2000,1,821,367,454,161,59,102,0.27,0.13,0.2,5102,51,174,518
127185,Fort Lewis College,1,0,2007,2000,1,863,404,459,149,50,99,0.24,0.11,0.17,5138,54,171,565
127185,Fort Lewis College,1,0,2008,2000,1,758,355,403,136,62,74,0.2,0.15,0.18,2846,57,175,475
127185,Fort Lewis College,1,0,2009,2000,1,766,344,422,138,64,74,0.21,0.15,0.18,3102,60,183,515
127185,Fort Lewis College,1,0,2010,2000,1,830,393,437,203,74,129,0.32,0.17,0.24,3380,60,167,552
127565,METROPOLITAN STATE COLLEGE OF DENVER,1,0,1991,NA,NA,1357,669,688,35,12,23,0.03,0.02,0.03,1483,62,362,1004
127565,METROPOLITAN STATE COLLEGE OF DENVER,1,0,1992,NA,NA,1227,614,613,49,17,32,0.05,0.03,0.04,1709,69,372,905
127565,METROPOLITAN STATE COLLEGE OF DENVER,1,0,1993,NA,NA,1380,682,698,43,22,21,0.03,0.03,0.03,1749,70,370,968
127565,METROPOLITAN STATE COLLEGE OF DENVER,1,0,1995,NA,NA,1239,691,548,48,19,29,0.04,0.03,0.04,1850,75,385,801
127565,METROPOLITAN STATE COLLEGE OF DENVER,1,0,1996,NA,NA,1324,677,647,51,15,36,0.05,0.02,0.04,1942,80,364,891
127565,METROPOLITAN STATE COLLEGE OF DENVER,1,0,1997,NA,NA,1478,787,691,69,19,50,0.06,0.03,0.05,1976,87,376,1016
127565,METROPOLITAN STATE COLLEGE OF DENVER,1,0,1998,NA,NA,1382,759,623,81,29,52,0.06,0.05,0.06,2033,92,381,935
127565,METROPOLITAN STATE COLLEGE OF DENVER,1,0,1999,NA,NA,1440,764,676,86,40,46,0.06,0.06,0.06,1718,98,386,989
127565,METROPOLITAN STATE COLLEGE OF DENVER,1,0,2000,NA,NA,1435,778,657,79,27,52,0.06,0.04,0.06,1768,98,416,950
127565,METROPOLITAN STATE COLLEGE OF DENVER,1,0,2001,NA,NA,1596,816,780,97,42,55,0.06,0.05,0.06,1893,106,446,1087
127565,METROPOLITAN STATE COLLEGE OF DENVER,1,0,2002,NA,NA,1655,852,803,73,25,48,0.05,0.03,0.04,1925,102,489,1143
127565,METROPOLITAN STATE COLLEGE OF DENVER,1,0,2003,NA,NA,1809,931,878,82,26,56,0.06,0.03,0.05,2021,107,392,1209
127565,METROPOLITAN STATE COLLEGE OF DENVER,1,0,2004,NA,NA,1815,937,878,86,34,52,0.05,0.04,0.05,2044,103,395,1242
127565,Metropolitan State College of Denver,1,0,2005,NA,NA,1840,939,901,79,32,47,0.05,0.04,0.04,2191,107,431,1201
127565,Metropolitan State College of Denver,1,0,2006,NA,NA,1711,925,786,102,33,69,0.07,0.04,0.06,2246,107,458,1014
127565,Metropolitan State College of Denver,1,0,2007,NA,NA,1910,1036,874,108,38,70,0.06,0.04,0.06,2432,116,500,1287
127565,Metropolitan State College of Denver,1,0,2008,NA,NA,1918,969,949,88,33,55,0.05,0.03,0.05,2615,124,516,1218
127565,Metropolitan State College of Denver,1,0,2009,NA,NA,1959,985,974,115,46,69,0.07,0.05,0.06,2850,134,509,1168
127565,Metropolitan State College of Denver,1,0,2010,NA,NA,1876,916,960,112,43,69,0.07,0.04,0.06,3107,140,517,1086
127741,UNIVERSITY OF NORTHERN COLORADO,1,0,1991,NA,NA,1639,937,702,258,78,180,0.19,0.11,0.16,1926,89,458,1365
127741,UNIVERSITY OF NORTHERN COLORADO,1,0,1992,NA,NA,1464,921,543,232,63,169,0.18,0.12,0.16,2027,94,447,1168
127741,UNIVERSITY OF NORTHERN COLORADO,1,0,1993,NA,NA,1704,1019,685,309,81,228,0.22,0.12,0.18,2114,94,467,1372
127741,UNIVERSITY OF NORTHERN COLORADO,1,0,1995,NA,NA,1763,1091,672,404,90,314,0.28,0.13,0.23,2408,104,463,1456
127741,UNIVERSITY OF NORTHERN COLORADO,1,0,1996,NA,NA,1642,1000,642,413,120,293,0.29,0.19,0.25,2542,114,445,1365
127741,UNIVERSITY OF NORTHERN COLORADO,1,0,1997,NA,NA,1905,1147,758,490,107,383,0.33,0.14,0.26,2578,112,445,1543
127741,UNIVERSITY OF NORTHERN COLORADO,1,0,1998,NA,NA,2165,1314,851,515,123,392,0.29,0.14,0.24,2652,116,452,1825
127741,UNIVERSITY OF NORTHERN COLORADO,1,0,1999,NA,NA,2291,1401,890,589,129,460,0.32,0.14,0.26,2014,123,461,1892
127741,UNIVERSITY OF NORTHERN COLORADO,1,0,2000,NA,NA,2113,1240,873,605,162,443,0.35000000000000003,0.19,0.29,2072,128,444,1748
127741,UNIVERSITY OF NORTHERN COLORADO,1,0,2001,NA,NA,2108,1309,799,623,140,483,0.36,0.18,0.3,2155,132,427,1740
127741,UNIVERSITY OF NORTHERN COLORADO,1,0,2002,NA,NA,1938,1253,685,548,116,432,0.34,0.17,0.28,2290,126,452,1622
127741,UNIVERSITY OF NORTHERN COLORADO,1,0,2003,NA,NA,2118,1337,781,598,169,429,0.32,0.22,0.28,2520,128,410,1747
127741,UNIVERSITY OF NORTHERN COLORADO,1,0,2004,NA,NA,2412,1459,953,648,190,458,0.31,0.2,0.27,2850,127,412,1906
127741,University of Northern Colorado,1,0,2005,NA,NA,2483,1479,1004,620,173,447,0.3,0.17,0.25,3192,130,400,1987
127741,University of Northern Colorado,1,0,2006,NA,NA,2491,1442,1049,659,204,455,0.31,0.19,0.26,3276,146,446,1950
127741,University of Northern Colorado,1,0,2007,NA,NA,2199,1328,871,583,149,434,0.32,0.17,0.27,3600,146,438,1722
127741,University of Northern Colorado,1,0,2008,NA,NA,2071,1227,844,558,156,402,0.32,0.18,0.27,3942,157,458,1613
127741,University of Northern Colorado,1,0,2009,NA,NA,2275,1360,915,605,165,440,0.32,0.18,0.27,4296,168,488,1696
127741,University of Northern Colorado,1,0,2010,NA,NA,2221,1420,801,653,183,470,0.33,0.23,0.29,4680,183,498,1537
128106,UNIVERSITY OF SOUTHERN COLORADO,1,0,1991,NA,NA,579,287,292,59,23,36,0.12,0.08,0.1,1725,33,171,386
128106,UNIVERSITY OF SOUTHERN COLORADO,1,0,1992,NA,NA,656,342,314,58,21,37,0.1,0.07,0.09,1833,34,164,433
128106,UNIVERSITY OF SOUTHERN COLORADO,1,0,1993,NA,NA,678,321,357,78,34,44,0.13,0.1,0.12,1878,38,170,466
128106,UNIVERSITY OF SOUTHERN COLORADO,1,0,1995,NA,NA,590,299,291,69,31,38,0.12,0.11,0.12,2080,44,175,377
128106,UNIVERSITY OF SOUTHERN COLORADO,1,0,1996,NA,NA,574,305,269,68,19,49,0.16,0.07,0.12,2149,46,168,381
128106,UNIVERSITY OF SOUTHERN COLORADO,1,0,1997,NA,NA,580,299,281,49,20,29,0.09,0.07,0.08,2186,46,171,369
128106,UNIVERSITY OF SOUTHERN COLORADO,1,0,1998,NA,NA,611,345,266,80,30,50,0.14,0.11,0.13,2219,48,164,350
128106,UNIVERSITY OF SOUTHERN COLORADO,1,0,1999,NA,NA,611,326,285,76,27,49,0.15,0.09,0.12,1808,71,165,391
128106,UNIVERSITY OF SOUTHERN COLORADO,1,0,2000,NA,NA,641,331,310,101,41,60,0.18,0.13,0.16,1860,50,161,392
128106,UNIVERSITY OF SOUTHERN COLORADO,1,0,2001,NA,NA,634,343,291,115,47,68,0.19,0.16,0.18,1940,51,158,353
128106,UNIVERSITY OF SOUTHERN COLORADO,1,0,2002,NA,NA,642,329,313,105,39,66,0.2,0.12,0.16,2060,50,160,383
128106,COLORADO STATE UNIVERSITY-PUEBLO,1,0,2003,NA,NA,686,372,314,93,35,58,0.15,0.11,0.14,1873,48,161,422
128106,COLORADO STATE UNIVERSITY-PUEBLO,1,0,2004,NA,NA,753,423,330,118,34,84,0.19,0.1,0.16,2524,48,158,454
128106,Colorado State University-Pueblo,1,0,2005,NA,NA,665,361,304,125,54,71,0.19,0.18,0.19,2903,49,160,382
128106,Colorado State University-Pueblo,1,0,2006,NA,NA,628,350,278,112,42,70,0.2,0.15,0.18,2975,51,168,349
128106,Colorado State University-Pueblo,1,0,2007,NA,NA,602,308,294,109,41,68,0.22,0.14,0.18,3184,51,155,314
128106,Colorado State University-Pueblo,1,0,2008,NA,NA,1002,465,537,160,65,95,0.2,0.12,0.16,3422,55,177,517
128106,Colorado State University-Pueblo,1,0,2009,NA,NA,1013,513,500,178,67,111,0.21,0.13,0.18,3732,66,180,521
128106,Colorado State University-Pueblo,1,0,2010,NA,NA,977,467,510,182,80,102,0.21,0.16,0.19,4068,66,180,486
128744,UNIVERSITY OF BRIDGEPORT,1,0,1991,NA,NA,208,110,98,12,5,7,0.06,0.05,0.06,12774,62,152,81
128744,UNIVERSITY OF BRIDGEPORT,1,0,1992,NA,NA,18,12,6,1,0,1,0.08,0,0.06,12880,42,91,3
128744,UNIVERSITY OF BRIDGEPORT,1,0,1993,NA,NA,137,66,71,58,20,38,0.5700000000000001,0.28,0.42,12905,33,90,37
128744,UNIVERSITY OF BRIDGEPORT,1,0,1995,NA,NA,123,73,50,38,14,24,0.32,0.28,0.31,13124,41,83,37
128744,UNIVERSITY OF BRIDGEPORT,1,0,1996,NA,NA,116,58,58,35,17,18,0.31,0.29,0.3,13144,37,83,25
128744,UNIVERSITY OF BRIDGEPORT,1,0,1997,NA,NA,187,93,94,58,24,34,0.36,0.26,0.31,13644,31,88,49
128744,UNIVERSITY OF BRIDGEPORT,1,0,1998,NA,NA,233,94,139,80,48,32,0.34,0.35,0.34,14041,32,99,30
128744,UNIVERSITY OF BRIDGEPORT,1,0,1999,NA,NA,190,96,94,39,15,24,0.25,0.16,0.21,13800,35,94,42
128744,UNIVERSITY OF BRIDGEPORT,1,0,2000,NA,NA,161,80,81,53,21,32,0.4,0.26,0.33,14150,35,89,45
128744,UNIVERSITY OF BRIDGEPORT,1,0,2001,NA,NA,175,97,78,49,17,32,0.32,0.22,0.28,14720,36,84,20
128744,UNIVERSITY OF BRIDGEPORT,1,0,2002,NA,NA,234,144,90,66,23,43,0.29,0.26,0.28,15604,37,86,48
128744,UNIVERSITY OF BRIDGEPORT,1,0,2003,NA,NA,286,158,128,61,14,47,0.29,0.11,0.21,17008,44,87,67
128744,UNIVERSITY OF BRIDGEPORT,1,0,2004,NA,NA,241,134,107,47,19,28,0.2,0.18,0.2,18300,38,88,62
128744,University of Bridgeport,1,0,2005,NA,NA,352,212,140,64,20,44,0.2,0.14,0.18,19200,41,89,78
128744,University of Bridgeport,1,0,2006,NA,NA,303,176,127,70,20,50,0.28,0.16,0.23,20250,47,102,72
128744,University of Bridgeport,1,0,2007,NA,NA,331,209,122,62,17,45,0.21,0.14,0.19,21150,54,114,70
128744,University of Bridgeport,1,0,2008,NA,NA,444,266,178,90,30,60,0.22,0.17,0.2,22500,66,117,72
128744,University of Bridgeport,1,0,2009,NA,NA,429,260,169,108,37,71,0.27,0.22,0.25,23400,73,125,75
128744,University of Bridgeport,1,0,2010,NA,NA,594,397,197,122,41,81,0.2,0.21,0.21,24300,73,120,93
128771,CENTRAL CONNECTICUT STATE UNIVERSITY,1,0,1991,NA,NA,1088,627,461,115,34,81,0.12,0.07,0.11,2414,62,396,914
128771,CENTRAL CONNECTICUT STATE UNIVERSITY,1,0,1992,NA,NA,964,552,412,98,31,67,0.12,0.08,0.1,2804,65,383,801
128771,CENTRAL CONNECTICUT STATE UNIVERSITY,1,0,1993,NA,NA,902,483,419,80,18,62,0.12,0.04,0.09,2976,67,390,714
128771,CENTRAL CONNECTICUT STATE UNIVERSITY,1,0,1995,NA,NA,1076,566,510,68,28,40,0.07,0.05,0.06,3266,75,387,843
128771,CENTRAL CONNECTICUT STATE UNIVERSITY,1,0,1996,NA,NA,1092,534,558,165,65,100,0.18,0.12,0.15,3542,74,367,886
128771,CENTRAL CONNECTICUT STATE UNIVERSITY,1,0,1997,NA,NA,1213,626,587,82,36,46,0.07,0.06,0.07,3614,82,354,948
128771,CENTRAL CONNECTICUT STATE UNIVERSITY,1,0,1998,NA,NA,1317,675,642,163,46,117,0.17,0.07,0.12,3670,98,377,1063
128771,CENTRAL CONNECTICUT STATE UNIVERSITY,1,0,1999,NA,NA,1280,559,721,143,47,96,0.17,0.07,0.11,2062,106,379,932
128771,CENTRAL CONNECTICUT STATE UNIVERSITY,1,0,2000,NA,NA,1304,635,669,141,42,99,0.15,0.06,0.11,2142,120,385,1001
128771,CENTRAL CONNECTICUT STATE UNIVERSITY,1,0,2001,NA,NA,1261,623,638,169,74,95,0.15,0.12,0.13,2226,118,391,975
128771,CENTRAL CONNECTICUT STATE UNIVERSITY,1,0,2002,NA,NA,1473,735,738,192,61,131,0.17,0.08,0.13,2314,135,400,1188
128771,CENTRAL CONNECTICUT STATE UNIVERSITY,1,0,2003,NA,NA,1176,571,605,166,59,107,0.18,0.1,0.14,2648,150,395,906
128771,CENTRAL CONNECTICUT STATE UNIVERSITY,1,0,2004,NA,NA,1278,596,682,213,80,133,0.22,0.12,0.17,2862,164,409,977
128771,Central Connecticut State University,1,0,2005,NA,NA,1333,663,670,188,82,106,0.15,0.12,0.14,3034,209,416,1050
128771,Central Connecticut State University,1,0,2006,NA,NA,1282,603,679,272,117,155,0.25,0.17,0.21,3187,176,417,1008
128771,Central Connecticut State University,1,0,2007,NA,NA,1466,676,790,294,133,161,0.23,0.17,0.2,3346,186,432,1154
128771,Central Connecticut State University,1,0,2008,NA,NA,1297,578,719,279,133,146,0.25,0.18,0.22,3514,198,434,992
128771,Central Connecticut State University,1,0,2009,NA,NA,1277,621,656,321,128,193,0.31,0.2,0.25,3742,210,433,940
128771,Central Connecticut State University,1,0,2010,NA,NA,1340,592,748,279,125,154,0.26,0.17,0.21,4023,198,440,1031
129020,UNIVERSITY OF CONNECTICUT,1,0,1991,NA,NA,2904,1464,1440,977,359,618,0.42,0.25,0.34,3402,324,1093,2381
129020,UNIVERSITY OF CONNECTICUT,1,0,1992,NA,NA,2831,1454,1377,968,354,614,0.42,0.26,0.34,3902,362,1045,2197
129020,UNIVERSITY OF CONNECTICUT,1,0,1993,NA,NA,2052,1068,984,775,297,478,0.44,0.3,0.38,4290,360,1044,1670
129020,UNIVERSITY OF CONNECTICUT,1,0,1995,NA,NA,2010,1051,959,855,341,514,0.48,0.36,0.43,4810,454,1068,1558
129020,UNIVERSITY OF CONNECTICUT,1,0,1996,NA,NA,2142,1156,986,908,311,597,0.51,0.32,0.42,4974,447,1025,1643
129020,UNIVERSITY OF CONNECTICUT,1,0,1997,NA,NA,2172,1181,991,977,340,637,0.53,0.34,0.45,5242,431,962,1663
129020,UNIVERSITY OF CONNECTICUT,1,0,1998,NA,NA,2536,1358,1178,1135,431,704,0.51,0.37,0.45,5330,444,1014,1907
129020,UNIVERSITY OF CONNECTICUT,1,0,1999,NA,NA,2940,1596,1344,1454,523,931,0.58,0.39,0.49,4158,488,1043,2256
129020,UNIVERSITY OF CONNECTICUT,1,0,2000,NA,NA,2802,1549,1253,1484,554,930,0.6,0.44,0.53,4282,537,1039,2112
129020,UNIVERSITY OF CONNECTICUT,1,0,2001,NA,NA,3122,1648,1474,1671,682,989,0.6,0.46,0.54,4448,577,1036,1979
129020,UNIVERSITY OF CONNECTICUT,1,0,2002,NA,NA,3157,1722,1435,1766,674,1092,0.63,0.47,0.56,4730,620,1068,2382
129020,UNIVERSITY OF CONNECTICUT,1,0,2003,NA,NA,3182,1733,1449,1912,757,1155,0.66,0.52,0.6,5260,676,1017,2402
129020,UNIVERSITY OF CONNECTICUT,1,0,2004,NA,NA,3229,1789,1440,2104,830,1274,0.71,0.58,0.65,5772,716,1109,2402
129020,University of Connecticut,1,0,2005,NA,NA,3239,1789,1450,2176,881,1295,0.72,0.61,0.67,6096,812,1187,2212
129020,University of Connecticut,1,0,2006,NA,NA,3222,1631,1591,2148,962,1186,0.72,0.6,0.67,6456,835,1202,2074
129020,University of Connecticut,1,0,2007,NA,NA,3160,1682,1478,2136,921,1215,0.72,0.62,0.68,6816,863,1233,2012
129020,University of Connecticut,1,0,2008,NA,NA,3587,1780,1807,2382,1098,1284,0.72,0.61,0.66,7200,937,1254,2208
129020,University of Connecticut,1,0,2009,NA,NA,3206,1652,1554,2216,986,1230,0.74,0.63,0.69,7632,1762,1296,2125
129020,University of Connecticut,1,0,2010,NA,NA,3317,1629,1688,2300,1076,1224,0.75,0.64,0.69,8064,1764,1312,2284
129242,FAIRFIELD UNIVERSITY,1,0,1991,NA,NA,749,429,320,597,255,342,0.79,0.8,0.8,12920,60,190,672
129242,FAIRFIELD UNIVERSITY,1,0,1992,NA,NA,861,506,355,672,277,395,0.78,0.78,0.78,13720,65,188,780
129242,FAIRFIELD UNIVERSITY,1,0,1993,NA,NA,773,392,381,595,283,312,0.79,0.74,0.77,14560,71,192,677
129242,FAIRFIELD UNIVERSITY,1,0,1995,NA,NA,784,450,334,602,248,354,0.78,0.74,0.77,16340,79,199,681
129242,FAIRFIELD UNIVERSITY,1,0,1996,NA,NA,876,440,436,642,299,343,0.77,0.69,0.73,17360,84,199,765
129242,FAIRFIELD UNIVERSITY,1,0,1997,NA,NA,876,462,414,649,286,363,0.78,0.69,0.74,18310,73,202,781
129242,FAIRFIELD UNIVERSITY,1,0,1998,NA,NA,875,478,397,679,299,380,0.79,0.75,0.78,19210,76,202,749
129242,FAIRFIELD UNIVERSITY,1,0,1999,NA,NA,837,446,391,662,287,375,0.84,0.73,0.79,20000,80,206,756
129242,FAIRFIELD UNIVERSITY,1,0,2000,NA,NA,1008,610,398,797,291,506,0.8200000000000001,0.73,0.79,21000,85,214,908
129242,FAIRFIELD UNIVERSITY,1,0,2001,NA,NA,831,463,368,646,265,381,0.8200000000000001,0.72,0.78,22430,95,222,697
129242,FAIRFIELD UNIVERSITY,1,0,2002,NA,NA,813,461,352,609,240,369,0.8,0.68,0.75,24100,106,219,708
129242,FAIRFIELD UNIVERSITY,1,0,2003,NA,NA,789,459,330,636,260,376,0.81,0.79,0.81,26100,113,219,692
129242,FAIRFIELD UNIVERSITY,1,0,2004,NA,NA,856,475,381,679,282,397,0.8300000000000001,0.74,0.79,27930,119,221,784
129242,Fairfield University,1,0,2005,NA,NA,940,551,389,744,297,447,0.81,0.76,0.79,29730,126,225,742
129242,Fairfield University,1,0,2006,NA,NA,896,534,362,696,269,427,0.79,0.74,0.78,31450,130,238,614
129242,Fairfield University,1,0,2007,NA,NA,842,496,346,664,268,396,0.79,0.77,0.79,33340,140,239,619
129242,Fairfield University,1,0,2008,NA,NA,898,537,361,688,257,431,0.8,0.71,0.77,35510,156,252,536
129242,Fairfield University,1,0,2009,NA,NA,848,479,369,664,270,394,0.8200000000000001,0.73,0.78,36900,156,253,540
129242,Fairfield University,1,0,2010,NA,NA,921,576,345,722,250,472,0.81,0.72,0.78,38450,156,250,627
129941,UNIVERSITY OF NEW HAVEN,1,0,1991,NA,NA,320,84,236,60,42,18,0.21,0.18,0.19,9600,30,149,208
129941,UNIVERSITY OF NEW HAVEN,1,0,1992,NA,NA,302,74,228,42,30,12,0.16,0.13,0.14,9870,32,152,194
129941,UNIVERSITY OF NEW HAVEN,1,0,1993,NA,NA,289,103,186,47,27,20,0.19,0.15,0.16,10180,34,152,171
129941,UNIVERSITY OF NEW HAVEN,1,0,1995,NA,NA,352,115,237,110,74,36,0.31,0.31,0.31,11450,31,154,247
129941,UNIVERSITY OF NEW HAVEN,1,0,1996,NA,NA,329,109,220,68,40,28,0.25,0.18,0.21,12110,42,157,229
129941,UNIVERSITY OF NEW HAVEN,1,0,1997,NA,NA,324,130,194,87,46,41,0.31,0.24,0.27,13100,42,152,207
129941,UNIVERSITY OF NEW HAVEN,1,0,1998,NA,NA,370,141,229,95,51,44,0.31,0.22,0.26,13800,45,158,236
129941,UNIVERSITY OF NEW HAVEN,1,0,1999,NA,NA,322,117,205,66,32,34,0.29,0.16,0.2,14250,40,159,194
129941,UNIVERSITY OF NEW HAVEN,1,0,2000,NA,NA,457,195,262,101,48,53,0.27,0.18,0.22,15210,41,165,242
129941,UNIVERSITY OF NEW HAVEN,1,0,2001,NA,NA,503,202,301,123,54,69,0.34,0.18,0.24,16200,44,171,283
129941,UNIVERSITY OF NEW HAVEN,1,0,2002,NA,NA,529,240,289,166,67,99,0.41000000000000003,0.23,0.31,18800,46,168,374
129941,UNIVERSITY OF NEW HAVEN,1,0,2003,NA,NA,618,301,317,223,85,138,0.45,0.27,0.36,20150,53,178,467
129941,UNIVERSITY OF NEW HAVEN,1,0,2004,NA,NA,571,264,307,197,111,86,0.32,0.36,0.35,21120,58,169,437
129941,University of New Haven,1,0,2005,NA,NA,653,322,331,256,117,139,0.43,0.35,0.39,22380,61,162,503
129941,University of New Haven,1,0,2006,NA,NA,690,325,365,305,157,148,0.45,0.43,0.44,24000,75,169,513
129941,University of New Haven,1,0,2007,NA,NA,700,331,369,296,138,158,0.47000000000000003,0.37,0.42,25380,81,182,498
129941,University of New Haven,1,0,2008,NA,NA,1129,569,560,430,175,255,0.44,0.31,0.38,27000,94,183,686
129941,University of New Haven,1,0,2009,NA,NA,1252,639,613,553,247,306,0.47000000000000003,0.4,0.44,28250,107,200,486
129941,University of New Haven,1,0,2010,NA,NA,1005,534,471,452,198,254,0.47000000000000003,0.42,0.45,29500,118,207,189
130253,SACRED HEART UNIVERSITY,1,0,1991,NA,NA,485,196,289,93,41,52,0.26,0.14,0.19,8970,24,103,356
130253,SACRED HEART UNIVERSITY,1,0,1992,NA,NA,491,240,251,114,52,62,0.25,0.21,0.23,9740,30,108,375
130253,SACRED HEART UNIVERSITY,1,0,1993,NA,NA,515,274,241,197,72,125,0.45,0.3,0.38,10550,35,111,400
130253,SACRED HEART UNIVERSITY,1,0,1995,NA,NA,639,357,282,269,107,162,0.45,0.38,0.42,12100,48,128,550
130253,SACRED HEART UNIVERSITY,1,0,1996,NA,NA,602,361,241,281,81,200,0.55,0.34,0.47,12714,48,127,534
130253,SACRED HEART UNIVERSITY,1,0,1997,NA,NA,632,377,255,297,113,184,0.48,0.44,0.47,13435,48,130,546
130253,SACRED HEART UNIVERSITY,1,0,1998,NA,NA,702,409,293,308,112,196,0.47000000000000003,0.38,0.44,13972,52,137,618
130253,SACRED HEART UNIVERSITY,1,0,1999,NA,NA,718,416,302,401,141,260,0.62,0.47,0.56,14670,56,144,621
130253,SACRED HEART UNIVERSITY,1,0,2000,NA,NA,834,498,336,477,168,309,0.62,0.5,0.57,15404,63,148,749
130253,SACRED HEART UNIVERSITY,1,0,2001,NA,NA,766,465,301,457,172,285,0.61,0.57,0.6,16328,69,153,696
130253,SACRED HEART UNIVERSITY,1,0,2002,NA,NA,797,457,340,445,171,274,0.59,0.5,0.56,19260,72,160,752
130253,SACRED HEART UNIVERSITY,1,0,2003,NA,NA,816,497,319,462,144,318,0.63,0.45,0.57,20220,79,165,734
130253,SACRED HEART UNIVERSITY,1,0,2004,NA,NA,876,521,355,528,196,332,0.63,0.55,0.6,21990,82,181,786
130253,Sacred Heart University,1,0,2005,NA,NA,886,542,344,544,186,358,0.66,0.54,0.61,23750,94,182,821
130253,Sacred Heart University,1,0,2006,NA,NA,931,603,328,536,172,364,0.6,0.52,0.58,25300,103,189,846
130253,Sacred Heart University,1,0,2007,NA,NA,956,580,376,606,220,386,0.66,0.59,0.63,26950,106,199,850
130253,Sacred Heart University,1,0,2008,NA,NA,981,577,404,583,201,382,0.66,0.5,0.59,28790,114,212,788
130253,Sacred Heart University,1,0,2009,NA,NA,907,542,365,526,180,346,0.63,0.49,0.58,30090,121,201,681
130253,Sacred Heart University,1,0,2010,NA,NA,974,610,364,529,167,362,0.59,0.46,0.54,31224,119,217,690
130314,SAINT JOSEPH COLLEGE,1,0,1991,NA,NA,104,104,0,54,0,54,0.51,NA,0.52,10400,14,70,79
130314,SAINT JOSEPH COLLEGE,1,0,1992,NA,NA,105,105,0,42,0,42,0.4,NA,0.4,11000,15,71,89
130314,SAINT JOSEPH COLLEGE,1,0,1993,NA,NA,93,93,0,47,0,47,0.5,NA,0.51,11600,14,66,78
130314,SAINT JOSEPH COLLEGE,1,0,1995,NA,NA,153,152,1,82,0,82,0.53,0,0.54,13020,19,74,134
130314,SAINT JOSEPH COLLEGE,1,0,1996,NA,NA,164,164,0,66,0,66,0.4,NA,0.4,13800,21,72,125
130314,SAINT JOSEPH COLLEGE,1,0,1997,NA,NA,174,174,0,87,0,87,0.5,NA,0.5,14490,18,73,131
130314,SAINT JOSEPH COLLEGE,1,0,1998,NA,NA,142,142,0,66,0,66,0.46,NA,0.46,15070,20,74,117
130314,SAINT JOSEPH COLLEGE,1,0,1999,NA,NA,144,144,0,61,0,61,0.42,NA,0.42,15900,21,76,101
130314,SAINT JOSEPH COLLEGE,1,0,2000,NA,NA,187,187,0,86,0,86,0.45,NA,0.46,16930,23,75,137
130314,SAINT JOSEPH COLLEGE,1,0,2001,NA,NA,165,165,0,75,0,75,0.45,NA,0.45,17869,25,74,95
130314,SAINT JOSEPH COLLEGE,1,0,2002,NA,NA,201,201,0,69,0,69,0.34,NA,0.34,19110,28,77,124
130314,SAINT JOSEPH COLLEGE,1,0,2003,NA,NA,190,190,0,59,0,59,0.31,NA,0.31,20350,30,78,127
130314,SAINT JOSEPH COLLEGE,1,0,2004,NA,NA,189,189,0,56,0,56,0.29,NA,0.3,21370,32,75,116
130314,Saint Joseph College,1,0,2005,NA,NA,206,206,0,88,0,88,0.42,NA,0.43,22225,32,77,149
130314,Saint Joseph College,1,0,2006,NA,NA,133,133,0,50,0,50,0.37,NA,0.38,22890,33,78,96
130314,Saint Joseph College,1,0,2007,NA,NA,165,165,0,61,0,61,0.36,NA,0.37,24040,34,79,34
130314,Saint Joseph College,1,0,2008,NA,NA,225,225,0,92,0,92,0.4,NA,0.41,25240,36,76,134
130314,Saint Joseph College,1,0,2009,NA,NA,184,184,0,82,0,82,0.44,NA,0.45,26502,39,78,112
130314,Saint Joseph College,1,0,2010,NA,NA,229,229,0,137,0,137,0.59,NA,0.6,27580,41,96,141
130493,SOUTHERN CONNECTICUT STATE UNIVERSITY,1,0,1991,NA,NA,1002,539,463,188,49,139,0.25,0.11,0.19,2199,60,404,806
130493,SOUTHERN CONNECTICUT STATE UNIVERSITY,1,0,1992,NA,NA,933,493,440,134,35,99,0.2,0.08,0.14,2646,62,397,754
130493,SOUTHERN CONNECTICUT STATE UNIVERSITY,1,0,1993,NA,NA,1044,572,472,139,38,101,0.17,0.08,0.13,2838,67,389,868
130493,SOUTHERN CONNECTICUT STATE UNIVERSITY,1,0,1995,NA,NA,917,526,391,121,36,85,0.16,0.09,0.13,3128,79,382,665
130493,SOUTHERN CONNECTICUT STATE UNIVERSITY,1,0,1996,NA,NA,1009,587,422,137,39,98,0.16,0.09,0.14,3474,70,374,720
130493,SOUTHERN CONNECTICUT STATE UNIVERSITY,1,0,1997,NA,NA,1089,624,465,146,39,107,0.17,0.08,0.13,3568,79,343,789
130493,SOUTHERN CONNECTICUT STATE UNIVERSITY,1,0,1998,NA,NA,1077,647,430,140,24,116,0.17,0.06,0.13,3716,82,381,808
130493,SOUTHERN CONNECTICUT STATE UNIVERSITY,1,0,1999,NA,NA,1238,702,536,148,50,98,0.13,0.09,0.12,2124,102,388,877
130493,SOUTHERN CONNECTICUT STATE UNIVERSITY,1,0,2000,NA,NA,1350,775,575,142,38,104,0.13,0.07,0.11,2142,114,394,945
130493,SOUTHERN CONNECTICUT STATE UNIVERSITY,1,0,2001,NA,NA,1429,858,571,134,37,97,0.11,0.06,0.09,2226,120,401,1015
130493,SOUTHERN CONNECTICUT STATE UNIVERSITY,1,0,2002,NA,NA,1276,719,557,144,46,98,0.13,0.08,0.11,2314,130,402,895
130493,SOUTHERN CONNECTICUT STATE UNIVERSITY,1,0,2003,NA,NA,1310,802,508,7,2,5,0,0,0.01,2648,132,396,944
130493,SOUTHERN CONNECTICUT STATE UNIVERSITY,1,0,2004,NA,NA,1396,899,497,219,46,173,0.19,0.09,0.16,3010,131,403,1035
130493,Southern Connecticut State University,1,0,2005,NA,NA,1313,866,447,192,43,149,0.17,0.1,0.15,3034,161,403,958
130493,Southern Connecticut State University,1,0,2006,NA,NA,1516,987,529,262,54,208,0.21,0.1,0.17,3187,167,409,1069
130493,Southern Connecticut State University,1,0,2007,NA,NA,1333,884,449,239,56,183,0.2,0.12,0.18,3346,179,438,951
130493,Southern Connecticut State University,1,0,2008,NA,NA,1288,858,430,293,77,216,0.25,0.18,0.23,3514,192,449,928
130493,Southern Connecticut State University,1,0,2009,NA,NA,1237,792,445,280,65,215,0.27,0.15,0.23,3742,203,407,909
130493,Southern Connecticut State University,1,0,2010,NA,NA,1248,792,456,299,58,241,0.3,0.13,0.24,4023,188,424,862
130590,TRINITY COLLEGE,1,0,1991,NA,NA,481,226,255,387,192,195,0.86,0.75,0.8,16740,52,145,401
130590,TRINITY COLLEGE,1,0,1992,NA,NA,472,240,232,352,161,191,0.79,0.69,0.75,17620,56,143,385
130590,TRINITY COLLEGE,1,0,1993,NA,NA,476,242,234,362,173,189,0.78,0.74,0.76,17950,60,146,398
130590,TRINITY COLLEGE,1,0,1995,NA,NA,507,246,261,388,174,214,0.86,0.67,0.77,19690,65,142,411
130590,TRINITY COLLEGE,1,0,1996,NA,NA,504,238,266,387,195,192,0.8,0.73,0.77,21410,71,151,405
130590,TRINITY COLLEGE,1,0,1997,NA,NA,500,220,280,386,205,181,0.8200000000000001,0.73,0.77,22470,71,150,377
130590,TRINITY COLLEGE,1,0,1998,NA,NA,509,263,246,390,176,214,0.81,0.72,0.77,23570,78,151,362
130590,TRINITY COLLEGE,1,0,1999,NA,NA,565,286,279,442,206,236,0.8200000000000001,0.74,0.78,23730,85,166,389
130590,TRINITY COLLEGE,1,0,2000,NA,NA,489,253,236,389,181,208,0.8200000000000001,0.77,0.8,24660,93,181,349
130590,TRINITY COLLEGE,1,0,2001,NA,NA,491,239,252,388,184,204,0.85,0.73,0.79,25880,97,196,344
130590,TRINITY COLLEGE,1,0,2002,NA,NA,548,286,262,445,207,238,0.8300000000000001,0.79,0.81,27170,105,201,349
130590,TRINITY COLLEGE,1,0,2003,NA,NA,548,257,291,421,212,209,0.81,0.73,0.77,28740,109,191,335
130590,TRINITY COLLEGE,1,0,2004,NA,NA,569,283,286,442,213,229,0.8,0.74,0.78,30380,113,201,302
130590,Trinity College,1,0,2005,NA,NA,573,289,284,469,221,248,0.85,0.78,0.82,32000,118,189,358
130590,Trinity College,1,0,2006,NA,NA,608,294,314,466,229,237,0.8,0.73,0.77,33440,114,180,397
130590,Trinity College,1,0,2007,NA,NA,576,292,284,469,224,245,0.8300000000000001,0.79,0.81,35110,120,179,382
130590,Trinity College,1,0,2008,NA,NA,589,300,289,464,214,250,0.8300000000000001,0.74,0.79,36864,129,196,355
130590,Trinity College,1,0,2009,NA,NA,573,272,301,464,232,232,0.85,0.77,0.81,38900,128,206,398
130590,Trinity College,1,0,2010,NA,NA,591,300,291,473,223,250,0.8300000000000001,0.77,0.8,40410,129,193,387
130697,WESLEYAN UNIVERSITY,1,0,1991,NA,NA,663,347,316,501,223,278,0.8,0.71,0.76,16250,82,255,435
130697,WESLEYAN UNIVERSITY,1,0,1992,NA,NA,704,361,343,553,263,290,0.8,0.77,0.79,17190,85,252,449
130697,WESLEYAN UNIVERSITY,1,0,1993,NA,NA,703,365,338,547,257,290,0.79,0.76,0.78,18150,92,254,474
130697,WESLEYAN UNIVERSITY,1,0,1995,NA,NA,710,356,354,584,288,296,0.8300000000000001,0.81,0.82,20820,101,241,484
130697,WESLEYAN UNIVERSITY,1,0,1996,NA,NA,738,374,364,633,311,322,0.86,0.85,0.86,21910,109,246,503
130697,WESLEYAN UNIVERSITY,1,0,1997,NA,NA,700,371,329,583,263,320,0.86,0.8,0.83,22980,106,252,463
130697,WESLEYAN UNIVERSITY,1,0,1998,NA,NA,716,382,334,593,264,329,0.86,0.79,0.83,24050,112,259,463
130697,WESLEYAN UNIVERSITY,1,0,1999,NA,NA,732,375,357,609,283,326,0.86,0.79,0.83,24330,116,263,499
130697,WESLEYAN UNIVERSITY,1,0,2000,NA,NA,720,371,349,607,281,326,0.87,0.81,0.84,25380,123,287,447
130697,WESLEYAN UNIVERSITY,1,0,2001,NA,NA,722,372,350,606,280,326,0.87,0.8,0.84,26290,130,311,465
130697,WESLEYAN UNIVERSITY,1,0,2002,NA,NA,716,377,339,634,288,346,0.91,0.85,0.89,27474,140,311,444
130697,WESLEYAN UNIVERSITY,1,0,2003,NA,NA,713,376,337,631,291,340,0.9,0.86,0.88,29784,147,329,431
130697,WESLEYAN UNIVERSITY,1,0,2004,NA,NA,728,385,343,649,300,349,0.9,0.87,0.89,31436,159,322,428
130697,Wesleyan University,1,0,2005,NA,NA,705,360,345,614,305,309,0.85,0.88,0.87,32976,161,325,422
130697,Wesleyan University,1,0,2006,NA,NA,716,352,364,624,316,308,0.87,0.87,0.87,34630,166,333,448
130697,Wesleyan University,1,0,2007,NA,NA,733,377,356,632,305,327,0.86,0.86,0.86,36536,167,325,451
130697,Wesleyan University,1,0,2008,NA,NA,715,355,360,622,300,322,0.9,0.83,0.87,38364,177,328,366
130697,Wesleyan University,1,0,2009,NA,NA,744,389,355,681,322,359,0.92,0.91,0.92,39822,187,330,380
130697,Wesleyan University,1,0,2010,NA,NA,748,411,337,652,292,360,0.87,0.87,0.87,41814,174,339,446
130776,WESTERN CONNECTICUT STATE UNIVERSITY,1,0,1991,NA,NA,349,187,162,96,32,64,0.34,0.2,0.28,2361,30,180,288
130776,WESTERN CONNECTICUT STATE UNIVERSITY,1,0,1992,NA,NA,372,161,211,88,47,41,0.25,0.22,0.24,2910,29,183,275
130776,WESTERN CONNECTICUT STATE UNIVERSITY,1,0,1993,NA,NA,526,247,279,115,50,65,0.26,0.18,0.22,2900,32,178,417
130776,WESTERN CONNECTICUT STATE UNIVERSITY,1,0,1995,NA,NA,460,237,223,79,35,44,0.18,0.16,0.17,3168,38,187,336
130776,WESTERN CONNECTICUT STATE UNIVERSITY,1,0,1996,NA,NA,496,242,254,60,32,28,0.11,0.13,0.12,3528,36,181,383
130776,WESTERN CONNECTICUT STATE UNIVERSITY,1,0,1997,NA,NA,668,303,365,90,35,55,0.18,0.1,0.13,3626,41,174,495
130776,WESTERN CONNECTICUT STATE UNIVERSITY,1,0,1998,NA,NA,655,315,340,91,33,58,0.18,0.1,0.14,3626,43,175,479
130776,WESTERN CONNECTICUT STATE UNIVERSITY,1,0,1999,NA,NA,697,359,338,70,22,48,0.13,0.07,0.1,2062,49,178,525
130776,WESTERN CONNECTICUT STATE UNIVERSITY,1,0,2000,NA,NA,822,404,418,104,42,62,0.15,0.1,0.13,2142,59,183,591
130776,WESTERN CONNECTICUT STATE UNIVERSITY,1,0,2001,NA,NA,841,439,402,111,36,75,0.17,0.09,0.13,2226,47,189,617
130776,WESTERN CONNECTICUT STATE UNIVERSITY,1,0,2002,NA,NA,794,434,360,113,32,81,0.18,0.09,0.14,2314,74,188,582
130776,WESTERN CONNECTICUT STATE UNIVERSITY,1,0,2003,NA,NA,808,444,364,105,40,65,0.14,0.11,0.13,2648,75,186,630
130776,WESTERN CONNECTICUT STATE UNIVERSITY,1,0,2004,NA,NA,755,382,373,120,53,67,0.17,0.14,0.16,3010,76,196,624
130776,Western Connecticut State University,1,0,2005,NA,NA,773,396,377,124,52,72,0.18,0.14,0.16,3034,95,197,617
130776,Western Connecticut State University,1,0,2006,NA,NA,843,413,430,167,64,103,0.24,0.15,0.2,3187,120,200,655
130776,Western Connecticut State University,1,0,2007,NA,NA,913,494,419,190,77,113,0.22,0.18,0.21,3346,106,212,701
130776,Western Connecticut State University,1,0,2008,NA,NA,928,462,466,180,82,98,0.21,0.18,0.19,3514,107,221,700
130776,Western Connecticut State University,1,0,2009,NA,NA,1008,549,459,255,99,156,0.28,0.22,0.25,3742,110,218,761
130776,Western Connecticut State University,1,0,2010,NA,NA,975,524,451,209,85,124,0.23,0.19,0.21,4023,110,228,653
130794,YALE UNIVERSITY,1,0,1991,NA,NA,1290,592,698,1127,608,519,0.87,0.87,0.87,16300,745,773,800
130794,YALE UNIVERSITY,1,0,1992,NA,NA,1326,640,686,1139,561,578,0.9,0.82,0.86,17500,799,755,805
130794,YALE UNIVERSITY,1,0,1993,NA,NA,1317,627,690,1135,582,553,0.88,0.84,0.86,18630,837,767,696
130794,YALE UNIVERSITY,1,0,1995,NA,NA,1360,692,668,1198,575,623,0.9,0.86,0.88,21000,934,765,773
130794,YALE UNIVERSITY,1,0,1996,NA,NA,1403,688,715,1235,611,624,0.9,0.85,0.88,22200,983,772,767
130794,YALE UNIVERSITY,1,0,1997,NA,NA,1307,662,645,1170,552,618,0.93,0.86,0.9,23100,995,758,701
130794,YALE UNIVERSITY,1,0,1998,NA,NA,1295,646,649,1146,573,573,0.88,0.88,0.88,23780,1066,777,656
130794,YALE UNIVERSITY,1,0,1999,NA,NA,1358,682,676,1219,594,625,0.91,0.88,0.9,24500,1136,814,736
130794,YALE UNIVERSITY,1,0,2000,NA,NA,1349,678,671,1189,582,607,0.89,0.87,0.88,25220,1283,845,693
130794,YALE UNIVERSITY,1,0,2001,NA,NA,1293,648,645,1125,538,587,0.9,0.83,0.87,26100,1334,877,645
130794,YALE UNIVERSITY,1,0,2002,NA,NA,1299,643,656,1164,576,588,0.91,0.88,0.9,27130,1426,893,661
130794,YALE UNIVERSITY,1,0,2003,NA,NA,1350,680,670,1221,582,639,0.93,0.87,0.9,28400,1543,1044,695
130794,YALE UNIVERSITY,1,0,2004,NA,NA,1306,632,674,1161,589,572,0.9,0.87,0.89,29820,1675,1037,650
130794,Yale University,1,0,2005,NA,NA,1320,651,669,1172,574,598,0.91,0.86,0.89,31460,1786,1038,624
130794,Yale University,1,0,2006,NA,NA,1313,654,659,1169,578,591,0.9,0.88,0.89,33030,1963,1081,628
130794,Yale University,1,0,2007,NA,NA,1313,661,652,1177,578,599,0.9,0.89,0.9,34530,2108,1079,697
130794,Yale University,1,0,2008,NA,NA,1316,664,652,1150,543,607,0.91,0.83,0.87,35300,2314,1129,638
130794,Yale University,1,0,2009,NA,NA,1305,651,654,1145,553,592,0.9,0.85,0.88,36500,2493,1164,667
130794,Yale University,1,0,2010,NA,NA,1343,696,647,1161,547,614,0.88,0.85,0.86,38300,2572,1152,665
130934,DELAWARE STATE COLLEGE,1,0,1991,NA,NA,585,330,255,53,12,41,0.12,0.05,0.09,1546,32,158,103
130934,DELAWARE STATE COLLEGE,1,0,1992,NA,NA,579,305,274,47,22,25,0.08,0.08,0.08,1788,36,185,107
130934,DELAWARE STATE UNIVERSITY,1,0,1993,NA,NA,686,386,300,68,11,57,0.14,0.04,0.1,1966,37,176,103
130934,DELAWARE STATE UNIVERSITY,1,0,1995,NA,NA,563,333,230,76,27,49,0.14,0.12,0.13,2250,46,168,53
130934,DELAWARE STATE UNIVERSITY,1,0,1996,NA,NA,544,305,239,87,21,66,0.21,0.09,0.16,2636,47,173,63
130934,DELAWARE STATE UNIVERSITY,1,0,1997,NA,NA,637,359,278,121,35,86,0.23,0.13,0.19,2810,49,175,60
130934,DELAWARE STATE UNIVERSITY,1,0,1998,NA,NA,578,339,239,118,39,79,0.23,0.16,0.2,2974,53,177,48
130934,DELAWARE STATE UNIVERSITY,1,0,1999,NA,NA,632,375,257,132,37,95,0.25,0.14,0.21,3096,58,184,67
130934,DELAWARE STATE UNIVERSITY,1,0,2000,NA,NA,684,405,279,155,36,119,0.29,0.13,0.23,3290,63,179,70
130934,DELAWARE STATE UNIVERSITY,1,0,2001,NA,NA,686,385,301,107,30,77,0.2,0.1,0.16,3422,64,174,55
130934,DELAWARE STATE UNIVERSITY,1,0,2002,NA,NA,761,439,322,1,0,1,0,0,0,3956,60,182,64
130934,DELAWARE STATE UNIVERSITY,1,0,2003,NA,NA,597,355,242,89,13,76,0.21,0.05,0.15,3996,63,194,53
130934,DELAWARE STATE UNIVERSITY,1,0,2004,NA,NA,687,400,287,133,23,110,0.27,0.08,0.19,4646,67,179,62
130934,Delaware State University,1,0,2005,NA,NA,885,514,371,164,40,124,0.24,0.11,0.19,5480,74,177,53
130934,Delaware State University,1,0,2006,NA,NA,818,463,355,126,37,89,0.19,0.1,0.15,5366,80,166,66
130934,Delaware State University,1,0,2007,NA,NA,799,495,304,145,37,108,0.21,0.12,0.18,5366,92,184,58
130934,Delaware State University,1,0,2008,NA,NA,721,455,266,154,36,118,0.25,0.14,0.21,5701,102,193,44
130934,Delaware State University,1,0,2009,NA,NA,739,463,276,165,42,123,0.26,0.15,0.22,5701,107,190,57
130934,Delaware State University,1,0,2010,NA,NA,887,556,331,220,58,162,0.29,0.18,0.25,5901,99,198,57
130943,UNIVERSITY OF DELAWARE,1,0,1991,NA,NA,3170,1871,1299,1592,524,1068,0.5700000000000001,0.4,0.5,3520,316,972,2948
130943,UNIVERSITY OF DELAWARE,1,0,1992,NA,NA,2944,1729,1215,1593,590,1003,0.58,0.49,0.54,3722,333,960,2695
130943,UNIVERSITY OF DELAWARE,1,0,1993,NA,NA,3181,1847,1334,1623,573,1050,0.56,0.43,0.51,3948,346,901,2892
130943,UNIVERSITY OF DELAWARE,1,0,1995,NA,NA,3155,1883,1272,1719,621,1098,0.58,0.49,0.54,4286,388,915,2784
130943,UNIVERSITY OF DELAWARE,1,0,1996,NA,NA,3290,1980,1310,1823,623,1200,0.6,0.48,0.55,4430,403,920,2881
130943,UNIVERSITY OF DELAWARE,1,0,1997,NA,NA,3179,1881,1298,1823,622,1201,0.63,0.48,0.57,4574,408,935,2781
130943,UNIVERSITY OF DELAWARE,1,0,1998,NA,NA,3545,2149,1396,2078,696,1382,0.64,0.5,0.59,4716,433,930,3145
130943,UNIVERSITY OF DELAWARE,1,0,1999,NA,NA,3513,2146,1367,2193,764,1429,0.66,0.56,0.62,4380,467,933,3123
130943,UNIVERSITY OF DELAWARE,1,0,2000,NA,NA,3128,1926,1202,1884,620,1264,0.65,0.52,0.6,4510,479,989,2722
130943,UNIVERSITY OF DELAWARE,1,0,2001,NA,NA,3362,1944,1418,2147,767,1380,0.7000000000000001,0.54,0.64,4770,473,1045,2939
130943,UNIVERSITY OF DELAWARE,1,0,2002,NA,NA,3712,2222,1490,2282,777,1505,0.67,0.52,0.61,5070,509,1124,3256
130943,UNIVERSITY OF DELAWARE,1,0,2003,NA,NA,3794,2157,1637,2016,761,1255,0.58,0.46,0.53,5890,514,1116,3154
130943,UNIVERSITY OF DELAWARE,1,0,2004,NA,NA,3769,2173,1596,2131,776,1355,0.62,0.49,0.57,6304,540,1121,3170
130943,University of Delaware,1,0,2005,NA,NA,3830,2252,1578,2250,803,1447,0.64,0.51,0.59,6614,578,1077,3183
130943,University of Delaware,1,0,2006,NA,NA,3563,2127,1436,2175,777,1398,0.65,0.54,0.61,6980,603,1117,2907
130943,University of Delaware,1,0,2007,NA,NA,3912,2305,1607,2445,879,1566,0.67,0.55,0.62,7340,639,1117,3046
130943,University of Delaware,1,0,2008,NA,NA,3834,2211,1623,2378,891,1487,0.67,0.55,0.62,7780,674,1117,3028
130943,University of Delaware,1,0,2009,NA,NA,4211,2424,1787,2486,929,1557,0.64,0.52,0.59,8540,702,1112,3261
130943,University of Delaware,1,0,2010,NA,NA,3719,2116,1603,2399,913,1486,0.7000000000000001,0.57,0.65,9040,738,1126,2863
131159,AMERICAN UNIVERSITY,1,0,1991,NA,NA,1027,633,394,622,223,399,0.63,0.57,0.61,13716,159,468,794
131159,AMERICAN UNIVERSITY,1,0,1992,NA,NA,1025,629,396,629,235,394,0.62,0.59,0.61,14594,169,452,786
131159,AMERICAN UNIVERSITY,1,0,1993,NA,NA,1039,660,379,641,219,422,0.63,0.58,0.62,15386,176,446,805
131159,AMERICAN UNIVERSITY,1,0,1995,NA,NA,1221,794,427,789,288,501,0.63,0.67,0.65,17115,190,441,964
131159,AMERICAN UNIVERSITY,1,0,1996,NA,NA,1107,703,404,643,224,419,0.59,0.55,0.58,17744,180,452,799
131159,AMERICAN UNIVERSITY,1,0,1997,NA,NA,1056,665,391,678,239,439,0.66,0.61,0.64,18555,173,456,781
131159,AMERICAN UNIVERSITY,1,0,1998,NA,NA,1232,774,458,802,262,540,0.6900000000000001,0.57,0.65,19433,186,457,919
131159,AMERICAN UNIVERSITY,1,0,1999,NA,NA,1146,744,402,723,231,492,0.66,0.57,0.63,20118,203,463,706
131159,AMERICAN UNIVERSITY,1,0,2000,NA,NA,1272,821,451,818,260,558,0.67,0.58,0.64,21144,204,475,813
131159,AMERICAN UNIVERSITY,1,0,2001,NA,NA,1387,875,512,924,330,594,0.67,0.64,0.67,22116,219,487,925
131159,AMERICAN UNIVERSITY,1,0,2002,NA,NA,1303,811,492,917,329,588,0.72,0.67,0.7,23068,243,476,910
131159,AMERICAN UNIVERSITY,1,0,2003,NA,NA,1238,832,406,882,286,596,0.71,0.7,0.71,24452,262,492,835
131159,AMERICAN UNIVERSITY,1,0,2004,NA,NA,1210,776,434,902,306,596,0.76,0.71,0.75,25920,275,490,811
131159,American University,1,0,2005,NA,NA,1216,778,438,898,319,579,0.74,0.73,0.74,27552,292,543,820
131159,American University,1,0,2006,NA,NA,1385,923,462,1007,321,686,0.74,0.69,0.73,29206,306,547,966
131159,American University,1,0,2007,NA,NA,1288,840,448,975,334,641,0.76,0.75,0.76,30958,323,568,850
131159,American University,1,0,2008,NA,NA,1570,967,603,1199,442,757,0.78,0.73,0.76,32816,357,588,917
131159,American University,1,0,2009,NA,NA,1527,917,610,1164,449,715,0.77,0.74,0.76,34456,369,637,914
131159,American University,1,0,2010,NA,NA,1498,911,587,1145,438,707,0.77,0.75,0.76,36180,406,681,935
131283,CATHOLIC UNIVERSITY OF AMERICA,1,0,1991,NA,NA,532,308,224,309,124,185,0.6,0.55,0.58,11936,95,386,428
131283,CATHOLIC UNIVERSITY OF AMERICA,1,0,1992,NA,NA,471,252,219,272,121,151,0.59,0.55,0.58,12986,101,389,380
131283,CATHOLIC UNIVERSITY OF AMERICA,1,0,1993,NA,NA,505,276,229,306,130,176,0.63,0.57,0.61,13614,100,380,418
131283,CATHOLIC UNIVERSITY OF AMERICA,1,0,1995,NA,NA,514,265,249,290,125,165,0.62,0.5,0.56,15062,111,357,408
131283,CATHOLIC UNIVERSITY OF AMERICA,1,0,1996,NA,NA,452,264,188,261,100,161,0.6,0.53,0.58,16152,115,355,362
131283,CATHOLIC UNIVERSITY OF AMERICA,1,0,1997,NA,NA,567,313,254,337,148,189,0.6,0.58,0.59,17110,104,347,472
131283,CATHOLIC UNIVERSITY OF AMERICA,1,0,1998,NA,NA,597,338,259,378,149,229,0.67,0.58,0.63,18066,108,350,489
131283,CATHOLIC UNIVERSITY OF AMERICA,1,0,1999,NA,NA,762,381,381,457,204,253,0.66,0.54,0.6,18200,118,349,641
131283,CATHOLIC UNIVERSITY OF AMERICA,1,0,2000,NA,NA,530,298,232,315,126,189,0.63,0.54,0.59,19100,90,354,406
131283,CATHOLIC UNIVERSITY OF AMERICA,1,0,2001,NA,NA,613,342,271,407,170,237,0.6900000000000001,0.63,0.66,20050,125,360,513
131283,CATHOLIC UNIVERSITY OF AMERICA,1,0,2002,NA,NA,700,406,294,438,170,268,0.66,0.58,0.63,21050,134,359,550
131283,CATHOLIC UNIVERSITY OF AMERICA,1,0,2003,NA,NA,646,362,284,423,167,256,0.7000000000000001,0.59,0.65,22200,141,336,506
131283,CATHOLIC UNIVERSITY OF AMERICA,1,0,2004,NA,NA,719,387,332,429,182,247,0.63,0.55,0.6,23600,154,354,545
131283,Catholic University of America,1,0,2005,NA,NA,786,455,331,482,187,295,0.64,0.56,0.61,24800,160,344,569
131283,Catholic University of America,1,0,2006,NA,NA,856,459,397,527,219,308,0.67,0.55,0.62,26200,165,344,608
131283,Catholic University of America,1,0,2007,NA,NA,864,451,413,535,233,302,0.66,0.56,0.62,27700,177,347,653
131283,Catholic University of America,1,0,2008,NA,NA,901,475,426,537,234,303,0.63,0.55,0.6,30520,191,352,605
131283,Catholic University of America,1,0,2009,NA,NA,813,456,357,501,184,317,0.6900000000000001,0.52,0.62,31740,194,368,542
131283,Catholic University of America,1,0,2010,NA,NA,991,576,415,613,240,373,0.64,0.58,0.62,33580,202,385,666
131450,GALLAUDET UNIVERSITY,1,0,1991,NA,NA,227,129,98,15,2,13,0.1,0.02,0.07,3854,73,266,149
131450,GALLAUDET UNIVERSITY,1,0,1992,NA,NA,339,177,162,15,6,9,0.05,0.04,0.04,4194,75,264,210
131450,GALLAUDET UNIVERSITY,1,0,1993,NA,NA,306,164,142,18,6,12,0.07,0.04,0.06,4570,79,261,190
131450,GALLAUDET UNIVERSITY,1,0,1995,NA,NA,225,120,105,10,2,8,0.06,0.02,0.04,6140,86,244,137
131450,GALLAUDET UNIVERSITY,1,0,1996,NA,NA,186,105,81,13,6,7,0.06,0.07,0.07,6650,87,225,113
131450,GALLAUDET UNIVERSITY,1,0,1997,NA,NA,211,116,95,10,3,7,0.06,0.03,0.05,7043,84,225,134
131450,GALLAUDET UNIVERSITY,1,0,1998,NA,NA,230,112,118,17,7,10,0.08,0.06,0.07,7464,86,221,125
131450,GALLAUDET UNIVERSITY,1,0,1999,NA,NA,254,135,119,14,6,8,0.05,0.05,0.06,6870,90,227,168
131450,GALLAUDET UNIVERSITY,1,0,2000,NA,NA,241,123,118,16,3,13,0.1,0.03,0.07,7350,94,225,142
131450,GALLAUDET UNIVERSITY,1,0,2001,NA,NA,213,113,100,10,3,7,0.06,0.03,0.05,7870,96,223,126
131450,GALLAUDET UNIVERSITY,1,0,2002,NA,NA,235,122,113,12,6,6,0.04,0.05,0.05,8420,106,229,143
131450,GALLAUDET UNIVERSITY,1,0,2003,NA,NA,236,124,112,25,8,17,0.13,0.07,0.11,9000,105,230,144
131450,GALLAUDET UNIVERSITY,1,0,2004,NA,NA,227,121,106,18,8,10,0.08,0.08,0.08,9630,107,230,128
131450,Gallaudet University,1,0,2005,NA,NA,280,151,129,28,7,21,0.13,0.05,0.1,9920,115,235,176
131450,Gallaudet University,1,0,2006,NA,NA,209,96,113,15,5,10,0.1,0.04,0.07,10220,119,227,146
131450,Gallaudet University,1,0,2007,NA,NA,174,97,77,27,9,18,0.18,0.12,0.16,10220,123,211,123
131450,Gallaudet University,1,0,2008,NA,NA,179,97,82,29,9,20,0.2,0.11,0.16,10850,129,200,111
131450,Gallaudet University,1,0,2009,NA,NA,211,112,99,51,13,38,0.33,0.13,0.24,10850,134,201,141
131450,Gallaudet University,1,0,2010,NA,NA,198,107,91,39,10,29,0.27,0.11,0.2,10850,135,191,120
131469,GEORGE WASHINGTON UNIVERSITY,1,0,1991,NA,NA,1151,622,529,686,282,404,0.64,0.53,0.6,14902,522,633,802
131469,GEORGE WASHINGTON UNIVERSITY,1,0,1992,NA,NA,1193,642,551,695,291,404,0.62,0.53,0.58,16080,578,643,765
131469,GEORGE WASHINGTON UNIVERSITY,1,0,1993,NA,NA,1492,801,691,887,373,514,0.64,0.54,0.59,16988,671,637,983
131469,GEORGE WASHINGTON UNIVERSITY,1,0,1995,NA,NA,1367,803,564,905,346,559,0.6900000000000001,0.61,0.66,19032,778,633,917
131469,GEORGE WASHINGTON UNIVERSITY,1,0,1996,NA,NA,1643,973,670,1082,427,655,0.67,0.64,0.66,19980,767,649,1081
131469,GEORGE WASHINGTON UNIVERSITY,1,0,1997,NA,NA,1716,972,744,1185,485,700,0.72,0.65,0.69,21360,724,670,1102
131469,GEORGE WASHINGTON UNIVERSITY,1,0,1998,NA,NA,1773,1057,716,1285,471,814,0.77,0.66,0.72,22625,669,692,1182
131469,GEORGE WASHINGTON UNIVERSITY,1,0,1999,NA,NA,2109,1282,827,1515,556,959,0.74,0.67,0.72,22925,697,717,1427
131469,GEORGE WASHINGTON UNIVERSITY,1,0,2000,NA,NA,2093,1241,852,1504,574,930,0.74,0.67,0.72,24005,651,742,1426
131469,GEORGE WASHINGTON UNIVERSITY,1,0,2001,NA,NA,2566,1433,1133,1864,761,1103,0.76,0.67,0.73,24880,554,767,1696
131469,GEORGE WASHINGTON UNIVERSITY,1,0,2002,NA,NA,2283,1359,924,1735,660,1075,0.79,0.71,0.76,27790,608,890,1518
131469,GEORGE WASHINGTON UNIVERSITY,1,0,2003,NA,NA,2260,1333,927,1726,683,1043,0.78,0.74,0.76,29320,639,862,1550
131469,GEORGE WASHINGTON UNIVERSITY,1,0,2004,NA,NA,2623,1441,1182,1957,830,1127,0.78,0.7,0.75,34000,671,859,1763
131469,George Washington University,1,0,2005,NA,NA,2408,1375,1033,1823,732,1091,0.79,0.71,0.76,33992,718,841,1562
131469,George Washington University,1,0,2006,NA,NA,2440,1348,1092,1804,756,1048,0.77,0.69,0.74,35604,776,854,1544
131469,George Washington University,1,0,2007,NA,NA,2123,1198,925,1604,668,936,0.78,0.72,0.76,37000,821,904,1275
131469,George Washington University,1,0,2008,NA,NA,2449,1408,1041,1755,687,1068,0.75,0.66,0.72,38630,903,910,1224
131469,George Washington University,1,0,2009,NA,NA,2582,1435,1147,1940,825,1115,0.77,0.72,0.75,39962,953,939,1437
131469,George Washington University,1,0,2010,NA,NA,2376,1316,1060,1805,761,1044,0.79,0.72,0.76,41182,986,983,1535
131496,GEORGETOWN UNIVERSITY,1,0,1991,NA,NA,1369,710,659,1133,547,586,0.8200000000000001,0.83,0.83,15652,645,499,964
131496,GEORGETOWN UNIVERSITY,1,0,1992,NA,NA,1383,733,650,1179,550,629,0.85,0.85,0.85,16589,717,514,945
131496,GEORGETOWN UNIVERSITY,1,0,1993,NA,NA,1377,720,657,1155,551,604,0.8300000000000001,0.84,0.84,17586,745,528,940
131496,GEORGETOWN UNIVERSITY,1,0,1995,NA,NA,1403,742,661,1207,568,639,0.86,0.86,0.86,19402,822,553,973
131496,GEORGETOWN UNIVERSITY,1,0,1996,NA,NA,1408,760,648,1256,569,687,0.9,0.88,0.89,20388,863,576,1020
131496,GEORGETOWN UNIVERSITY,1,0,1997,NA,NA,1394,757,637,1247,561,686,0.9,0.88,0.89,21405,837,616,978
131496,GEORGETOWN UNIVERSITY,1,0,1998,NA,NA,1470,810,660,1302,581,721,0.89,0.88,0.89,22446,854,617,1036
131496,GEORGETOWN UNIVERSITY,1,0,1999,NA,NA,1474,802,672,1299,587,712,0.88,0.87,0.88,23088,889,622,1028
131496,GEORGETOWN UNIVERSITY,1,0,2000,NA,NA,1469,789,680,1327,603,724,0.91,0.89,0.9,23952,545,634,1064
131496,GEORGETOWN UNIVERSITY,1,0,2001,NA,NA,1482,757,725,1339,648,691,0.91,0.89,0.9,25152,540,646,1066
131496,GEORGETOWN UNIVERSITY,1,0,2002,NA,NA,1477,795,682,1324,608,716,0.9,0.89,0.9,26544,584,746,1042
131496,GEORGETOWN UNIVERSITY,1,0,2003,NA,NA,1504,827,677,1321,575,746,0.9,0.85,0.88,27864,639,780,970
131496,GEORGETOWN UNIVERSITY,1,0,2004,NA,NA,1523,855,668,1358,574,784,0.91,0.86,0.89,29808,680,821,1055
131496,Georgetown University,1,0,2005,NA,NA,1530,774,756,1378,669,709,0.91,0.88,0.9,31656,711,836,1007
131496,Georgetown University,1,0,2006,NA,NA,1588,877,711,1419,630,789,0.89,0.89,0.89,33552,744,875,1047
131496,Georgetown University,1,0,2007,NA,NA,1577,864,713,1387,616,771,0.89,0.86,0.88,35568,818,915,1083
131496,Georgetown University,1,0,2008,NA,NA,1571,822,749,1430,665,765,0.93,0.89,0.91,37536,890,943,1099
131496,Georgetown University,1,0,2009,NA,NA,1550,861,689,1389,601,788,0.91,0.87,0.9,38616,937,980,1027
131496,Georgetown University,1,0,2010,NA,NA,1569,859,710,1414,623,791,0.92,0.88,0.9,39768,974,966,1016
131520,HOWARD UNIVERSITY,1,0,1991,NA,NA,1089,687,402,261,64,197,0.28,0.16,0.24,6438,458,820,3
131520,HOWARD UNIVERSITY,1,0,1992,NA,NA,1264,797,467,264,70,194,0.24,0.15,0.21,6981,461,825,3
131520,HOWARD UNIVERSITY,1,0,1993,NA,NA,1492,951,541,352,88,264,0.27,0.16,0.24,7535,563,891,0
131520,HOWARD UNIVERSITY,1,0,1995,NA,NA,834,540,294,438,117,321,0.59,0.4,0.53,8105,605,723,1
131520,HOWARD UNIVERSITY,1,0,1996,NA,NA,1002,648,354,463,126,337,0.52,0.36,0.46,8725,551,809,1
131520,HOWARD UNIVERSITY,1,0,1997,NA,NA,1098,715,383,402,98,304,0.42,0.26,0.37,8985,509,873,3
131520,HOWARD UNIVERSITY,1,0,1998,NA,NA,1244,831,413,469,103,366,0.44,0.25,0.38,9155,535,849,0
131520,HOWARD UNIVERSITY,1,0,1999,NA,NA,937,632,305,405,99,306,0.48,0.32,0.43,8925,599,865,2
131520,HOWARD UNIVERSITY,1,0,2000,NA,NA,1355,909,446,624,145,479,0.52,0.33,0.46,9190,635,922,6
131520,HOWARD UNIVERSITY,1,0,2001,NA,NA,1344,900,444,680,185,495,0.55,0.42,0.51,9515,642,979,0
131520,HOWARD UNIVERSITY,1,0,2002,NA,NA,1366,931,435,621,125,496,0.53,0.29,0.45,9515,657,810,2
131520,HOWARD UNIVERSITY,1,0,2003,NA,NA,1446,992,454,679,155,524,0.52,0.34,0.47,10130,676,836,1
131520,HOWARD UNIVERSITY,1,0,2004,NA,NA,1445,987,458,691,151,540,0.54,0.33,0.48,10840,716,842,2
131520,Howard University,1,0,2005,NA,NA,1410,944,466,635,166,469,0.49,0.36,0.45,11490,726,859,3
131520,Howard University,1,0,2006,NA,NA,1512,1022,490,629,155,474,0.46,0.32,0.42,12180,737,1177,0
131520,Howard University,1,0,2007,NA,NA,1451,1028,423,574,129,445,0.43,0.3,0.4,13215,793,1034,0
131520,Howard University,1,0,2008,NA,NA,1477,1004,473,629,133,496,0.49,0.28,0.43,14205,834,807,0
131520,Howard University,1,0,2009,NA,NA,1600,1097,503,633,144,489,0.44,0.29,0.4,15270,1051,955,0
131520,Howard University,1,0,2010,NA,NA,1464,1034,430,571,122,449,0.43,0.28,0.39,17100,903,676,0
132471,BARRY UNIVERSITY,1,0,1991,NA,NA,301,179,122,85,34,51,0.28,0.28,0.28,9793,39,188,122
132471,BARRY UNIVERSITY,1,0,1992,NA,NA,265,146,119,80,28,52,0.35000000000000003,0.24,0.3,10180,44,195,129
132471,BARRY UNIVERSITY,1,0,1993,NA,NA,232,143,89,77,19,58,0.4,0.21,0.33,11030,57,215,111
132471,BARRY UNIVERSITY,1,0,1995,NA,NA,177,103,74,46,10,36,0.34,0.14,0.26,12110,61,245,71
132471,BARRY UNIVERSITY,1,0,1996,NA,NA,177,101,76,40,16,24,0.23,0.21,0.23,12790,66,238,70
132471,BARRY UNIVERSITY,1,0,1997,NA,NA,176,112,64,58,18,40,0.35000000000000003,0.28,0.33,13460,55,248,64
132471,BARRY UNIVERSITY,1,0,1998,NA,NA,393,249,144,82,20,62,0.24,0.14,0.21,14790,65,254,133
132471,BARRY UNIVERSITY,1,0,1999,NA,NA,398,251,147,9,1,8,0.03,0.01,0.02,15530,71,267,123
132471,BARRY UNIVERSITY,1,0,2000,NA,NA,401,258,143,70,18,52,0.2,0.13,0.17,15530,85,296,120
132471,BARRY UNIVERSITY,1,0,2001,NA,NA,431,264,167,101,32,69,0.26,0.19,0.23,17500,94,326,148
132471,BARRY UNIVERSITY,1,0,2002,NA,NA,446,273,173,110,34,76,0.27,0.2,0.25,18900,108,334,162
132471,BARRY UNIVERSITY,1,0,2003,NA,NA,517,336,181,91,33,58,0.17,0.18,0.18,20320,116,342,190
132471,BARRY UNIVERSITY,1,0,2004,NA,NA,553,349,204,101,29,72,0.2,0.14,0.18,21350,118,353,160
132471,Barry University,1,0,2005,NA,NA,563,356,207,117,35,82,0.23,0.17,0.21,22430,125,357,209
132471,Barry University,1,0,2006,NA,NA,387,255,132,82,24,58,0.22,0.18,0.21,24000,132,340,96
132471,Barry University,1,0,2007,NA,NA,472,316,156,102,28,74,0.23,0.18,0.22,24500,137,315,117
132471,Barry University,1,0,2008,NA,NA,584,400,184,120,34,86,0.21,0.18,0.21,25500,134,325,111
132471,Barry University,1,0,2009,NA,NA,648,433,215,102,25,77,0.17,0.12,0.16,26400,139,341,88
132471,Barry University,1,0,2010,NA,NA,625,403,222,98,32,66,0.16,0.14,0.16,27200,146,422,73
132602,BETHUNE COOKMAN COLLEGE,1,0,1991,NA,NA,619,348,271,134,25,109,0.31,0.09,0.22,4835,27,122,4
132602,BETHUNE COOKMAN COLLEGE,1,0,1992,NA,NA,597,326,271,99,29,70,0.21,0.11,0.17,4965,30,123,4
132602,BETHUNE COOKMAN COLLEGE,1,0,1993,NA,NA,543,291,252,100,28,72,0.24,0.11,0.18,5165,31,125,4
132602,BETHUNE COOKMAN COLLEGE,1,0,1995,NA,NA,729,393,336,106,31,75,0.19,0.09,0.15,6458,31,126,1
132602,BETHUNE COOKMAN COLLEGE,1,0,1996,NA,NA,575,322,253,93,20,73,0.22,0.08,0.16,6780,36,128,0
132602,BETHUNE COOKMAN COLLEGE,1,0,1997,NA,NA,749,388,361,77,25,52,0.13,0.07,0.1,7280,28,130,1
132602,BETHUNE COOKMAN COLLEGE,1,0,1998,NA,NA,623,316,307,97,24,73,0.23,0.08,0.16,8047,35,133,10
132602,BETHUNE COOKMAN COLLEGE,1,0,1999,NA,NA,677,360,317,134,36,98,0.27,0.11,0.2,8560,36,132,5
132602,BETHUNE COOKMAN COLLEGE,1,0,2000,NA,NA,833,478,355,105,26,79,0.16,0.07,0.13,8988,37,135,7
132602,BETHUNE COOKMAN COLLEGE,1,0,2001,NA,NA,720,386,334,91,31,60,0.15,0.09,0.13,9617,42,138,13
132602,BETHUNE COOKMAN COLLEGE,1,0,2002,NA,NA,607,351,256,161,59,102,0.29,0.23,0.27,9810,43,136,10
132602,BETHUNE COOKMAN COLLEGE,1,0,2003,NA,NA,827,492,335,112,24,88,0.17,0.07,0.14,10106,45,141,7
132602,BETHUNE COOKMAN COLLEGE,1,0,2004,NA,NA,818,503,315,118,29,89,0.17,0.09,0.14,10610,48,150,5
132602,Bethune Cookman College,1,0,2005,NA,NA,913,525,388,140,52,88,0.16,0.13,0.15,11140,49,147,9
132602,Bethune Cookman College,1,0,2006,NA,NA,901,497,404,142,64,78,0.15,0.16,0.16,11792,50,161,12
132602,Bethune-Cookman University,1,0,2007,NA,NA,821,511,310,136,44,92,0.18,0.14,0.17,12382,54,162,5
132602,Bethune-Cookman University,1,0,2008,NA,NA,719,478,241,198,38,160,0.33,0.16,0.28,12876,57,204,6
132602,Bethune-Cookman University,1,0,2009,NA,NA,917,551,366,233,76,157,0.28,0.21,0.25,12936,63,202,6
132602,Bethune-Cookman University,1,0,2010,NA,NA,924,579,345,132,32,100,0.17,0.09,0.14,13452,60,197,9
132903,UNIVERSITY OF CENTRAL FLORIDA,1,0,1991,NA,NA,1577,813,764,332,89,243,0.29,0.12,0.21,1523,148,597,1026
132903,UNIVERSITY OF CENTRAL FLORIDA,1,0,1992,NA,NA,1405,745,660,330,92,238,0.31,0.14,0.23,1713,151,585,995
132903,UNIVERSITY OF CENTRAL FLORIDA,1,0,1993,NA,NA,1882,955,927,432,144,288,0.3,0.16,0.23,1756,158,593,1365
132903,UNIVERSITY OF CENTRAL FLORIDA,1,0,1995,NA,NA,2411,1295,1116,661,217,444,0.34,0.19,0.27,1840,187,566,1900
132903,UNIVERSITY OF CENTRAL FLORIDA,1,0,1996,NA,NA,2579,1316,1263,672,219,453,0.34,0.17,0.26,1924,202,685,1966
132903,UNIVERSITY OF CENTRAL FLORIDA,1,0,1997,NA,NA,2839,1510,1329,785,265,520,0.34,0.2,0.28,2024,219,662,2171
132903,UNIVERSITY OF CENTRAL FLORIDA,1,0,1998,NA,NA,3792,1932,1860,1097,387,710,0.36,0.21,0.29,2121,255,777,2959
132903,UNIVERSITY OF CENTRAL FLORIDA,1,0,1999,NA,NA,4267,2256,2011,1298,425,873,0.38,0.21,0.3,2296,286,874,3177
132903,UNIVERSITY OF CENTRAL FLORIDA,1,0,2000,NA,NA,4558,2436,2122,1384,436,948,0.38,0.21,0.3,1554,310,903,3329
132903,UNIVERSITY OF CENTRAL FLORIDA,1,0,2001,NA,NA,4913,2621,2292,1529,529,1000,0.38,0.23,0.31,1670,364,932,3537
132903,UNIVERSITY OF CENTRAL FLORIDA,1,0,2002,NA,NA,5330,2851,2479,1736,578,1158,0.4,0.23,0.33,1753,359,1004,3824
132903,UNIVERSITY OF CENTRAL FLORIDA,1,0,2003,NA,NA,5653,2956,2697,1923,673,1250,0.42,0.25,0.34,1902,434,1068,3910
132903,UNIVERSITY OF CENTRAL FLORIDA,1,0,2004,NA,NA,5710,3041,2669,1986,723,1263,0.41000000000000003,0.27,0.35,2045,482,1120,4020
132903,University of Central Florida,1,0,2005,NA,NA,6041,3216,2825,2025,720,1305,0.4,0.25,0.34,2147,529,1134,4096
132903,University of Central Florida,1,0,2006,NA,NA,6389,3389,3000,2257,754,1503,0.44,0.25,0.35,2211,574,1168,4542
132903,University of Central Florida,1,0,2007,NA,NA,6350,3310,3040,2277,827,1450,0.43,0.27,0.36,2211,624,1158,4398
132903,University of Central Florida,1,0,2008,NA,NA,6139,3283,2856,2464,867,1597,0.48,0.3,0.4,2531,661,1139,4150
132903,University of Central Florida,1,0,2009,NA,NA,6251,3342,2909,2529,868,1661,0.49,0.3,0.4,2910,695,1097,4258
132903,University of Central Florida,1,0,2010,NA,NA,6028,3179,2849,2407,859,1548,0.48,0.3,0.4,3347,711,1122,3805
133492,ECKERD COLLEGE,1,0,1991,NA,NA,336,187,149,186,80,106,0.56,0.54,0.55,12900,29,84,278
133492,ECKERD COLLEGE,1,0,1992,NA,NA,348,182,166,187,92,95,0.52,0.55,0.54,13725,32,86,279
133492,ECKERD COLLEGE,1,0,1993,NA,NA,364,185,179,201,103,98,0.52,0.58,0.55,14770,36,87,303
133492,ECKERD COLLEGE,1,0,1995,NA,NA,334,184,150,199,83,116,0.63,0.55,0.6,15975,38,92,278
133492,ECKERD COLLEGE,1,0,1996,NA,NA,429,260,169,242,84,158,0.6,0.5,0.56,16625,39,92,341
133492,ECKERD COLLEGE,1,0,1997,NA,NA,386,230,156,230,88,142,0.61,0.56,0.6,17130,34,96,310
133492,ECKERD COLLEGE,1,0,1998,NA,NA,407,227,180,234,99,135,0.59,0.55,0.57,17685,38,91,330
133492,ECKERD COLLEGE,1,0,1999,NA,NA,403,210,193,232,101,131,0.62,0.52,0.58,18025,40,96,326
133492,ECKERD COLLEGE,1,0,2000,NA,NA,408,223,185,215,95,120,0.53,0.51,0.53,18565,44,96,315
133492,ECKERD COLLEGE,1,0,2001,NA,NA,424,241,183,225,83,142,0.58,0.45,0.53,19870,45,97,345
133492,ECKERD COLLEGE,1,0,2002,NA,NA,442,239,203,261,117,144,0.6,0.58,0.59,21262,45,94,332
133492,ECKERD COLLEGE,1,0,2003,NA,NA,434,248,186,250,101,149,0.6,0.54,0.58,22538,46,103,338
133492,ECKERD COLLEGE,1,0,2004,NA,NA,471,272,199,297,119,178,0.65,0.6,0.63,24116,49,106,372
133492,Eckerd College,1,0,2005,NA,NA,501,297,204,275,102,173,0.58,0.5,0.55,25804,55,112,408
133492,Eckerd College,1,0,2006,NA,NA,544,315,229,308,113,195,0.61,0.49,0.57,27352,58,114,447
133492,Eckerd College,1,0,2007,NA,NA,535,319,216,315,127,188,0.58,0.59,0.59,28860,62,113,432
133492,Eckerd College,1,0,2008,NA,NA,487,285,202,283,116,167,0.58,0.57,0.58,30304,64,112,385
133492,Eckerd College,1,0,2009,NA,NA,504,300,204,301,122,179,0.59,0.6,0.6,31818,63,115,413
133492,Eckerd College,1,0,2010,NA,NA,496,300,196,304,117,187,0.62,0.6,0.61,32932,63,114,384
133553,EMBRY-RIDDLE AERONAUTICAL UNIVERSITY,1,0,1991,NA,NA,875,134,741,190,158,32,0.23,0.21,0.22,6310,86,312,730
133553,EMBRY-RIDDLE AERONAUTICAL UNIVERSITY,1,0,1992,NA,NA,801,132,669,190,149,41,0.31,0.22,0.24,6810,93,311,691
133553,EMBRY-RIDDLE AERONAUTICAL UNIVERSITY,1,0,1993,NA,NA,799,128,671,154,122,32,0.25,0.18,0.19,7370,95,299,688
133553,EMBRY-RIDDLE AERONAUTICAL UNIVERSITY,1,0,1995,NA,NA,665,100,565,128,105,23,0.23,0.19,0.19,8280,98,274,498
133553,EMBRY-RIDDLE AERONAUTICAL UNIVERSITY,1,0,1996,NA,NA,711,95,616,132,119,13,0.13,0.19,0.19,8740,104,252,476
133553,EMBRY-RIDDLE AERONAUTICAL UNIVERSITY,1,0,1997,NA,NA,1020,136,884,213,184,29,0.21,0.21,0.21,9230,104,248,689
133553,EMBRY-RIDDLE AERONAUTICAL UNIVERSITY,1,0,1998,NA,NA,934,128,806,279,230,49,0.38,0.29,0.3,9920,113,247,644
133553,EMBRY RIDDLE AERONAUTICAL UNIVERSITY,1,0,1999,NA,NA,939,151,788,305,245,60,0.39,0.31,0.32,10100,122,247,685
133553,EMBRY RIDDLE AERONAUTICAL UNIVERSITY,1,0,2000,NA,NA,797,124,673,280,225,55,0.44,0.33,0.35,14500,136,208,603
133553,EMBRY RIDDLE AERONAUTICAL UNIVERSITY-DAYTONA BEACH,1,0,2001,NA,NA,1013,159,854,338,277,61,0.38,0.32,0.33,15370,154,170,753
133553,EMBRY RIDDLE AERONAUTICAL UNIVERSITY-DAYTONA BEACH,1,0,2002,NA,NA,872,148,724,315,244,71,0.47000000000000003,0.34,0.36,17850,170,183,633
133553,EMBRY RIDDLE AERONAUTICAL UNIVERSITY-DAYTONA BEACH,1,0,2003,NA,NA,1012,164,848,292,238,54,0.32,0.28,0.29,20700,188,183,687
133553,EMBRY RIDDLE AERONAUTICAL UNIVERSITY-DAYTONA BEACH,1,0,2004,NA,NA,933,139,794,282,231,51,0.36,0.29,0.3,21530,206,187,646
133553,Embry Riddle Aeronautical University-Daytona Beach,1,0,2005,NA,NA,975,152,823,307,246,61,0.4,0.3,0.31,22820,217,191,656
133553,Embry Riddle Aeronautical University-Daytona Beach,1,0,2006,NA,NA,1101,161,940,363,290,73,0.45,0.31,0.33,24420,234,198,713
133553,Embry Riddle Aeronautical University-Daytona Beach,1,0,2007,NA,NA,1014,158,856,341,277,64,0.4,0.32,0.34,25400,240,210,650
133553,Embry Riddle Aeronautical University-Daytona Beach,1,0,2008,NA,NA,1058,158,900,325,263,62,0.39,0.29,0.31,26420,250,214,667
133553,Embry Riddle Aeronautical University-Daytona Beach,1,0,2009,NA,NA,853,134,719,265,203,62,0.46,0.28,0.31,27480,265,211,476
133553,Embry Riddle Aeronautical University-Daytona Beach,1,0,2010,NA,NA,949,120,829,283,239,44,0.36,0.29,0.3,28560,260,222,574
133650,FLORIDA AGRICULTURAL AND MECHANICAL UNIVERSITY,1,0,1991,NA,NA,1608,945,663,188,36,152,0.16,0.05,0.12,1545,94,400,8
133650,FLORIDA AGRICULTURAL AND MECHANICAL UNIVERSITY,1,0,1992,NA,NA,1383,815,568,206,60,146,0.17,0.11,0.15,1749,102,355,18
133650,FLORIDA AGRICULTURAL AND MECHANICAL UNIVERSITY,1,0,1993,NA,NA,1507,908,599,210,46,164,0.18,0.08,0.14,1829,110,364,15
133650,FLORIDA AGRICULTURAL AND MECHANICAL UNIVERSITY,1,0,1995,NA,NA,1574,952,622,245,63,182,0.19,0.1,0.16,1848,135,443,9
133650,FLORIDA AGRICULTURAL AND MECHANICAL UNIVERSITY,1,0,1996,NA,NA,1717,1017,700,281,83,198,0.19,0.12,0.16,1863,150,446,16
133650,FLORIDA AGRICULTURAL AND MECHANICAL UNIVERSITY,1,0,1997,NA,NA,1947,1148,799,328,84,244,0.21,0.11,0.17,1970,189,482,15
133650,FLORIDA AGRICULTURAL AND MECHANICAL UNIVERSITY,1,0,1998,NA,NA,2213,1294,919,385,120,265,0.2,0.13,0.17,2133,169,435,7
133650,FLORIDA AGRICULTURAL AND MECHANICAL UNIVERSITY,1,0,1999,NA,NA,2205,1277,928,360,86,274,0.21,0.09,0.16,2325,191,442,13
133650,FLORIDA AGRICULTURAL AND MECHANICAL UNIVERSITY,1,0,2000,NA,NA,2145,1263,882,415,99,316,0.25,0.11,0.19,1554,199,465,17
133650,FLORIDA AGRICULTURAL AND MECHANICAL UNIVERSITY,1,0,2001,NA,NA,2243,1300,943,368,88,280,0.21,0.09,0.16,1670,215,488,15
133650,FLORIDA AGRICULTURAL AND MECHANICAL UNIVERSITY,1,0,2002,NA,NA,2097,1249,848,280,77,203,0.16,0.09,0.13,1754,206,490,14
133650,FLORIDA AGRICULTURAL AND MECHANICAL UNIVERSITY,1,0,2003,NA,NA,2403,1391,1012,289,79,210,0.15,0.08,0.12,1902,230,518,20
133650,FLORIDA AGRICULTURAL AND MECHANICAL UNIVERSITY,1,0,2004,NA,NA,2105,1242,863,268,73,195,0.15,0.08,0.13,2045,263,548,49
133650,Florida Agricultural and Mechanical University,1,0,2005,NA,NA,1636,925,711,183,61,122,0.13,0.09,0.11,2148,270,673,19
133650,Florida Agricultural and Mechanical University,1,0,2006,NA,NA,1614,925,689,156,36,120,0.12,0.05,0.1,2211,270,658,27
133650,Florida Agricultural and Mechanical University,1,0,2007,NA,NA,1853,1071,782,217,74,143,0.13,0.09,0.12,2211,267,617,21
133650,Florida Agricultural and Mechanical University,1,0,2008,NA,NA,2090,1196,894,254,79,175,0.14,0.09,0.12,2461,272,637,31
133650,Florida Agricultural and Mechanical University,1,0,2009,NA,NA,2348,1421,927,267,88,179,0.12,0.09,0.11,2658,281,623,23
133650,Florida Agricultural and Mechanical University,1,0,2010,NA,NA,2701,1636,1065,331,94,237,0.14,0.09,0.12,2870,284,614,45
133669,FLORIDA ATLANTIC UNIVERSITY,1,0,1991,NA,NA,651,358,293,93,29,64,0.17,0.1,0.14,1350,112,464,483
133669,FLORIDA ATLANTIC UNIVERSITY,1,0,1992,NA,NA,795,417,378,115,43,72,0.17,0.11,0.14,1733,116,530,607
133669,FLORIDA ATLANTIC UNIVERSITY,1,0,1993,NA,NA,743,412,331,104,34,70,0.16,0.1,0.14,1791,124,528,530
133669,FLORIDA ATLANTIC UNIVERSITY,1,0,1995,NA,NA,901,504,397,162,51,111,0.22,0.13,0.18,1446,136,535,581
133669,FLORIDA ATLANTIC UNIVERSITY,1,0,1996,NA,NA,1001,551,450,155,57,98,0.17,0.13,0.15,1512,163,538,693
133669,FLORIDA ATLANTIC UNIVERSITY-BOCA RATON,1,0,1997,NA,NA,1174,669,505,161,54,107,0.15,0.11,0.14,1618,186,575,777
133669,FLORIDA ATLANTIC UNIVERSITY-BOCA RATON,1,0,1998,NA,NA,1309,773,536,196,56,140,0.18,0.1,0.15,1695,208,618,847
133669,FLORIDA ATLANTIC UNIVERSITY-BOCA RATON,1,0,1999,NA,NA,1423,860,563,201,56,145,0.16,0.1,0.14,2253,237,657,928
133669,FLORIDA ATLANTIC UNIVERSITY-BOCA RATON,1,0,2000,NA,NA,1818,988,830,254,89,165,0.16,0.11,0.14,1554,246,669,1179
133669,FLORIDA ATLANTIC UNIVERSITY-BOCA RATON,1,0,2001,NA,NA,1937,1120,817,292,85,207,0.18,0.1,0.15,1670,270,681,1211
133669,FLORIDA ATLANTIC UNIVERSITY-BOCA RATON,1,0,2002,NA,NA,1994,1102,892,323,115,208,0.18,0.13,0.16,1402,291,689,1229
133669,FLORIDA ATLANTIC UNIVERSITY-BOCA RATON,1,0,2003,NA,NA,2038,1143,895,335,109,226,0.19,0.12,0.16,1522,320,731,1268
133669,FLORIDA ATLANTIC UNIVERSITY-BOCA RATON,1,0,2004,NA,NA,2278,1231,1047,364,122,242,0.19,0.12,0.16,1636,343,740,1397
133669,Florida Atlantic University,1,0,2005,NA,NA,2080,1111,969,363,126,237,0.21,0.13,0.17,1717,399,767,1324
133669,Florida Atlantic University,1,0,2006,NA,NA,2193,1208,985,339,115,224,0.18,0.12,0.15,1769,358,777,1328
133669,Florida Atlantic University,1,0,2007,NA,NA,2563,1326,1237,388,150,238,0.17,0.12,0.15,1769,364,797,1482
133669,Florida Atlantic University,1,0,2008,NA,NA,2677,1407,1270,457,149,308,0.21,0.12,0.17,1968,394,788,1533
133669,Florida Atlantic University,1,0,2009,NA,NA,2447,1314,1133,487,156,331,0.25,0.14,0.2,2126,402,779,1418
133669,Florida Atlantic University,1,0,2010,NA,NA,2616,1359,1257,501,169,332,0.24,0.13,0.19,2296,416,774,1425
133711,FLAGLER COLLEGE,1,0,1991,NA,NA,290,169,121,133,50,83,0.49,0.41,0.46,4550,9,59,273
133711,FLAGLER COLLEGE,1,0,1992,NA,NA,299,169,130,125,43,82,0.48,0.33,0.42,4710,10,74,273
133711,FLAGLER COLLEGE,1,0,1993,NA,NA,338,193,145,147,59,88,0.45,0.41,0.43,4920,9,44,309
133711,FLAGLER COLLEGE,1,0,1995,NA,NA,355,217,138,143,45,98,0.45,0.33,0.4,5375,12,51,334
133711,FLAGLER COLLEGE,1,0,1996,NA,NA,355,217,138,143,45,98,0.45,0.33,0.4,5530,12,52,334
133711,FLAGLER COLLEGE,1,0,1997,NA,NA,424,272,152,176,55,121,0.44,0.36,0.42,5760,14,53,403
133711,FLAGLER COLLEGE,1,0,1998,NA,NA,418,285,133,182,58,124,0.43,0.44,0.44,5950,14,59,391
133711,FLAGLER COLLEGE,1,0,1999,NA,NA,419,267,152,186,61,125,0.46,0.4,0.44,6130,16,60,394
133711,FLAGLER COLLEGE,1,0,2000,NA,NA,496,315,181,206,72,134,0.42,0.4,0.42,6320,18,62,453
133711,FLAGLER COLLEGE,1,0,2001,NA,NA,407,253,154,185,59,126,0.49,0.38,0.45,6550,21,64,377
133711,FLAGLER COLLEGE,1,0,2002,NA,NA,481,308,173,231,70,161,0.52,0.4,0.48,6870,23,73,441
133711,FLAGLER COLLEGE,1,0,2003,NA,NA,556,318,238,220,84,136,0.42,0.35,0.4,7410,25,79,495
133711,FLAGLER COLLEGE,1,0,2004,NA,NA,500,296,204,250,98,152,0.51,0.48,0.5,8000,27,69,454
133711,Flagler College,1,0,2005,NA,NA,459,283,176,216,77,139,0.49,0.44,0.47,8600,26,73,426
133711,Flagler College,1,0,2006,NA,NA,463,284,179,235,77,158,0.55,0.43,0.51,9450,30,76,208
133711,Flagler College,1,0,2007,NA,NA,531,333,198,246,85,161,0.48,0.43,0.46,11810,34,87,290
133711,Flagler College,1,0,2008,NA,NA,645,365,280,312,116,196,0.53,0.41,0.48,12520,41,91,550
133711,Flagler College,1,0,2009,NA,NA,564,337,227,281,94,187,0.55,0.41,0.5,13300,45,94,480
133711,Flagler College-St Augustine,1,0,2010,NA,NA,612,347,265,281,98,183,0.52,0.37,0.46,13860,48,96,490
133881,FLORIDA INSTITUTE OF TECHNOLOGY,0,1,1991,1993,0,350,78,272,98,67,31,0.39,0.25,0.28,10752,49,232,256
133881,FLORIDA INSTITUTE OF TECHNOLOGY,0,1,1992,1993,0,457,121,336,147,99,48,0.39,0.29,0.32,11817,52,224,321
133881,FLORIDA INSTITUTE OF TECHNOLOGY,1,0,1993,1993,1,358,109,249,93,65,28,0.25,0.26,0.26,13035,57,232,247
133881,FLORIDA INSTITUTE OF TECHNOLOGY,1,0,1995,1993,1,370,111,259,113,70,43,0.38,0.27,0.31,14111,60,171,237
133881,FLORIDA INSTITUTE OF TECHNOLOGY,1,0,1996,1993,1,491,149,342,171,101,70,0.46,0.3,0.35,15060,62,177,314
133881,FLORIDA INSTITUTE OF TECHNOLOGY-MELBOURNE,1,0,1997,1993,1,367,112,255,128,84,44,0.39,0.33,0.35,15510,59,168,216
133881,FLORIDA INSTITUTE OF TECHNOLOGY-MELBOURNE,1,0,1998,1993,1,461,145,316,173,108,65,0.44,0.34,0.38,16500,53,170,307
133881,FLORIDA INSTITUTE OF TECHNOLOGY-MELBOURNE,1,0,1999,1993,1,402,116,286,139,95,44,0.37,0.33,0.35,17300,54,171,259
133881,FLORIDA INSTITUTE OF TECHNOLOGY-MELBOURNE,1,0,2000,1993,1,531,156,375,214,145,69,0.44,0.39,0.4,18450,58,179,355
133881,FLORIDA INSTITUTE OF TECHNOLOGY-MELBOURNE,1,0,2001,1993,1,544,153,391,203,128,75,0.49,0.33,0.37,19700,81,188,332
133881,FLORIDA INSTITUTE OF TECHNOLOGY-MELBOURNE,1,0,2002,1993,1,518,139,379,218,142,76,0.54,0.37,0.42,20900,88,202,306
133881,FLORIDA INSTITUTE OF TECHNOLOGY-MELBOURNE,1,0,2003,1993,1,549,174,375,219,136,83,0.47000000000000003,0.36,0.4,22600,93,218,326
133881,FLORIDA INSTITUTE OF TECHNOLOGY-MELBOURNE,1,0,2004,1993,1,551,181,370,218,132,86,0.47000000000000003,0.36,0.4,23730,93,216,337
133881,Florida Institute of Technology-Melbourne,1,0,2005,1993,1,603,154,449,242,172,70,0.45,0.38,0.4,25150,105,210,394
133881,Florida Institute of Technology,1,0,2006,1993,1,597,160,437,222,144,78,0.48,0.33,0.37,27540,90,213,280
133881,Florida Institute of Technology,1,0,2007,1993,1,675,186,489,261,170,91,0.48,0.35,0.39,28920,94,226,305
133881,Florida Institute of Technology,1,0,2008,1993,1,635,194,441,247,152,95,0.48,0.34,0.39,29940,102,232,384
133881,Florida Institute of Technology,1,0,2009,1993,1,538,145,393,222,144,78,0.53,0.37,0.41,31020,115,240,304
133881,Florida Institute of Technology,1,0,2010,1993,1,489,138,351,220,142,78,0.56,0.4,0.45,31734,125,238,298
133951,FLORIDA INTERNATIONAL UNIVERSITY,1,0,1991,NA,NA,1021,600,421,198,62,136,0.22,0.15,0.19,1478,141,782,242
133951,FLORIDA INTERNATIONAL UNIVERSITY,1,0,1992,NA,NA,1124,625,499,197,64,133,0.21,0.13,0.18,1701,146,758,266
133951,FLORIDA INTERNATIONAL UNIVERSITY,1,0,1993,NA,NA,1306,751,555,216,65,151,0.2,0.12,0.17,1757,163,767,223
133951,FLORIDA INTERNATIONAL UNIVERSITY,1,0,1995,NA,NA,1752,1003,749,270,74,196,0.19,0.1,0.15,1791,194,806,324
133951,FLORIDA INTERNATIONAL UNIVERSITY,1,0,1996,NA,NA,1846,1067,779,314,87,227,0.21,0.11,0.17,1875,214,813,298
133951,FLORIDA INTERNATIONAL UNIVERSITY,1,0,1997,NA,NA,1987,1144,843,352,91,261,0.22,0.11,0.18,2035,238,831,371
133951,FLORIDA INTERNATIONAL UNIVERSITY,1,0,1998,NA,NA,2227,1298,929,430,117,313,0.24,0.13,0.19,2154,266,864,423
133951,FLORIDA INTERNATIONAL UNIVERSITY,1,0,1999,NA,NA,2482,1460,1022,525,141,384,0.26,0.14,0.21,2272,290,863,451
133951,FLORIDA INTERNATIONAL UNIVERSITY,1,0,2000,NA,NA,2582,1511,1071,507,148,359,0.23,0.14,0.2,1554,311,827,523
133951,FLORIDA INTERNATIONAL UNIVERSITY,1,0,2001,NA,NA,2457,1364,1093,527,145,382,0.28,0.13,0.21,1670,354,792,490
133951,FLORIDA INTERNATIONAL UNIVERSITY,1,0,2002,NA,NA,2801,1617,1184,566,176,390,0.24,0.15,0.2,1754,385,714,535
133951,FLORIDA INTERNATIONAL UNIVERSITY,1,0,2003,NA,NA,3038,1756,1282,597,185,412,0.23,0.14,0.2,1902,411,745,570
133951,FLORIDA INTERNATIONAL UNIVERSITY,1,0,2004,NA,NA,3370,1906,1464,647,198,449,0.23,0.14,0.19,2045,443,769,551
133951,Florida International University,1,0,2005,NA,NA,3967,2261,1706,634,188,446,0.19,0.11,0.16,2147,465,757,641
133951,Florida International University,1,0,2006,NA,NA,3889,2099,1790,736,243,493,0.23,0.14,0.19,2211,506,759,626
133951,Florida International University,1,0,2007,NA,NA,3230,1707,1523,661,209,452,0.26,0.14,0.2,2211,532,852,512
133951,Florida International University,1,0,2008,NA,NA,3106,1642,1464,732,234,498,0.3,0.16,0.24,2565,571,854,459
133951,Florida International University,1,0,2009,NA,NA,2946,1615,1331,828,278,550,0.34,0.21,0.28,2864,599,871,403
133951,Florida International University,1,0,2010,NA,NA,3752,2079,1673,931,280,651,0.31,0.17,0.25,3200,631,857,424
134079,FLORIDA SOUTHERN COLLEGE,1,0,1991,NA,NA,378,210,168,147,53,94,0.44,0.32,0.39,6080,24,99,346
134079,FLORIDA SOUTHERN COLLEGE,1,0,1992,NA,NA,343,200,143,147,45,102,0.51,0.31,0.43,7080,25,96,311
134079,FLORIDA SOUTHERN COLLEGE,1,0,1993,NA,NA,375,207,168,138,58,80,0.38,0.35,0.37,7660,25,96,330
134079,FLORIDA SOUTHERN COLLEGE,1,0,1995,NA,NA,527,302,225,230,76,154,0.5,0.34,0.44,8630,28,90,438
134079,FLORIDA SOUTHERN COLLEGE,1,0,1996,NA,NA,458,287,171,224,67,157,0.54,0.39,0.49,9970,32,92,384
134079,FLORIDA SOUTHERN COLLEGE,1,0,1997,NA,NA,428,270,158,196,67,129,0.47000000000000003,0.42,0.46,10604,29,94,364
134079,FLORIDA SOUTHERN COLLEGE,1,0,1998,NA,NA,440,286,154,199,55,144,0.5,0.36,0.45,11274,30,98,380
134079,FLORIDA SOUTHERN COLLEGE,1,0,1999,NA,NA,425,267,158,173,55,118,0.44,0.35,0.41,11650,32,101,383
134079,FLORIDA SOUTHERN COLLEGE,1,0,2000,NA,NA,506,306,200,209,62,147,0.48,0.31,0.41,12750,36,104,419
134079,FLORIDA SOUTHERN COLLEGE,1,0,2001,NA,NA,515,323,192,205,66,139,0.43,0.34,0.4,13700,38,107,434
134079,FLORIDA SOUTHERN COLLEGE,1,0,2002,NA,NA,491,322,169,184,41,143,0.44,0.24,0.37,15778,39,107,414
134079,FLORIDA SOUTHERN COLLEGE,1,0,2003,NA,NA,436,250,186,163,51,112,0.44,0.27,0.37,17192,40,109,354
134079,FLORIDA SOUTHERN COLLEGE,1,0,2004,NA,NA,553,342,211,227,70,157,0.45,0.33,0.41,17860,41,114,468
134079,Florida Southern College,1,0,2005,NA,NA,462,274,188,190,60,130,0.47000000000000003,0.32,0.41,18765,44,112,386
134079,Florida Southern College,1,0,2006,NA,NA,420,267,153,198,59,139,0.52,0.39,0.47,19700,43,110,342
134079,Florida Southern College,1,0,2007,NA,NA,423,259,164,199,77,122,0.47000000000000003,0.47,0.47,20690,46,106,333
134079,Florida Southern College,1,0,2008,NA,NA,497,304,193,277,102,175,0.5700000000000001,0.53,0.56,21620,46,107,414
134079,Florida Southern College,1,0,2009,NA,NA,557,319,238,257,91,166,0.52,0.38,0.46,22270,51,100,430
134079,Florida Southern College,1,0,2010,NA,NA,602,357,245,314,119,195,0.54,0.49,0.52,23578,52,102,452
134097,FLORIDA STATE UNIVERSITY,1,0,1991,NA,NA,2899,1702,1197,1131,410,721,0.42,0.34,0.39,1492,322,1065,2346
134097,FLORIDA STATE UNIVERSITY,1,0,1992,NA,NA,3313,1949,1364,1259,378,881,0.45,0.28,0.38,1679,327,1047,2730
134097,FLORIDA STATE UNIVERSITY,1,0,1993,NA,NA,3603,2132,1471,1424,480,944,0.44,0.33,0.4,1780,345,1038,2914
134097,FLORIDA STATE UNIVERSITY,1,0,1995,NA,NA,3826,2210,1616,1534,530,1004,0.45,0.33,0.4,1798,398,1011,2983
134097,FLORIDA STATE UNIVERSITY,1,0,1996,NA,NA,3999,2329,1670,1583,536,1047,0.44,0.32,0.4,1882,411,982,3023
134097,FLORIDA STATE UNIVERSITY,1,0,1997,NA,NA,4491,2525,1966,1822,606,1216,0.48,0.31,0.41,1988,429,971,3408
134097,FLORIDA STATE UNIVERSITY,1,0,1998,NA,NA,5066,2932,2134,2143,705,1438,0.49,0.33,0.42,2084,446,981,3862
134097,FLORIDA STATE UNIVERSITY,1,0,1999,NA,NA,5078,2934,2144,2244,793,1451,0.49,0.37,0.44,2195,493,1007,3892
134097,FLORIDA STATE UNIVERSITY,1,0,2000,NA,NA,5557,3294,2263,2481,811,1670,0.5,0.36,0.45,1554,520,1045,4188
134097,FLORIDA STATE UNIVERSITY,1,0,2001,NA,NA,5681,3318,2363,2702,928,1774,0.53,0.39,0.48,1670,586,1084,4014
134097,FLORIDA STATE UNIVERSITY,1,0,2002,NA,NA,6258,3742,2516,2927,959,1968,0.52,0.38,0.47,1754,571,1124,4531
134097,FLORIDA STATE UNIVERSITY,1,0,2003,NA,NA,6059,3522,2537,2847,987,1860,0.52,0.39,0.47,1902,620,1116,4543
134097,FLORIDA STATE UNIVERSITY,1,0,2004,NA,NA,6198,3727,2471,3112,1029,2083,0.55,0.42,0.5,2045,682,1124,4545
134097,Florida State University,1,0,2005,NA,NA,6052,3554,2498,2995,1066,1929,0.54,0.43,0.49,2147,742,1283,4419
134097,Florida State University,1,0,2006,NA,NA,6191,3597,2594,3310,1201,2109,0.58,0.46,0.53,2211,780,1330,4564
134097,Florida State University,1,0,2007,NA,NA,6104,3436,2668,3458,1266,2192,0.63,0.47,0.57,2211,848,1367,4426
134097,Florida State University,1,0,2008,NA,NA,4993,2928,2065,3066,1093,1973,0.67,0.53,0.61,2461,882,1314,3523
134097,Florida State University,1,0,2009,NA,NA,5925,3476,2449,3650,1245,2405,0.6900000000000001,0.51,0.62,2658,908,1312,4079
134097,Florida State University,1,0,2010,NA,NA,5957,3515,2442,3620,1249,2371,0.67,0.51,0.61,2870,911,1257,4073
134130,UNIVERSITY OF FLORIDA,1,0,1991,NA,NA,4364,2116,2248,1284,490,794,0.37,0.22,0.29,1420,777,3083,3388
134130,UNIVERSITY OF FLORIDA,1,0,1992,NA,NA,4471,2097,2374,1377,568,809,0.38,0.24,0.31,1650,790,2271,3308
134130,UNIVERSITY OF FLORIDA,1,0,1993,NA,NA,5074,2520,2554,1728,701,1027,0.4,0.27,0.34,1770,822,2261,3823
134130,UNIVERSITY OF FLORIDA,1,0,1995,NA,NA,5655,3023,2632,2443,903,1540,0.5,0.34,0.43,1705,889,2225,4121
134130,UNIVERSITY OF FLORIDA,1,0,1996,NA,NA,5171,2899,2272,2599,929,1670,0.5700000000000001,0.41,0.5,1793,934,2229,3823
134130,UNIVERSITY OF FLORIDA,1,0,1997,NA,NA,5959,3307,2652,2950,1073,1877,0.56,0.4,0.5,1926,974,1575,4397
134130,UNIVERSITY OF FLORIDA,1,0,1998,NA,NA,5629,3171,2458,2886,1037,1849,0.58,0.42,0.51,2052,1030,1447,4123
134130,UNIVERSITY OF FLORIDA,1,0,1999,NA,NA,6065,3388,2677,3191,1111,2080,0.61,0.42,0.53,2141,1102,1536,4292
134130,UNIVERSITY OF FLORIDA,1,0,2000,NA,NA,6864,3874,2990,3692,1285,2407,0.62,0.43,0.54,1554,1164,1568,4553
134130,UNIVERSITY OF FLORIDA,1,0,2001,NA,NA,6178,3348,2830,3304,1208,2096,0.62,0.43,0.53,1670,1252,1601,4518
134130,UNIVERSITY OF FLORIDA,1,0,2002,NA,NA,6406,3674,2732,3586,1215,2371,0.64,0.44,0.56,1754,1280,1686,4405
134130,UNIVERSITY OF FLORIDA,1,0,2003,NA,NA,6499,3790,2709,3779,1253,2526,0.66,0.46,0.58,1902,1390,1679,4452
134130,UNIVERSITY OF FLORIDA,1,0,2004,NA,NA,6621,3706,2915,3933,1418,2515,0.67,0.49,0.59,2045,1479,1622,4481
134130,University of Florida,1,0,2005,NA,NA,7217,4080,3137,4230,1533,2697,0.66,0.49,0.59,2147,1655,1663,4673
134130,University of Florida,1,0,2006,NA,NA,6674,3783,2891,4294,1572,2722,0.71,0.54,0.64,2211,1745,2007,3961
134130,University of Florida,1,0,2007,NA,NA,6440,3792,2648,4197,1467,2730,0.71,0.55,0.65,2211,1826,2009,3758
134130,University of Florida,1,0,2008,NA,NA,6382,3787,2595,4289,1442,2847,0.75,0.56,0.67,2670,1860,2314,3837
134130,University of Florida,1,0,2009,NA,NA,6253,3728,2525,4149,1367,2782,0.74,0.54,0.66,3070,2157,2249,3575
134130,University of Florida,1,0,2010,NA,NA,6345,3661,2684,4275,1469,2806,0.76,0.55,0.67,3530,2226,2180,3693
134945,JACKSONVILLE UNIVERSITY,1,0,1991,NA,NA,388,147,241,102,56,46,0.31,0.23,0.26,8450,25,105,307
134945,JACKSONVILLE UNIVERSITY,1,0,1992,NA,NA,304,128,176,81,33,48,0.37,0.19,0.27,9320,27,111,227
134945,JACKSONVILLE UNIVERSITY,1,0,1993,NA,NA,310,139,171,92,47,45,0.32,0.27,0.3,10080,28,107,249
134945,JACKSONVILLE UNIVERSITY,1,0,1995,NA,NA,356,197,159,129,51,78,0.39,0.32,0.36,10580,31,109,267
134945,JACKSONVILLE UNIVERSITY,1,0,1996,NA,NA,365,197,168,113,44,69,0.35000000000000003,0.26,0.31,12510,33,114,273
134945,JACKSONVILLE UNIVERSITY,1,0,1997,NA,NA,290,125,165,65,19,46,0.36,0.12,0.22,13900,36,118,197
134945,JACKSONVILLE UNIVERSITY,1,0,1998,NA,NA,307,112,195,75,40,35,0.31,0.21,0.24,14420,34,119,192
134945,JACKSONVILLE UNIVERSITY,1,0,1999,NA,NA,309,122,187,98,49,49,0.4,0.26,0.32,14390,36,110,180
134945,JACKSONVILLE UNIVERSITY,1,0,2000,NA,NA,406,163,243,155,80,75,0.46,0.33,0.38,15270,36,111,277
134945,JACKSONVILLE UNIVERSITY,1,0,2001,NA,NA,428,186,242,219,140,79,0.42,0.58,0.51,15990,35,112,289
134945,JACKSONVILLE UNIVERSITY,1,0,2002,NA,NA,389,165,224,105,52,53,0.32,0.23,0.27,16540,39,121,274
134945,JACKSONVILLE UNIVERSITY,1,0,2003,NA,NA,430,192,238,137,57,80,0.41000000000000003,0.24,0.32,17700,43,125,299
134945,JACKSONVILLE UNIVERSITY,1,0,2004,NA,NA,462,197,265,118,59,59,0.29,0.22,0.26,18590,44,121,283
134945,Jacksonville University,1,0,2005,NA,NA,544,252,292,127,59,68,0.26,0.2,0.23,19970,46,130,272
134945,Jacksonville University,1,0,2006,NA,NA,493,213,280,134,62,72,0.33,0.22,0.27,21200,44,138,275
134945,Jacksonville University,1,0,2007,NA,NA,581,274,307,141,60,81,0.29,0.2,0.24,22500,47,137,326
134945,Jacksonville University,1,0,2008,NA,NA,539,249,290,151,67,84,0.33,0.23,0.28,23900,66,160,321
134945,Jacksonville University,1,0,2009,NA,NA,665,337,328,187,78,109,0.32,0.24,0.28,25300,72,161,445
134945,Jacksonville University,1,0,2010,NA,NA,624,313,311,197,87,110,0.35000000000000003,0.28,0.32,26600,64,172,324
135726,UNIVERSITY OF MIAMI,1,0,1991,NA,NA,1832,826,1006,775,383,392,0.47000000000000003,0.38,0.42,14080,612,748,1074
135726,UNIVERSITY OF MIAMI,1,0,1992,NA,NA,1770,841,929,798,395,403,0.47000000000000003,0.43,0.45,15050,673,752,1007
135726,UNIVERSITY OF MIAMI,1,0,1993,NA,NA,1612,791,821,741,338,403,0.5,0.41,0.46,15880,729,769,836
135726,UNIVERSITY OF MIAMI,1,0,1995,NA,NA,1684,913,771,832,348,484,0.53,0.45,0.49,17699,799,748,871
135726,UNIVERSITY OF MIAMI,1,0,1996,NA,NA,1678,893,785,887,381,506,0.56,0.49,0.53,18582,849,770,798
135726,UNIVERSITY OF MIAMI,1,0,1997,NA,NA,1814,960,854,962,421,541,0.56,0.49,0.53,19512,790,735,921
135726,UNIVERSITY OF MIAMI,1,0,1998,NA,NA,1831,980,851,975,389,586,0.59,0.46,0.53,20424,800,731,940
135726,UNIVERSITY OF MIAMI,1,0,1999,NA,NA,1845,998,847,1031,439,592,0.59,0.52,0.56,20960,829,752,982
135726,UNIVERSITY OF MIAMI,1,0,2000,NA,NA,1964,1081,883,1140,469,671,0.62,0.53,0.58,22124,873,809,1091
135726,UNIVERSITY OF MIAMI,1,0,2001,NA,NA,2152,1277,875,1349,503,846,0.66,0.57,0.63,23228,951,867,1215
135726,UNIVERSITY OF MIAMI,1,0,2002,NA,NA,2046,1197,849,1311,497,814,0.68,0.59,0.64,24378,1048,865,1177
135726,UNIVERSITY OF MIAMI,1,0,2003,NA,NA,2066,1142,924,1374,582,792,0.6900000000000001,0.63,0.67,25838,1148,897,1192
135726,UNIVERSITY OF MIAMI,1,0,2004,NA,NA,2025,1157,868,1381,551,830,0.71,0.63,0.68,27384,1259,910,1163
135726,University of Miami,1,0,2005,NA,NA,2258,1168,1090,1480,670,810,0.6900000000000001,0.61,0.66,29020,1289,908,1249
135726,University of Miami,1,0,2006,NA,NA,2046,1055,991,1421,644,777,0.73,0.65,0.69,30732,1360,955,1087
135726,University of Miami,1,0,2007,NA,NA,1977,1049,928,1400,606,794,0.75,0.65,0.71,32422,1552,970,968
135726,University of Miami,1,0,2008,NA,NA,1983,987,996,1358,647,711,0.72,0.65,0.68,34206,1846,1003,932
135726,University of Miami,1,0,2009,NA,NA,1903,924,979,1297,599,698,0.75,0.61,0.68,35540,2141,998,948
135726,University of Miami,1,0,2010,NA,NA,2105,1072,1033,1465,646,819,0.76,0.63,0.7,36962,2203,1018,1104
136172,UNIVERSITY OF NORTH FLORIDA,1,0,1991,NA,NA,406,240,166,71,24,47,0.19,0.14,0.17,1413,48,243,315
136172,UNIVERSITY OF NORTH FLORIDA,1,0,1992,NA,NA,487,277,210,68,27,41,0.14,0.13,0.14,1534,48,225,366
136172,UNIVERSITY OF NORTH FLORIDA,1,0,1993,NA,NA,545,289,256,94,25,69,0.23,0.1,0.17,1732,53,230,432
136172,UNIVERSITY OF NORTH FLORIDA,1,0,1995,NA,NA,762,463,299,145,26,119,0.25,0.09,0.19,1747,63,334,592
136172,UNIVERSITY OF NORTH FLORIDA,1,0,1996,NA,NA,987,583,404,213,62,151,0.25,0.15,0.22,1884,69,278,766
136172,UNIVERSITY OF NORTH FLORIDA,1,0,1997,NA,NA,1105,646,459,269,77,192,0.29,0.17,0.24,2006,75,294,861
136172,UNIVERSITY OF NORTH FLORIDA,1,0,1998,NA,NA,1371,842,529,353,105,248,0.29,0.2,0.26,2157,85,342,1127
136172,UNIVERSITY OF NORTH FLORIDA,1,0,1999,NA,NA,1501,886,615,375,97,278,0.31,0.16,0.25,2274,99,359,1228
136172,UNIVERSITY OF NORTH FLORIDA,1,0,2000,NA,NA,1664,963,701,335,100,235,0.24,0.14,0.2,1554,105,360,1321
136172,UNIVERSITY OF NORTH FLORIDA,1,0,2001,NA,NA,1672,979,693,392,126,266,0.27,0.18,0.23,1670,119,362,1303
136172,UNIVERSITY OF NORTH FLORIDA,1,0,2002,NA,NA,1865,1067,798,395,129,266,0.24,0.16,0.21,1754,128,375,1508
136172,UNIVERSITY OF NORTH FLORIDA,1,0,2003,NA,NA,1919,1115,804,444,120,324,0.29,0.15,0.23,1902,132,409,1566
136172,UNIVERSITY OF NORTH FLORIDA,1,0,2004,NA,NA,2199,1252,947,447,116,331,0.26,0.12,0.2,2045,137,427,1714
136172,University of North Florida,1,0,2005,NA,NA,2288,1296,992,518,179,339,0.26,0.18,0.23,2147,148,449,1742
136172,University of North Florida,1,0,2006,NA,NA,2304,1301,1003,462,131,331,0.25,0.13,0.2,2211,162,482,1756
136172,University of North Florida,1,0,2007,NA,NA,2048,1185,863,435,151,284,0.23,0.17,0.21,2211,181,512,1539
136172,University of North Florida,1,0,2008,NA,NA,1694,1013,681,444,115,329,0.32,0.17,0.26,2461,192,481,1273
136172,University of North Florida,1,0,2009,NA,NA,2025,1129,896,536,155,381,0.33,0.17,0.26,2547,205,487,1506
136172,University of North Florida,1,0,2010,NA,NA,1926,1078,848,504,137,367,0.34,0.16,0.26,2930,215,491,1480
136950,ROLLINS COLLEGE,1,0,1991,NA,NA,401,227,174,233,92,141,0.62,0.53,0.58,13900,38,149,328
136950,ROLLINS COLLEGE,1,0,1992,NA,NA,394,215,179,194,71,123,0.5700000000000001,0.4,0.49,14974,41,156,327
136950,ROLLINS COLLEGE,1,0,1993,NA,NA,377,210,167,195,82,113,0.53,0.49,0.52,15950,47,154,315
136950,ROLLINS COLLEGE,1,0,1995,NA,NA,412,248,164,250,88,162,0.65,0.54,0.61,17995,48,146,331
136950,ROLLINS COLLEGE,1,0,1996,NA,NA,418,240,178,194,69,125,0.52,0.39,0.46,19075,52,147,292
136950,ROLLINS COLLEGE,1,0,1997,NA,NA,415,253,162,192,65,127,0.5,0.4,0.46,20010,45,149,287
136950,ROLLINS COLLEGE,1,0,1998,NA,NA,458,278,180,232,80,152,0.54,0.44,0.51,20915,47,148,364
136950,ROLLINS COLLEGE,1,0,1999,NA,NA,448,267,181,220,87,133,0.49,0.48,0.49,21250,50,143,338
136950,ROLLINS COLLEGE,1,0,2000,NA,NA,425,256,169,252,87,165,0.64,0.51,0.59,22206,57,147,300
136950,ROLLINS COLLEGE,1,0,2001,NA,NA,473,300,173,278,90,188,0.62,0.52,0.59,23205,61,152,360
136950,ROLLINS COLLEGE,1,0,2002,NA,NA,466,280,186,278,97,181,0.64,0.52,0.6,24250,63,177,369
136950,ROLLINS COLLEGE,1,0,2003,NA,NA,496,298,198,291,102,189,0.63,0.52,0.59,25500,67,179,368
136950,ROLLINS COLLEGE,1,0,2004,NA,NA,486,284,202,285,116,169,0.59,0.57,0.59,26910,71,179,341
136950,Rollins College,1,0,2005,NA,NA,463,275,188,284,105,179,0.65,0.56,0.61,28390,75,185,346
136950,Rollins College,1,0,2006,NA,NA,501,287,214,312,119,193,0.67,0.56,0.62,30420,79,188,367
136950,Rollins College,1,0,2007,NA,NA,525,305,220,319,124,195,0.63,0.56,0.61,32640,84,193,407
136950,Rollins College,1,0,2008,NA,NA,464,262,202,293,118,175,0.66,0.58,0.63,34520,92,194,332
136950,Rollins College,1,0,2009,NA,NA,464,287,177,299,103,196,0.68,0.58,0.64,36220,97,196,328
136950,Rollins College,1,0,2010,NA,NA,465,286,179,298,100,198,0.6900000000000001,0.56,0.64,37640,99,200,308
137546,STETSON UNIVERSITY,1,0,1991,NA,NA,460,256,204,237,89,148,0.5700000000000001,0.44,0.52,10020,44,174,410
137546,STETSON UNIVERSITY,1,0,1992,NA,NA,501,282,219,232,87,145,0.51,0.4,0.46,11110,47,176,419
137546,STETSON UNIVERSITY,1,0,1993,NA,NA,481,292,189,238,87,151,0.51,0.46,0.49,11995,61,185,403
137546,STETSON UNIVERSITY,1,0,1995,NA,NA,464,253,211,228,89,139,0.54,0.42,0.49,13700,61,183,397
137546,STETSON UNIVERSITY,1,0,1996,NA,NA,416,229,187,211,83,128,0.55,0.44,0.51,14735,61,193,351
137546,STETSON UNIVERSITY,1,0,1997,NA,NA,504,289,215,283,104,179,0.61,0.48,0.56,15765,51,192,442
137546,STETSON UNIVERSITY,1,0,1998,NA,NA,539,311,228,279,113,166,0.53,0.5,0.52,16650,55,203,461
137546,STETSON UNIVERSITY,1,0,1999,NA,NA,548,325,223,312,119,193,0.59,0.53,0.57,16640,60,220,461
137546,STETSON UNIVERSITY,1,0,2000,NA,NA,502,262,240,265,108,157,0.59,0.45,0.53,17475,67,227,424
137546,STETSON UNIVERSITY,1,0,2001,NA,NA,527,298,229,289,117,172,0.5700000000000001,0.51,0.55,18350,74,235,421
137546,STETSON UNIVERSITY,1,0,2002,NA,NA,542,325,217,299,104,195,0.6,0.48,0.55,19450,79,239,448
137546,STETSON UNIVERSITY,1,0,2003,NA,NA,523,284,239,260,109,151,0.53,0.46,0.5,20425,79,236,456
137546,STETSON UNIVERSITY,1,0,2004,NA,NA,598,354,244,303,100,203,0.5700000000000001,0.41,0.51,22350,83,231,474
137546,Stetson University,1,0,2005,NA,NA,547,312,235,308,135,173,0.55,0.57,0.56,23750,89,243,396
137546,Stetson University,1,0,2006,NA,NA,565,338,227,317,113,204,0.6,0.5,0.56,25350,94,237,402
137546,Stetson University,1,0,2007,NA,NA,557,322,235,314,121,193,0.59,0.51,0.56,27100,97,235,430
137546,Stetson University,1,0,2008,NA,NA,617,360,257,344,133,211,0.58,0.52,0.56,28456,101,231,440
137546,Stetson University,1,0,2009,NA,NA,502,273,229,287,124,163,0.59,0.54,0.57,29880,107,229,350
137546,Stetson University,1,0,2010,NA,NA,545,331,214,305,109,196,0.59,0.51,0.56,31374,109,227,375
138354,THE UNIVERSITY OF WEST FLORIDA,1,0,1991,NA,NA,380,215,165,40,16,24,0.11,0.1,0.11,1463,61,241,315
138354,THE UNIVERSITY OF WEST FLORIDA,1,0,1992,NA,NA,396,208,188,70,28,42,0.2,0.15,0.18,1654,64,230,335
138354,THE UNIVERSITY OF WEST FLORIDA,1,0,1993,NA,NA,438,252,186,68,17,51,0.2,0.09,0.16,1702,66,221,347
138354,THE UNIVERSITY OF WEST FLORIDA,1,0,1995,NA,NA,509,279,230,101,30,71,0.25,0.13,0.2,1723,75,212,393
138354,THE UNIVERSITY OF WEST FLORIDA,1,0,1996,NA,NA,459,261,198,107,39,68,0.26,0.2,0.23,1819,77,210,369
138354,THE UNIVERSITY OF WEST FLORIDA,1,0,1997,NA,NA,620,372,248,101,28,73,0.19,0.11,0.16,1985,77,206,500
138354,THE UNIVERSITY OF WEST FLORIDA,1,0,1998,NA,NA,647,365,282,136,40,96,0.26,0.14,0.21,2143,83,210,515
138354,THE UNIVERSITY OF WEST FLORIDA,1,0,1999,NA,NA,637,335,302,132,54,78,0.23,0.18,0.21,2293,89,225,515
138354,THE UNIVERSITY OF WEST FLORIDA,1,0,2000,NA,NA,629,355,274,117,30,87,0.24,0.11,0.19,1554,97,236,513
138354,THE UNIVERSITY OF WEST FLORIDA,1,0,2001,NA,NA,695,406,289,167,59,108,0.26,0.2,0.24,1670,105,248,543
138354,THE UNIVERSITY OF WEST FLORIDA,1,0,2002,NA,NA,760,443,317,172,52,120,0.27,0.16,0.23,1754,110,245,614
138354,THE UNIVERSITY OF WEST FLORIDA,1,0,2003,NA,NA,816,469,347,169,48,121,0.25,0.14,0.21,1902,122,247,652
138354,THE UNIVERSITY OF WEST FLORIDA,1,0,2004,NA,NA,859,475,384,168,57,111,0.23,0.15,0.2,2045,131,257,690
138354,The University of West Florida,1,0,2005,NA,NA,830,490,340,194,65,129,0.26,0.19,0.23,2147,135,332,676
138354,The University of West Florida,1,0,2006,NA,NA,861,495,366,209,65,144,0.29,0.18,0.24,2211,145,343,648
138354,The University of West Florida,1,0,2007,NA,NA,912,511,401,184,57,127,0.24,0.14,0.2,2211,144,332,699
138354,The University of West Florida,1,0,2008,NA,NA,1030,605,425,277,94,183,0.3,0.22,0.27,2460,146,324,764
138354,The University of West Florida,1,0,2009,NA,NA,1154,643,511,313,91,222,0.34,0.18,0.27,2743,143,312,852
138354,The University of West Florida,1,0,2010,NA,NA,1211,661,550,325,118,207,0.31,0.21,0.27,3062,159,303,878
138716,ALBANY STATE COLLEGE,0,1,1991,1998,0,541,292,249,39,7,32,0.1,0.03,0.07,1794,22,138,8
138716,ALBANY STATE COLLEGE,0,1,1992,1998,0,645,364,281,50,14,36,0.09,0.05,0.08,1731,23,142,11
138716,ALBANY STATE COLLEGE,0,1,1993,1998,0,649,367,282,47,8,39,0.1,0.03,0.07,1771,27,138,7
138716,ALBANY STATE COLLEGE,0,1,1995,1998,0,530,291,239,37,10,27,0.09,0.04,0.07,2034,36,136,7
138716,ALBANY STATE UNIVERSITY,0,1,1996,1998,0,503,281,222,34,10,24,0.08,0.05,0.07,2139,34,147,4
138716,ALBANY STATE UNIVERSITY,0,1,1997,1998,0,575,359,216,35,9,26,0.07,0.04,0.06,2244,36,149,4
138716,ALBANY STATE UNIVERSITY,1,0,1998,1998,1,493,313,180,30,10,20,0.06,0.06,0.06,2176,40,127,4
138716,ALBANY STATE UNIVERSITY,1,0,1999,1998,1,648,424,224,92,23,69,0.16,0.1,0.14,1808,46,138,9
138716,ALBANY STATE UNIVERSITY,1,0,2000,1998,1,643,431,212,79,14,65,0.15,0.07,0.12,1876,44,142,1
138716,ALBANY STATE UNIVERSITY,1,0,2001,1998,1,420,266,154,79,17,62,0.23,0.11,0.19,1932,50,146,9
138716,ALBANY STATE UNIVERSITY,1,0,2002,1998,1,470,300,170,88,22,66,0.22,0.13,0.19,2010,52,164,9
138716,ALBANY STATE UNIVERSITY,1,0,2003,1998,1,537,322,215,78,21,57,0.17,0.1,0.15,2212,65,148,9
138716,ALBANY STATE UNIVERSITY,1,0,2004,1998,1,602,399,203,98,22,76,0.19,0.11,0.16,2322,54,142,4
138716,Albany State University,1,0,2005,1998,1,596,388,208,93,16,77,0.19,0.08,0.16,2438,60,145,3
138716,Albany State University,1,0,2006,1998,1,702,467,235,74,14,60,0.12,0.06,0.11,2548,54,142,5
138716,Albany State University,1,0,2007,1998,1,626,401,225,100,17,83,0.2,0.08,0.16,2706,57,148,9
138716,Albany State University,1,0,2008,1998,1,626,392,234,65,9,56,0.14,0.04,0.1,2838,65,142,7
138716,Albany State University,1,0,2009,1998,1,745,468,277,66,15,51,0.1,0.05,0.09,3100,64,141,6
138716,Albany State University,1,0,2010,1998,1,883,542,341,47,13,34,0.06,0.04,0.05,3132,66,145,6
138789,ARMSTRONG STATE COLLEGE,0,1,1991,1998,0,567,340,227,50,14,36,0.1,0.06,0.09,1467,20,161,450
138789,ARMSTRONG STATE COLLEGE,0,1,1992,1998,0,496,292,204,25,10,15,0.05,0.05,0.05,1521,21,187,381
138789,ARMSTRONG STATE COLLEGE,0,1,1993,1998,0,577,353,224,39,7,32,0.09,0.03,0.07,1568,26,202,448
138789,ARMSTRONG STATE COLLEGE,0,1,1995,1998,0,773,497,276,50,13,37,0.07,0.05,0.06,1719,33,210,582
138789,ARMSTRONG ATLANTIC STATE UNIVERSITY,0,1,1996,1998,0,805,519,286,60,14,46,0.08,0.05,0.07,1836,37,209,575
138789,ARMSTRONG ATLANTIC STATE UNIVERSITY,0,1,1997,1998,0,690,470,220,50,7,43,0.09,0.03,0.07,1962,39,211,517
138789,ARMSTRONG ATLANTIC STATE UNIVERSITY,1,0,1998,1998,1,550,378,172,26,8,18,0.04,0.05,0.05,2020,42,212,389
138789,ARMSTRONG ATLANTIC STATE UNIVERSITY,1,0,1999,1998,1,602,386,216,35,10,25,0.06,0.05,0.06,1808,48,213,449
138789,ARMSTRONG ATLANTIC STATE UNIVERSITY,1,0,2000,1998,1,568,327,241,27,9,18,0.05,0.04,0.05,1876,51,210,440
138789,ARMSTRONG ATLANTIC STATE UNIVERSITY,1,0,2001,1998,1,551,328,223,39,7,32,0.09,0.03,0.07,1932,52,208,424
138789,ARMSTRONG ATLANTIC STATE UNIVERSITY,1,0,2002,1998,1,581,350,231,48,13,35,0.1,0.06,0.08,2010,50,241,422
138789,ARMSTRONG ATLANTIC STATE UNIVERSITY,1,0,2003,1998,1,719,433,286,47,8,39,0.09,0.03,0.07,2212,58,217,556
138789,ARMSTRONG ATLANTIC STATE UNIVERSITY,1,0,2004,1998,1,776,449,327,70,21,49,0.1,0.06,0.09,2212,54,223,577
138789,Armstrong Atlantic State University,1,0,2005,1998,1,700,453,247,70,14,56,0.12,0.06,0.1,2438,58,234,465
138789,Armstrong Atlantic State University,1,0,2006,1998,1,757,472,285,63,14,49,0.1,0.05,0.08,2548,67,240,490
138789,Armstrong Atlantic State University,1,0,2007,1998,1,793,477,316,77,16,61,0.12,0.05,0.1,2706,74,245,501
138789,Armstrong Atlantic State University,1,0,2008,1998,1,864,511,353,87,23,64,0.12,0.07,0.1,2838,75,237,543
138789,Armstrong Atlantic State University,1,0,2009,1998,1,1063,611,452,110,20,90,0.14,0.04,0.1,3120,80,239,699
138789,Armstrong Atlantic State University,1,0,2010,1998,1,1161,685,476,141,41,100,0.14,0.09,0.12,3432,82,254,678
139144,BERRY COLLEGE,1,0,1991,NA,NA,429,253,176,220,85,135,0.53,0.48,0.51,6990,29,95,409
139144,BERRY COLLEGE,1,0,1992,NA,NA,425,286,139,191,64,127,0.44,0.46,0.45,7500,29,95,402
139144,BERRY COLLEGE,1,0,1993,NA,NA,484,306,178,183,57,126,0.41000000000000003,0.32,0.38,8050,31,92,453
139144,BERRY COLLEGE,1,0,1995,NA,NA,522,316,206,184,68,116,0.36,0.33,0.35,9216,35,97,479
139144,BERRY COLLEGE,1,0,1996,NA,NA,539,339,200,252,79,173,0.51,0.4,0.47,9678,38,103,510
139144,BERRY COLLEGE,1,0,1997,NA,NA,504,332,172,295,99,196,0.59,0.58,0.59,10210,41,111,472
139144,BERRY COLLEGE,1,0,1998,NA,NA,525,336,189,297,106,191,0.56,0.56,0.57,10900,44,124,492
139144,BERRY COLLEGE,1,0,1999,NA,NA,401,243,158,197,69,128,0.52,0.44,0.49,11550,47,136,385
139144,BERRY COLLEGE,1,0,2000,NA,NA,486,321,165,258,84,174,0.54,0.51,0.53,12500,51,142,457
139144,BERRY COLLEGE,1,0,2001,NA,NA,536,357,179,262,74,188,0.52,0.41,0.49,13450,54,148,497
139144,BERRY COLLEGE,1,0,2002,NA,NA,565,353,212,276,94,182,0.51,0.44,0.49,14260,60,149,516
139144,BERRY COLLEGE,1,0,2003,NA,NA,504,321,183,240,76,164,0.51,0.42,0.48,15220,65,148,455
139144,BERRY COLLEGE,1,0,2004,NA,NA,514,349,165,261,76,185,0.53,0.46,0.51,16240,65,146,462
139144,Berry College,1,0,2005,NA,NA,513,316,197,226,65,161,0.5,0.33,0.44,17570,68,137,456
139144,Berry College,1,0,2006,NA,NA,427,302,125,221,56,165,0.54,0.45,0.52,18950,57,139,385
139144,Berry College,1,0,2007,NA,NA,537,373,164,269,75,194,0.52,0.46,0.5,20570,58,143,469
139144,Berry College,1,0,2008,NA,NA,448,311,137,243,70,173,0.55,0.51,0.54,22170,61,141,371
139144,Berry College,1,0,2009,NA,NA,569,402,167,315,85,230,0.5700000000000001,0.51,0.55,23160,68,144,455
139144,Berry College,1,0,2010,NA,NA,653,431,222,386,126,260,0.6,0.57,0.59,24420,73,146,562
139366,COLUMBUS COLLEGE,0,1,1991,1998,0,509,312,197,30,9,21,0.06,0.05,0.06,1482,25,180,352
139366,COLUMBUS COLLEGE,0,1,1992,1998,0,589,365,224,42,14,28,0.07,0.06,0.07,1545,25,198,407
139366,COLUMBUS COLLEGE,0,1,1993,1998,0,650,401,249,59,20,39,0.09,0.08,0.09,1600,28,178,416
139366,COLUMBUS STATE UNIVERSITY,0,1,1995,1998,0,633,390,243,54,17,37,0.09,0.07,0.09,1740,38,190,435
139366,COLUMBUS STATE UNIVERSITY,0,1,1996,1998,0,616,383,233,43,10,33,0.08,0.04,0.07,1845,43,201,386
139366,COLUMBUS STATE UNIVERSITY,0,1,1997,1998,0,612,354,258,53,14,39,0.11,0.05,0.09,1941,47,218,420
139366,COLUMBUS STATE UNIVERSITY,1,0,1998,1998,1,723,450,273,63,17,46,0.1,0.06,0.09,2020,60,215,493
139366,COLUMBUS STATE UNIVERSITY,1,0,1999,1998,1,672,412,260,54,13,41,0.09,0.05,0.08,1808,48,216,495
139366,COLUMBUS STATE UNIVERSITY,1,0,2000,1998,1,759,468,291,87,24,63,0.13,0.08,0.11,1876,63,211,492
139366,COLUMBUS STATE UNIVERSITY,1,0,2001,1998,1,761,468,293,84,20,64,0.13,0.07,0.11,1932,52,206,518
139366,COLUMBUS STATE UNIVERSITY,1,0,2002,1998,1,943,548,395,91,18,73,0.13,0.05,0.1,2010,52,207,611
139366,COLUMBUS STATE UNIVERSITY,1,0,2003,1998,1,1037,619,418,114,32,82,0.13,0.08,0.11,2212,53,198,631
139366,COLUMBUS STATE UNIVERSITY,1,0,2004,1998,1,972,584,388,116,31,85,0.14,0.08,0.12,2322,55,201,606
139366,Columbus State University,1,0,2005,1998,1,1067,641,426,129,33,96,0.14,0.08,0.12,2438,62,217,657
139366,Columbus State University,1,0,2006,1998,1,1054,640,414,139,37,102,0.15,0.09,0.13,2548,69,245,611
139366,Columbus State University,1,0,2007,1998,1,996,568,428,117,29,88,0.15,0.07,0.12,2706,78,246,599
139366,Columbus State University,1,0,2008,1998,1,1114,642,472,131,38,93,0.14,0.08,0.12,2838,83,252,627
139366,Columbus State University,1,0,2009,1998,1,1231,734,497,138,43,95,0.12,0.09,0.11,3100,83,261,653
139366,Columbus State University,1,0,2010,1998,1,1154,718,436,130,43,87,0.12,0.1,0.11,3281,93,267,606
139393,COVENANT COLLEGE,1,0,1991,NA,NA,136,73,63,56,21,35,0.47000000000000003,0.33,0.41,7900,8,37,133
139393,COVENANT COLLEGE,1,0,1992,NA,NA,155,98,57,56,18,38,0.38,0.32,0.36,8550,9,37,147
139393,COVENANT COLLEGE,1,0,1993,NA,NA,168,93,75,75,31,44,0.47000000000000003,0.41,0.45,9200,11,39,159
139393,COVENANT COLLEGE,1,0,1995,NA,NA,155,90,65,75,33,42,0.46,0.51,0.48,10920,12,39,142
139393,COVENANT COLLEGE,1,0,1996,NA,NA,206,119,87,109,43,66,0.55,0.49,0.53,11780,12,37,192
139393,COVENANT COLLEGE,1,0,1997,NA,NA,197,112,85,89,31,58,0.51,0.36,0.45,12900,13,46,183
139393,COVENANT COLLEGE,1,0,1998,NA,NA,211,134,77,112,36,76,0.56,0.47,0.53,13750,14,43,196
139393,COVENANT COLLEGE,1,0,1999,NA,NA,228,144,84,124,45,79,0.54,0.54,0.54,14400,16,44,208
139393,COVENANT COLLEGE,1,0,2000,NA,NA,206,117,89,107,47,60,0.51,0.53,0.52,15600,18,45,191
139393,COVENANT COLLEGE,1,0,2001,NA,NA,238,151,87,120,41,79,0.52,0.47,0.5,16590,19,46,216
139393,COVENANT COLLEGE,1,0,2002,NA,NA,231,141,90,129,44,85,0.6,0.49,0.56,17750,21,58,209
139393,COVENANT COLLEGE,1,0,2003,NA,NA,236,146,90,108,32,76,0.52,0.36,0.46,17750,21,56,214
139393,COVENANT COLLEGE,1,0,2004,NA,NA,260,156,104,123,41,82,0.52,0.39,0.47,18750,22,59,243
139393,Covenant College,1,0,2005,NA,NA,270,138,132,122,48,74,0.53,0.36,0.45,20100,23,61,241
139393,Covenant College,1,0,2006,NA,NA,297,166,131,163,62,101,0.6,0.47,0.55,21100,23,65,265
139393,Covenant College,1,0,2007,NA,NA,291,163,128,139,51,88,0.53,0.4,0.48,22160,25,70,258
139393,Covenant College,1,0,2008,NA,NA,267,149,118,129,51,78,0.52,0.43,0.48,23600,27,66,240
139393,Covenant College,1,0,2009,NA,NA,277,158,119,139,48,91,0.5700000000000001,0.4,0.5,24520,31,60,252
139393,Covenant College,1,0,2010,NA,NA,269,131,138,160,66,94,0.71,0.48,0.59,25476,29,63,233
139658,EMORY UNIVERSITY,1,0,1991,NA,NA,1415,772,643,950,430,520,0.67,0.67,0.67,14580,747,492,1110
139658,EMORY UNIVERSITY,1,0,1992,NA,NA,1478,872,606,1010,406,604,0.6900000000000001,0.67,0.68,15600,801,507,1078
139658,EMORY UNIVERSITY,1,0,1993,NA,NA,1406,762,644,999,458,541,0.71,0.71,0.71,16820,885,549,1037
139658,EMORY UNIVERSITY,1,0,1995,NA,NA,1587,896,691,1093,441,652,0.72,0.64,0.69,19000,1061,569,1146
139658,EMORY UNIVERSITY,1,0,1996,NA,NA,1508,867,641,1076,438,638,0.73,0.68,0.71,19870,1106,592,1058
139658,EMORY UNIVERSITY,1,0,1997,NA,NA,1477,762,715,1120,525,595,0.78,0.73,0.76,21110,1154,581,1011
139658,EMORY UNIVERSITY,1,0,1998,NA,NA,1692,908,784,1227,548,679,0.74,0.7,0.73,21870,1427,587,1152
139658,EMORY UNIVERSITY,1,0,1999,NA,NA,1515,870,645,1148,486,662,0.76,0.75,0.76,22870,1581,579,1018
139658,EMORY UNIVERSITY,1,0,2000,NA,NA,1532,831,701,936,420,516,0.62,0.6,0.61,24240,1664,589,1021
139658,EMORY UNIVERSITY,1,0,2001,NA,NA,1547,817,730,1013,486,527,0.64,0.67,0.65,25240,1772,600,979
139658,EMORY UNIVERSITY,1,0,2002,NA,NA,1558,903,655,1061,444,617,0.68,0.68,0.68,26600,1854,613,995
139658,EMORY UNIVERSITY,1,0,2003,NA,NA,1595,895,700,1060,453,607,0.67,0.65,0.66,27600,2043,645,950
139658,EMORY UNIVERSITY,1,0,2004,NA,NA,1587,911,676,1044,436,608,0.66,0.64,0.66,28940,2214,666,959
139658,Emory University,1,0,2005,NA,NA,1631,933,698,1032,450,582,0.62,0.64,0.63,30400,2350,685,931
139658,Emory University,1,0,2006,NA,NA,1648,938,710,1108,477,631,0.67,0.67,0.67,32100,2550,697,882
139658,Emory University,1,0,2007,NA,NA,1597,863,734,1027,477,550,0.63,0.65,0.64,33900,2672,992,791
139658,Emory University,1,0,2008,NA,NA,1661,893,768,1064,501,563,0.63,0.65,0.64,35800,2832,1003,785
139658,Emory University,1,0,2009,NA,NA,1287,712,575,1067,448,619,0.86,0.78,0.83,37500,3022,995,537
139658,Emory University,1,0,2010,NA,NA,1321,748,573,1125,462,663,0.88,0.81,0.85,38600,3133,1003,593
139719,FORT VALLEY STATE COLLEGE,0,1,1991,1998,0,464,276,188,48,22,26,0.09,0.12,0.1,1650,26,148,7
139719,FORT VALLEY STATE COLLEGE,0,1,1992,1998,0,497,264,233,52,18,34,0.12,0.08,0.1,1650,27,147,1
139719,FORT VALLEY STATE COLLEGE,0,1,1993,1998,0,539,290,249,27,3,24,0.08,0.01,0.05,1775,30,142,7
139719,FORT VALLEY STATE UNIVERSITY,0,1,1995,1998,0,522,261,261,38,8,30,0.11,0.03,0.07,1920,36,143,5
139719,FORT VALLEY STATE UNIVERSITY,0,1,1996,1998,0,573,307,266,48,6,42,0.13,0.02,0.08,2040,38,149,4
139719,FORT VALLEY STATE UNIVERSITY,0,1,1997,1998,0,502,270,232,75,19,56,0.2,0.08,0.15,2157,43,139,5
139719,FORT VALLEY STATE UNIVERSITY,1,0,1998,1998,1,432,240,192,40,11,29,0.12,0.06,0.09,2216,45,152,4
139719,FORT VALLEY STATE UNIVERSITY,1,0,1999,1998,1,406,206,200,36,9,27,0.13,0.04,0.09,1808,47,146,2
139719,FORT VALLEY STATE UNIVERSITY,1,0,2000,1998,1,360,195,165,48,14,34,0.17,0.08,0.13,1876,49,143,7
139719,FORT VALLEY STATE UNIVERSITY,1,0,2001,1998,1,425,225,200,60,16,44,0.19,0.08,0.14,1932,51,141,3
139719,FORT VALLEY STATE UNIVERSITY,1,0,2002,1998,1,386,192,194,59,12,47,0.24,0.06,0.15,2580,113,135,3
139719,FORT VALLEY STATE UNIVERSITY,1,0,2003,1998,1,496,260,236,64,17,47,0.18,0.07,0.13,2212,59,107,2
139719,FORT VALLEY STATE UNIVERSITY,1,0,2004,1998,1,456,227,229,66,18,48,0.21,0.08,0.14,2322,50,126,7
139719,Fort Valley State University,1,0,2005,1998,1,317,169,148,48,11,37,0.21,0.07,0.15,2438,47,101,2
139719,Fort Valley State University,1,0,2006,1998,1,486,253,233,51,9,42,0.16,0.04,0.1,2548,50,107,2
139719,Fort Valley State University,1,0,2007,1998,1,716,386,330,56,12,44,0.11,0.04,0.08,2706,54,110,2
139719,Fort Valley State University,1,0,2008,1998,1,1074,568,506,117,32,85,0.14,0.06,0.11,2868,62,117,9
139719,Fort Valley State University,1,0,2009,1998,1,984,550,434,118,26,92,0.16,0.06,0.12,3874,67,103,7
139719,Fort Valley State University,1,0,2010,1998,1,840,487,353,69,26,43,0.08,0.07,0.08,4274,76,144,6
139755,GEORGIA INSTITUTE OF TECHNOLOGY MAIN CAMPUS,0,1,1991,1999,0,1750,415,1335,484,335,149,0.35000000000000003,0.25,0.28,2118,311,608,1383
139755,GEORGIA INSTITUTE OF TECHNOLOGY MAIN CAMPUS,0,1,1992,1999,0,1691,467,1224,472,298,174,0.37,0.24,0.28,2205,326,587,1363
139755,GEORGIA INSTITUTE OF TECHNOLOGY MAIN CAMPUS,0,1,1993,1999,0,1963,484,1479,398,252,146,0.3,0.17,0.2,2277,343,626,1529
139755,GEORGIA INSTITUTE OF TECHNOLOGY MAIN CAMPUS,0,1,1995,1999,0,2120,600,1520,451,271,180,0.3,0.18,0.21,2457,404,640,1612
139755,GEORGIA INSTITUTE OF TECHNOLOGY MAIN CAMPUS,0,1,1996,1999,0,2120,596,1524,484,288,196,0.32,0.19,0.23,2685,448,670,1667
139755,GEORGIA INSTITUTE OF TECHNOLOGY-MAIN CAMPUS,0,1,1997,1999,0,2069,565,1504,487,305,182,0.32,0.2,0.24,2901,487,688,1600
139755,GEORGIA INSTITUTE OF TECHNOLOGY-MAIN CAMPUS,0,1,1998,1999,0,2487,721,1766,644,371,273,0.37,0.21,0.26,2991,525,686,1799
139755,GEORGIA INSTITUTE OF TECHNOLOGY-MAIN CAMPUS,1,0,1999,1999,1,2293,654,1639,657,431,226,0.34,0.26,0.29,2414,573,721,1683
139755,GEORGIA INSTITUTE OF TECHNOLOGY-MAIN CAMPUS,1,0,2000,1999,1,2242,640,1602,760,470,290,0.45,0.29,0.34,2506,625,737,1633
139755,GEORGIA INSTITUTE OF TECHNOLOGY-MAIN CAMPUS,1,0,2001,1999,1,2223,634,1589,736,441,295,0.46,0.28,0.33,2632,653,754,1625
139755,GEORGIA INSTITUTE OF TECHNOLOGY-MAIN CAMPUS,1,0,2002,1999,1,2275,636,1639,711,445,266,0.41000000000000003,0.27,0.31,2790,658,879,1662
139755,GEORGIA INSTITUTE OF TECHNOLOGY-MAIN CAMPUS,1,0,2003,1999,1,2224,607,1617,683,427,256,0.42,0.26,0.31,3208,758,852,1579
139755,GEORGIA INSTITUTE OF TECHNOLOGY-MAIN CAMPUS,1,0,2004,1999,1,2572,766,1806,845,514,331,0.43,0.28,0.33,3368,792,834,1812
139755,Georgia Institute of Technology-Main Campus,1,0,2005,1999,1,2415,714,1701,756,431,325,0.45,0.25,0.31,3638,819,879,1716
139755,Georgia Institute of Technology-Main Campus,1,0,2006,1999,1,2838,890,1948,953,548,405,0.45,0.28,0.34,3892,859,907,1912
139755,Georgia Institute of Technology-Main Campus,1,0,2007,1999,1,2622,854,1768,1072,645,427,0.5,0.36,0.41,4159,936,909,1702
139755,Georgia Institute of Technology-Main Campus,1,0,2008,1999,1,2633,838,1795,974,604,370,0.44,0.34,0.37,4395,1006,964,1674
139755,Georgia Institute of Technology-Main Campus,1,0,2009,1999,1,2654,887,1767,1064,638,426,0.48,0.36,0.4,4829,1051,978,1558
139755,Georgia Institute of Technology-Main Campus,1,0,2010,1999,1,2706,976,1730,1111,648,463,0.47000000000000003,0.37,0.41,5873,1093,990,1625
139764,GEORGIA SOUTHWESTERN COLLEGE,0,1,1991,1998,0,322,190,132,70,35,35,0.18,0.27,0.22,1578,16,111,241
139764,GEORGIA SOUTHWESTERN COLLEGE,0,1,1992,1998,0,375,243,132,75,28,47,0.19,0.21,0.2,1650,16,114,283
139764,GEORGIA SOUTHWESTERN COLLEGE,0,1,1993,1998,0,349,226,123,38,6,32,0.14,0.05,0.11,1680,19,113,271
139764,GEORGIA SOUTHWESTERN STATE UNIVERSITY,0,1,1995,1998,0,328,211,117,26,3,23,0.1,0.03,0.08,1898,22,104,200
139764,GEORGIA SOUTHWESTERN STATE UNIVERSITY,0,1,1996,1998,0,315,199,116,43,10,33,0.16,0.09,0.14,2067,23,110,206
139764,GEORGIA SOUTHWESTERN STATE UNIVERSITY,0,1,1997,1998,0,449,283,166,85,29,56,0.19,0.17,0.19,2145,25,107,306
139764,GEORGIA SOUTHWESTERN STATE UNIVERSITY,1,0,1998,1998,1,335,215,120,41,5,36,0.16,0.04,0.12,2199,27,95,242
139764,GEORGIA SOUTHWESTERN STATE UNIVERSITY,1,0,1999,1998,1,259,161,98,42,14,28,0.17,0.14,0.16,1808,28,98,175
139764,GEORGIA SOUTHWESTERN STATE UNIVERSITY,1,0,2000,1998,1,308,202,106,44,15,29,0.14,0.14,0.14,1876,29,99,228
139764,GEORGIA SOUTHWESTERN STATE UNIVERSITY,1,0,2001,1998,1,266,173,93,31,8,23,0.13,0.09,0.12,1932,32,101,193
139764,GEORGIA SOUTHWESTERN STATE UNIVERSITY,1,0,2002,1998,1,331,216,115,46,15,31,0.14,0.13,0.14,2010,31,107,215
139764,GEORGIA SOUTHWESTERN STATE UNIVERSITY,1,0,2003,1998,1,326,222,104,48,13,35,0.15,0.12,0.15,2212,30,100,166
139764,GEORGIA SOUTHWESTERN STATE UNIVERSITY,1,0,2004,1998,1,359,247,112,40,6,34,0.13,0.05,0.11,2322,29,90,210
139764,Georgia Southwestern State University,1,0,2005,1998,1,358,200,158,36,9,27,0.13,0.06,0.1,2438,30,83,213
139764,Georgia Southwestern State University,1,0,2006,1998,1,399,236,163,52,11,41,0.17,0.07,0.13,2548,31,90,222
139764,Georgia Southwestern State University,1,0,2007,1998,1,388,252,136,59,16,43,0.17,0.12,0.15,2706,33,92,244
139764,Georgia Southwestern State University,1,0,2008,1998,1,418,240,178,42,16,26,0.1,0.09,0.1,2838,34,99,237
139764,Georgia Southwestern State University,1,0,2009,1998,1,435,251,184,49,16,33,0.13,0.09,0.11,2907,37,96,257
139764,Georgia Southwestern State University,1,0,2010,1998,1,473,284,189,64,13,51,0.17,0.07,0.14,3133,41,102,298
139861,GEORGIA COLLEGE,0,1,1991,1998,0,770,476,294,126,35,91,0.19,0.12,0.16,1563,26,155,605
139861,GEORGIA COLLEGE,0,1,1992,1998,0,754,451,303,112,23,89,0.19,0.08,0.15,1632,28,172,582
139861,GEORGIA COLLEGE,0,1,1993,1998,0,809,520,289,122,18,104,0.2,0.06,0.15,1693,32,177,589
139861,GEORGIA COLLEGE,0,1,1995,1998,0,754,467,287,123,28,95,0.2,0.1,0.16,1820,39,189,624
139861,GEORGIA COLLEGE AND STATE UNIVERSITY,0,1,1996,1998,0,715,483,232,119,23,96,0.19,0.1,0.17,1923,49,196,603
139861,GEORGIA COLLEGE AND STATE UNIVERSITY,0,1,1997,1998,0,818,528,290,130,31,99,0.18,0.11,0.16,2064,53,186,702
139861,GEORGIA COLLEGE AND STATE UNIVERSITY,1,0,1998,1998,1,750,470,280,127,22,105,0.22,0.08,0.17,2136,49,198,654
139861,GEORGIA COLLEGE AND STATE UNIVERSITY,1,0,1999,1998,1,786,486,300,164,36,128,0.26,0.12,0.21,1808,50,200,709
139861,GEORGIA COLLEGE AND STATE UNIVERSITY,1,0,2000,1998,1,820,506,314,189,41,148,0.29,0.13,0.23,1876,52,224,707
139861,GEORGIA COLLEGE AND STATE UNIVERSITY,1,0,2001,1998,1,879,556,323,203,52,151,0.27,0.16,0.23,2532,55,249,791
139861,GEORGIA COLLEGE AND STATE UNIVERSITY,1,0,2002,1998,1,984,612,372,199,45,154,0.25,0.12,0.2,2610,64,276,903
139861,GEORGIA COLLEGE AND STATE UNIVERSITY,1,0,2003,1998,1,1027,611,416,254,69,185,0.3,0.17,0.25,3002,72,276,944
139861,GEORGIA COLLEGE AND STATE UNIVERSITY,1,0,2004,1998,1,918,582,336,322,90,232,0.39,0.27,0.35,3152,74,280,841
139861,Georgia College and State University,1,0,2005,1998,1,1032,631,401,342,101,241,0.38,0.25,0.33,3404,69,268,941
139861,Georgia College & State University,1,0,2006,1998,1,1137,707,430,403,101,302,0.42,0.23,0.35,3608,77,276,1009
139861,Georgia College & State University,1,0,2007,1998,1,1197,778,419,464,124,340,0.43,0.3,0.39,3892,81,262,1077
139861,Georgia College & State University,1,0,2008,1998,1,1177,751,426,470,136,334,0.44,0.32,0.4,4113,102,280,1015
139861,Georgia College & State University,1,0,2009,1998,1,1206,741,465,476,138,338,0.45,0.3,0.39,4520,99,301,1047
139861,Georgia College & State University,1,0,2010,1998,1,1202,767,435,505,138,367,0.47000000000000003,0.32,0.42,5013,98,316,1001
139931,GEORGIA SOUTHERN UNIVERSITY,0,1,1991,1998,0,2737,1457,1280,508,172,336,0.23,0.13,0.19,1620,77,555,2145
139931,GEORGIA SOUTHERN UNIVERSITY,0,1,1992,1998,0,2828,1530,1298,506,174,332,0.21,0.13,0.18,1638,84,575,2046
139931,GEORGIA SOUTHERN UNIVERSITY,0,1,1993,1998,0,2955,1602,1353,540,158,382,0.23,0.12,0.18,1807,100,621,2032
139931,GEORGIA SOUTHERN UNIVERSITY,0,1,1995,1998,0,3193,1825,1368,407,112,295,0.16,0.08,0.13,1965,118,627,2175
139931,GEORGIA SOUTHERN UNIVERSITY,0,1,1996,1998,0,3159,1699,1460,385,115,270,0.15,0.08,0.12,2055,125,632,2196
139931,GEORGIA SOUTHERN UNIVERSITY,0,1,1997,1998,0,2596,1387,1209,306,81,225,0.16,0.07,0.12,2256,134,639,1883
139931,GEORGIA SOUTHERN UNIVERSITY,1,0,1998,1998,1,2897,1549,1348,335,87,248,0.16,0.06,0.12,2349,144,641,1973
139931,GEORGIA SOUTHERN UNIVERSITY,1,0,1999,1998,1,3266,1729,1537,384,98,286,0.16,0.06,0.12,1808,153,651,2218
139931,GEORGIA SOUTHERN UNIVERSITY,1,0,2000,1998,1,2859,1481,1378,379,105,274,0.18,0.08,0.13,1876,159,638,2004
139931,GEORGIA SOUTHERN UNIVERSITY,1,0,2001,1998,1,2632,1278,1354,435,110,325,0.25,0.08,0.17,1932,164,625,1939
139931,GEORGIA SOUTHERN UNIVERSITY,1,0,2002,1998,1,2597,1232,1365,434,138,296,0.24,0.1,0.17,2010,153,604,1976
139931,GEORGIA SOUTHERN UNIVERSITY,1,0,2003,1998,1,2735,1305,1430,466,145,321,0.24,0.1,0.17,2212,158,640,2090
139931,GEORGIA SOUTHERN UNIVERSITY,1,0,2004,1998,1,2982,1393,1589,546,158,388,0.27,0.1,0.18,2322,160,664,2248
139931,Georgia Southern University,1,0,2005,1998,1,3123,1472,1651,623,195,428,0.29,0.12,0.2,2438,168,645,2303
139931,Georgia Southern University,1,0,2006,1998,1,2731,1294,1437,617,214,403,0.31,0.15,0.23,2548,185,673,2084
139931,Georgia Southern University,1,0,2007,1998,1,3028,1402,1626,773,287,486,0.34,0.18,0.26,2744,203,714,1317
139931,Georgia Southern University,1,0,2008,1998,1,3106,1453,1653,828,300,528,0.36,0.18,0.27,2898,220,741,2175
139931,Georgia Southern University,1,0,2009,1998,1,3490,1683,1807,854,292,562,0.33,0.16,0.24,3178,241,751,2416
139931,Georgia Southern University,1,0,2010,1998,1,3597,1785,1812,950,305,645,0.36,0.17,0.26,3283,257,761,2339
139940,GEORGIA STATE UNIVERSITY,0,1,1991,1998,0,1007,598,409,103,34,69,0.11,0.08,0.1,1884,148,759,652
139940,GEORGIA STATE UNIVERSITY,0,1,1992,1998,0,998,574,424,96,36,60,0.1,0.08,0.1,1952,152,769,639
139940,GEORGIA STATE UNIVERSITY,0,1,1993,1998,0,1072,613,459,119,33,86,0.14,0.07,0.11,2019,168,793,622
139940,GEORGIA STATE UNIVERSITY,0,1,1995,1998,0,1276,750,526,127,51,76,0.1,0.1,0.1,2249,206,800,626
139940,GEORGIA STATE UNIVERSITY,0,1,1996,1998,0,1551,985,566,211,58,153,0.15,0.1,0.14,2385,220,814,779
139940,GEORGIA STATE UNIVERSITY,0,1,1997,1998,0,1906,1172,734,211,60,151,0.12,0.08,0.11,2673,259,845,979
139940,GEORGIA STATE UNIVERSITY,1,0,1998,1998,1,1491,924,567,208,63,145,0.15,0.11,0.14,2778,292,864,831
139940,GEORGIA STATE UNIVERSITY,1,0,1999,1998,1,1772,1082,690,242,69,173,0.15,0.1,0.14,2414,316,943,1002
139940,GEORGIA STATE UNIVERSITY,1,0,2000,1998,1,2061,1233,828,303,85,218,0.17,0.1,0.15,2506,319,940,1048
139940,GEORGIA STATE UNIVERSITY,1,0,2001,1998,1,2136,1305,831,357,99,258,0.19,0.12,0.17,2632,357,938,1006
139940,GEORGIA STATE UNIVERSITY,1,0,2002,1998,1,2469,1419,1050,423,107,316,0.22,0.1,0.17,2790,378,1000,1208
139940,GEORGIA STATE UNIVERSITY,1,0,2003,1998,1,1920,1159,761,349,114,235,0.2,0.15,0.18,3208,389,944,956
139940,GEORGIA STATE UNIVERSITY,1,0,2004,1998,1,2272,1338,934,389,132,257,0.19,0.14,0.17,3368,400,981,1111
139940,Georgia State University,1,0,2005,1998,1,2325,1322,1003,408,164,244,0.18,0.16,0.18,3638,402,998,1018
139940,Georgia State University,1,0,2006,1998,1,2174,1313,861,439,135,304,0.23,0.16,0.2,3856,432,994,940
139940,Georgia State University,1,0,2007,1998,1,2521,1486,1035,540,154,386,0.25,0.15,0.21,4159,428,1046,1005
139940,Georgia State University,1,0,2008,1998,1,2743,1609,1134,614,206,408,0.25,0.18,0.22,4856,513,1064,732
139940,Georgia State University,1,0,2009,1998,1,2937,1745,1192,702,233,469,0.26,0.2,0.24,6070,522,1052,1095
139940,Georgia State University,1,0,2010,1998,1,2853,1540,1313,669,240,429,0.27,0.18,0.23,7070,531,1067,998
139959,UNIVERSITY OF GEORGIA,0,1,1991,1998,0,3408,1927,1481,1191,429,762,0.39,0.29,0.35,2076,497,1728,2931
139959,UNIVERSITY OF GEORGIA,0,1,1992,1998,0,3147,1823,1324,1456,521,935,0.51,0.39,0.46,2175,491,1668,2697
139959,UNIVERSITY OF GEORGIA,0,1,1993,1998,0,3808,2115,1693,1617,630,987,0.46,0.37,0.42,2250,532,1658,3324
139959,UNIVERSITY OF GEORGIA,0,1,1995,1998,0,3996,2376,1620,1702,570,1132,0.47000000000000003,0.35,0.43,2542,644,1689,3379
139959,UNIVERSITY OF GEORGIA,0,1,1996,1998,0,3671,2184,1487,1546,494,1052,0.48,0.33,0.42,2694,689,1708,3239
139959,UNIVERSITY OF GEORGIA,0,1,1997,1998,0,4348,2544,1804,1729,569,1160,0.45,0.32,0.4,2838,735,1700,3856
139959,UNIVERSITY OF GEORGIA,1,0,1998,1998,1,4384,2588,1796,1771,535,1236,0.47000000000000003,0.3,0.4,2930,769,1705,3855
139959,UNIVERSITY OF GEORGIA,1,0,1999,1998,1,4375,2586,1789,1860,592,1268,0.49,0.33,0.43,2414,793,1719,3842
139959,UNIVERSITY OF GEORGIA,1,0,2000,1998,1,4207,2556,1651,1911,584,1327,0.51,0.35,0.45,2506,883,1723,3669
139959,UNIVERSITY OF GEORGIA,1,0,2001,1998,1,4459,2646,1813,2137,677,1460,0.55,0.37,0.48,2632,926,1727,3950
139959,UNIVERSITY OF GEORGIA,1,0,2002,1998,1,4282,2570,1712,2155,713,1442,0.56,0.42,0.5,2790,854,1705,3752
139959,UNIVERSITY OF GEORGIA,1,0,2003,1998,1,5157,3146,2011,2535,807,1728,0.54,0.4,0.49,3208,934,1690,4469
139959,UNIVERSITY OF GEORGIA,1,0,2004,1998,1,4500,2724,1776,2335,774,1561,0.5700000000000001,0.44,0.52,3368,942,1661,3918
139959,University of Georgia,1,0,2005,1998,1,4654,2812,1842,2505,845,1660,0.59,0.46,0.54,3638,931,1691,3697
139959,University of Georgia,1,0,2006,1998,1,5059,3161,1898,2732,900,1832,0.5700000000000001,0.47,0.54,3856,1017,1735,4018
139959,University of Georgia,1,0,2007,1998,1,4675,2942,1733,2655,853,1802,0.61,0.49,0.57,4159,1055,1733,3741
139959,University of Georgia,1,0,2008,1998,1,4778,3013,1765,2853,924,1929,0.64,0.52,0.6,4395,1123,1761,3759
139959,University of Georgia,1,0,2009,1998,1,4675,2862,1813,2881,951,1930,0.67,0.52,0.62,4828,1138,1775,3610
139959,University of Georgia,1,0,2010,1998,1,4667,2886,1781,2903,961,1942,0.67,0.54,0.62,5873,1123,1749,3345
140447,MERCER UNIVERSITY,0,1,1991,1998,0,670,347,323,230,100,130,0.37,0.31,0.34,9450,81,234,544
140447,MERCER UNIVERSITY,0,1,1992,1998,0,579,349,230,158,45,113,0.32,0.2,0.27,10287,83,238,428
140447,MERCER UNIVERSITY,0,1,1993,1998,0,639,378,261,243,85,158,0.41000000000000003,0.33,0.38,11160,88,246,480
140447,MERCER UNIVERSITY,0,1,1995,1998,0,630,381,249,199,65,134,0.35000000000000003,0.26,0.32,12987,107,255,439
140447,MERCER UNIVERSITY,0,1,1996,1998,0,681,432,249,228,63,165,0.38,0.25,0.33,13896,113,253,487
140447,MERCER UNIVERSITY,0,1,1997,1998,0,679,428,251,215,70,145,0.33,0.28,0.32,14656,109,313,456
140447,MERCER UNIVERSITY,1,0,1998,1998,1,706,428,278,221,74,147,0.34,0.27,0.31,15465,118,307,490
140447,MERCER UNIVERSITY,1,0,1999,1998,1,730,449,281,254,79,175,0.38,0.28,0.35,16290,124,314,457
140447,MERCER UNIVERSITY,1,0,2000,1998,1,733,438,295,223,71,152,0.34,0.24,0.3,17028,135,316,444
140447,MERCER UNIVERSITY,1,0,2001,1998,1,767,472,295,257,73,184,0.38,0.25,0.34,18290,142,318,567
140447,MERCER UNIVERSITY,1,0,2002,1998,1,687,387,300,275,93,182,0.47000000000000003,0.31,0.4,19728,159,320,500
140447,MERCER UNIVERSITY,1,0,2003,1998,1,663,381,282,292,88,204,0.53,0.31,0.44,20796,160,320,478
140447,MERCER UNIVERSITY,1,0,2004,1998,1,632,373,259,270,90,180,0.48,0.35,0.43,22050,166,318,447
140447,Mercer University,1,0,2005,1998,1,666,408,258,267,86,181,0.44,0.33,0.4,23460,171,343,461
140447,Mercer University,1,0,2006,1998,1,582,300,282,253,98,155,0.51,0.35,0.43,25056,186,349,391
140447,Mercer University,1,0,2007,1998,1,602,337,265,265,87,178,0.52,0.33,0.44,26760,175,349,352
140447,Mercer University,1,0,2008,1998,1,615,365,250,298,94,204,0.55,0.38,0.48,28500,182,348,387
140447,Mercer University,1,0,2009,1998,1,628,349,279,294,108,186,0.53,0.39,0.47,29340,195,359,374
140447,Mercer University,1,0,2010,1998,1,596,301,295,293,116,177,0.58,0.39,0.49,30360,205,380,368
140960,SAVANNAH STATE COLLEGE,0,1,1991,1998,0,737,394,343,75,28,47,0.11,0.08,0.1,1635,22,121,7
140960,SAVANNAH STATE COLLEGE,0,1,1992,1998,0,636,346,290,50,15,35,0.1,0.05,0.08,1686,23,130,10
140960,SAVANNAH STATE COLLEGE,0,1,1993,1998,0,760,391,369,48,15,33,0.08,0.04,0.06,1741,26,145,9
140960,SAVANNAH STATE UNIVERSITY,0,1,1995,1998,0,676,358,318,25,2,23,0.06,0.01,0.04,1965,31,137,13
140960,SAVANNAH STATE UNIVERSITY,0,1,1996,1998,0,483,268,215,13,3,10,0.03,0.01,0.03,2130,32,146,6
140960,SAVANNAH STATE UNIVERSITY,0,1,1997,1998,0,455,240,215,19,4,15,0.06,0.02,0.04,2226,43,147,8
140960,SAVANNAH STATE UNIVERSITY,1,0,1998,1998,1,321,179,142,23,5,18,0.1,0.04,0.07,2278,47,143,6
140960,SAVANNAH STATE UNIVERSITY,1,0,1999,1998,1,281,150,131,18,4,14,0.09,0.03,0.06,1808,48,142,10
140960,SAVANNAH STATE UNIVERSITY,1,0,2000,1998,1,370,195,175,35,7,28,0.14,0.04,0.09,1826,49,130,16
140960,SAVANNAH STATE UNIVERSITY,1,0,2001,1998,1,440,238,202,58,13,45,0.18,0.06,0.13,1932,54,118,10
140960,SAVANNAH STATE UNIVERSITY,1,0,2002,1998,1,496,269,227,52,7,45,0.16,0.03,0.1,2010,39,122,3
140960,SAVANNAH STATE UNIVERSITY,1,0,2003,1998,1,607,354,253,76,12,64,0.18,0.05,0.13,2212,40,114,7
140960,SAVANNAH STATE UNIVERSITY,1,0,2004,1998,1,568,316,252,73,22,51,0.16,0.09,0.13,2322,42,123,12
140960,Savannah State University,1,0,2005,1998,1,806,427,379,73,16,57,0.13,0.04,0.09,2438,44,123,14
140960,Savannah State University,1,0,2006,1998,1,697,377,320,60,12,48,0.12,0.04,0.09,2548,45,114,9
140960,Savannah State University,1,0,2007,1998,1,612,343,269,51,10,41,0.11,0.04,0.08,2706,47,116,8
140960,Savannah State University,1,0,2008,1998,1,905,490,415,71,22,49,0.1,0.05,0.08,3098,52,149,8
140960,Savannah State University,1,0,2009,1998,1,866,448,418,68,18,50,0.11,0.04,0.08,3100,63,151,16
140960,Savannah State University,1,0,2010,1998,1,953,504,449,81,19,62,0.12,0.04,0.08,4274,69,157,35
140988,SHORTER COLLEGE,1,0,1991,NA,NA,139,96,43,59,18,41,0.42,0.42,0.42,5810,8,61,130
140988,SHORTER COLLEGE,1,0,1992,NA,NA,175,118,57,65,20,45,0.38,0.35,0.37,6220,9,58,157
140988,SHORTER COLLEGE,1,0,1993,NA,NA,165,112,53,60,15,45,0.4,0.28,0.36,6670,10,55,156
140988,SHORTER COLLEGE,1,0,1995,NA,NA,167,118,49,76,24,52,0.44,0.49,0.46,7610,12,63,150
140988,SHORTER COLLEGE,1,0,1996,NA,NA,204,134,70,75,22,53,0.39,0.31,0.37,7860,13,62,181
140988,SHORTER COLLEGE,1,0,1997,NA,NA,242,162,80,90,26,64,0.39,0.32,0.37,8260,13,60,222
140988,SHORTER COLLEGE,1,0,1998,NA,NA,247,167,80,86,22,64,0.38,0.28,0.35,8770,12,57,221
140988,SHORTER COLLEGE,1,0,1999,NA,NA,259,171,88,103,32,71,0.41000000000000003,0.36,0.4,9050,13,61,227
140988,SHORTER COLLEGE,1,0,2000,NA,NA,299,205,94,105,23,82,0.4,0.24,0.35,9350,14,62,268
140988,SHORTER COLLEGE,1,0,2001,NA,NA,258,186,72,92,20,72,0.38,0.28,0.36,9800,16,64,228
140988,SHORTER COLLEGE,1,0,2002,NA,NA,218,144,74,80,23,57,0.39,0.31,0.37,10400,17,64,191
140988,SHORTER COLLEGE,1,0,2003,NA,NA,184,96,88,80,33,47,0.48,0.38,0.43,11440,18,65,155
140988,SHORTER COLLEGE,1,0,2004,NA,NA,226,128,98,95,31,64,0.5,0.32,0.42,12500,18,67,194
140988,Shorter College,1,0,2005,NA,NA,291,133,158,101,40,61,0.45,0.25,0.35,13200,19,72,222
140988,Shorter College,1,0,2006,NA,NA,311,138,173,104,42,62,0.44,0.24,0.33,14000,17,67,237
140988,Shorter College,1,0,2007,NA,NA,276,131,145,91,35,56,0.42,0.24,0.33,14850,19,69,215
140988,Shorter College,1,0,2008,NA,NA,330,163,167,117,46,71,0.43,0.28,0.35,15440,21,77,247
140988,Shorter College,1,0,2009,NA,NA,333,175,158,105,32,73,0.41000000000000003,0.2,0.32,15950,23,83,253
140988,Shorter University,1,0,2010,NA,NA,446,216,230,121,48,73,0.33,0.21,0.27,16700,26,85,311
141185,TOCCOA FALLS COLLEGE,1,0,1991,NA,NA,218,113,105,51,25,26,0.23,0.24,0.23,5208,7,41,201
141185,TOCCOA FALLS COLLEGE,1,0,1992,NA,NA,201,114,87,53,19,34,0.29,0.22,0.26,5486,8,39,186
141185,TOCCOA FALLS COLLEGE,1,0,1993,NA,NA,165,105,60,47,15,32,0.3,0.25,0.28,6104,8,40,161
141185,TOCCOA FALLS COLLEGE,1,0,1995,NA,NA,210,124,86,8,2,6,0.04,0.02,0.04,6628,10,45,188
141185,TOCCOA FALLS COLLEGE,1,0,1996,NA,NA,187,120,67,66,22,44,0.36,0.33,0.35,7005,11,45,171
141185,TOCCOA FALLS COLLEGE,1,0,1997,NA,NA,263,157,106,79,29,50,0.31,0.27,0.3,7395,12,47,244
141185,TOCCOA FALLS COLLEGE,1,0,1998,NA,NA,229,141,88,76,24,52,0.36,0.27,0.33,7763,13,50,204
141185,TOCCOA FALLS COLLEGE,1,0,1999,NA,NA,216,135,81,65,19,46,0.34,0.23,0.3,8384,13,47,201
141185,TOCCOA FALLS COLLEGE,1,0,2000,NA,NA,192,105,87,51,13,38,0.36,0.15,0.27,8888,15,50,173
141185,TOCCOA FALLS COLLEGE,1,0,2001,NA,NA,198,124,74,71,25,46,0.37,0.34,0.36,9600,15,53,171
141185,TOCCOA FALLS COLLEGE,1,0,2002,NA,NA,175,106,69,88,37,51,0.48,0.54,0.5,9900,15,47,157
141185,TOCCOA FALLS COLLEGE,1,0,2003,NA,NA,165,107,58,83,22,61,0.5700000000000001,0.38,0.5,10850,14,45,149
141185,TOCCOA FALLS COLLEGE,1,0,2004,NA,NA,161,98,63,67,20,47,0.47000000000000003,0.32,0.42,11450,15,42,140
141185,Toccoa Falls College,1,0,2005,NA,NA,223,135,88,84,27,57,0.42,0.31,0.38,12050,15,43,199
141185,Toccoa Falls College,1,0,2006,NA,NA,190,104,86,62,18,44,0.42,0.21,0.33,12900,16,48,165
141185,Toccoa Falls College,1,0,2007,NA,NA,218,128,90,75,28,47,0.36,0.31,0.34,13700,17,49,190
141185,Toccoa Falls College,1,0,2008,NA,NA,155,93,62,63,20,43,0.46,0.32,0.41,14500,19,50,135
141185,Toccoa Falls College,1,0,2009,NA,NA,168,109,59,59,21,38,0.34,0.36,0.35,15450,19,50,140
141185,Toccoa Falls College,1,0,2010,NA,NA,153,78,75,54,16,38,0.48,0.21,0.35,15760,18,43,124
141264,VALDOSTA STATE COLLEGE,0,1,1991,1998,0,994,614,380,225,78,147,0.23,0.21,0.23,1638,42,286,804
141264,VALDOSTA STATE COLLEGE,0,1,1992,1998,0,1057,608,449,146,43,103,0.16,0.1,0.14,1689,44,280,778
141264,VALDOSTA STATE UNIVERSITY,0,1,1993,1998,0,1357,807,550,211,50,161,0.19,0.09,0.16,1729,53,311,986
141264,VALDOSTA STATE UNIVERSITY,0,1,1995,1998,0,1665,985,680,247,71,176,0.17,0.1,0.15,1887,69,375,1154
141264,VALDOSTA STATE UNIVERSITY,0,1,1996,1998,0,1838,1030,808,227,65,162,0.15,0.08,0.12,2043,82,392,1281
141264,VALDOSTA STATE UNIVERSITY,0,1,1997,1998,0,1594,947,647,179,50,129,0.13,0.08,0.11,2139,87,409,1118
141264,VALDOSTA STATE UNIVERSITY,1,0,1998,1998,1,1301,755,546,158,44,114,0.15,0.08,0.12,2202,94,431,973
141264,VALDOSTA STATE UNIVERSITY,1,0,1999,1998,1,1177,735,442,211,52,159,0.21,0.12,0.18,1808,99,461,876
141264,VALDOSTA STATE UNIVERSITY,1,0,2000,1998,1,788,512,276,141,49,92,0.17,0.18,0.18,1876,98,436,568
141264,VALDOSTA STATE UNIVERSITY,1,0,2001,1998,1,1534,937,597,266,67,199,0.21,0.11,0.17,1932,102,411,1123
141264,VALDOSTA STATE UNIVERSITY,1,0,2002,1998,1,1584,973,611,239,54,185,0.19,0.09,0.15,2010,89,438,1183
141264,VALDOSTA STATE UNIVERSITY,1,0,2003,1998,1,1756,1007,749,262,73,189,0.18,0.1,0.15,2212,100,423,1334
141264,VALDOSTA STATE UNIVERSITY,1,0,2004,1998,1,1690,969,721,279,78,201,0.2,0.11,0.17,2322,101,420,1281
141264,Valdosta State University,1,0,2005,1998,1,1775,1072,703,299,69,230,0.21,0.1,0.17,2438,105,435,1227
141264,Valdosta State University,1,0,2006,1998,1,2015,1195,820,300,78,222,0.18,0.1,0.15,2548,112,438,1327
141264,Valdosta State University,1,0,2007,1998,1,2029,1233,796,316,86,230,0.18,0.11,0.16,2744,123,441,1286
141264,Valdosta State University,1,0,2008,1998,1,2106,1223,883,344,93,251,0.2,0.11,0.16,2898,133,469,1245
141264,Valdosta State University,1,0,2009,1998,1,2416,1421,995,365,85,280,0.19,0.09,0.15,2978,148,472,1271
141264,Valdosta State University,1,0,2010,1998,1,2528,1554,974,401,100,301,0.19,0.1,0.16,3283,157,499,1278
141334,WEST GEORGIA COLLEGE,0,1,1991,1998,0,1178,664,514,157,43,114,0.17,0.08,0.13,1653,38,246,901
141334,WEST GEORGIA COLLEGE,0,1,1992,1998,0,1182,657,525,141,39,102,0.15,0.07,0.12,2067,39,255,896
141334,WEST GEORGIA COLLEGE,0,1,1993,1998,0,1263,738,525,97,19,78,0.1,0.04,0.08,1766,45,272,904
141334,STATE UNIVERSITY OF WEST GEORGIA,0,1,1995,1998,0,1430,841,589,128,32,96,0.11,0.05,0.09,2274,53,283,1102
141334,STATE UNIVERSITY OF WEST GEORGIA,0,1,1996,1998,0,1296,801,495,141,28,113,0.14,0.06,0.11,2364,60,289,1034
141334,STATE UNIVERSITY OF WEST GEORGIA,0,1,1997,1998,0,1208,718,490,135,29,106,0.14,0.06,0.11,2088,65,286,924
141334,STATE UNIVERSITY OF WEST GEORGIA,1,0,1998,1998,1,1670,1042,628,166,34,132,0.12,0.05,0.1,2158,71,271,1168
141334,STATE UNIVERSITY OF WEST GEORGIA,1,0,1999,1998,1,1604,1005,599,144,34,110,0.1,0.06,0.09,1808,76,318,1151
141334,STATE UNIVERSITY OF WEST GEORGIA,1,0,2000,1998,1,1661,987,674,187,34,153,0.15,0.05,0.11,1876,81,331,1220
141334,STATE UNIVERSITY OF WEST GEORGIA,1,0,2001,1998,1,1551,931,620,194,34,160,0.17,0.05,0.13,2468,88,345,1177
141334,STATE UNIVERSITY OF WEST GEORGIA,1,0,2002,1998,1,1617,921,696,181,41,140,0.15,0.06,0.11,2010,92,356,1190
141334,STATE UNIVERSITY OF WEST GEORGIA,1,0,2003,1998,1,1738,1020,718,215,47,168,0.16,0.07,0.12,2212,99,308,1249
141334,STATE UNIVERSITY OF WEST GEORGIA,1,0,2004,1998,1,1702,976,726,202,67,135,0.13,0.09,0.12,2322,109,383,1198
141334,University of West Georgia,1,0,2005,1998,1,1640,966,674,212,47,165,0.17,0.07,0.13,2438,89,383,1124
141334,University of West Georgia,1,0,2006,1998,1,1694,1002,692,254,67,187,0.18,0.1,0.15,2548,101,390,1096
141334,University of West Georgia,1,0,2007,1998,1,1803,1051,752,311,93,218,0.2,0.12,0.17,2744,109,396,1121
141334,University of West Georgia,1,0,2008,1998,1,2008,1216,792,321,88,233,0.19,0.11,0.16,2898,118,412,1284
141334,University of West Georgia,1,0,2009,1998,1,1911,1095,816,298,81,217,0.19,0.1,0.16,3996,124,430,885
141334,University of West Georgia,1,0,2010,1998,1,1844,1124,720,309,79,230,0.2,0.11,0.17,3696,135,448,747
141486,CHAMINADE UNIVERSITY OF HONOLULU,1,0,1991,NA,NA,122,73,49,23,9,14,0.19,0.18,0.19,6800,13,56,31
141486,CHAMINADE UNIVERSITY OF HONOLULU,1,0,1992,NA,NA,127,73,54,23,8,15,0.2,0.15,0.18,7600,13,56,37
141486,CHAMINADE UNIVERSITY OF HONOLULU,1,0,1993,NA,NA,84,50,34,17,5,12,0.24,0.15,0.2,9990,13,59,25
141486,CHAMINADE UNIVERSITY OF HONOLULU,1,0,1995,NA,NA,123,72,51,31,12,19,0.26,0.24,0.25,10600,15,57,41
141486,CHAMINADE UNIVERSITY OF HONOLULU,1,0,1996,NA,NA,152,100,52,31,10,21,0.21,0.19,0.2,10600,17,45,45
141486,CHAMINADE UNIVERSITY OF HONOLULU,1,0,1997,NA,NA,146,105,41,30,9,21,0.2,0.22,0.21,10800,15,50,47
141486,CHAMINADE UNIVERSITY OF HONOLULU,1,0,1998,NA,NA,186,122,64,40,12,28,0.22,0.19,0.22,11180,15,50,51
141486,CHAMINADE UNIVERSITY OF HONOLULU,1,0,1999,NA,NA,231,159,72,49,12,37,0.23,0.17,0.21,11600,17,54,54
141486,CHAMINADE UNIVERSITY OF HONOLULU,1,0,2000,NA,NA,237,163,74,45,13,32,0.19,0.18,0.19,12040,18,56,59
141486,CHAMINADE UNIVERSITY OF HONOLULU,1,0,2001,NA,NA,223,160,63,39,11,28,0.17,0.17,0.17,12500,19,58,53
141486,CHAMINADE UNIVERSITY OF HONOLULU,1,0,2002,NA,NA,212,154,58,23,8,15,0.09,0.14,0.11,12950,21,57,48
141486,CHAMINADE UNIVERSITY OF HONOLULU,1,0,2003,NA,NA,254,174,80,54,18,36,0.2,0.22,0.21,13380,23,63,72
141486,CHAMINADE UNIVERSITY OF HONOLULU,1,0,2004,NA,NA,247,167,80,62,21,41,0.24,0.26,0.25,13850,25,67,64
141486,Chaminade University of Honolulu,1,0,2005,NA,NA,260,182,78,57,12,45,0.24,0.15,0.22,14330,26,69,64
141486,Chaminade University of Honolulu,1,0,2006,NA,NA,264,185,79,54,17,37,0.2,0.22,0.2,14820,29,74,53
141486,Chaminade University of Honolulu,1,0,2007,NA,NA,242,156,86,65,18,47,0.3,0.21,0.27,15330,30,74,61
141486,Chaminade University of Honolulu,1,0,2008,NA,NA,236,161,75,69,18,51,0.31,0.24,0.29,16000,32,61,29
141486,Chaminade University of Honolulu,1,0,2009,NA,NA,262,164,98,73,25,48,0.29,0.26,0.28,16900,34,62,50
141486,Chaminade University of Honolulu,1,0,2010,NA,NA,287,203,84,101,29,72,0.35000000000000003,0.35,0.35,17600,35,71,43
141565,UNIVERSITY OF HAWAII AT HILO,1,0,1991,NA,NA,198,100,98,10,2,8,0.08,0.02,0.05,1240,36,129,44
141565,UNIVERSITY OF HAWAII AT HILO,1,0,1992,NA,NA,286,173,113,23,10,13,0.07,0.09,0.08,1280,30,142,51
141565,UNIVERSITY OF HAWAII AT HILO,1,0,1993,NA,NA,310,190,120,20,4,16,0.08,0.03,0.06,1320,34,141,71
141565,UNIVERSITY OF HAWAII AT HILO,1,0,1995,NA,NA,359,216,143,32,5,27,0.12,0.03,0.09,1426,38,132,73
141565,UNIVERSITY OF HAWAII AT HILO,1,0,1996,NA,NA,333,207,126,35,11,24,0.11,0.09,0.11,1826,35,132,62
141565,UNIVERSITY OF HAWAII AT HILO,1,0,1997,NA,NA,335,202,133,36,11,25,0.12,0.08,0.11,2186,38,142,74
141565,UNIVERSITY OF HAWAII AT HILO,1,0,1998,NA,NA,351,194,157,24,11,13,0.06,0.07,0.07,2258,37,150,86
141565,UNIVERSITY OF HAWAII AT HILO,1,0,1999,NA,NA,366,207,159,39,11,28,0.13,0.07,0.11,2280,41,152,98
141565,UNIVERSITY OF HAWAII AT HILO,1,0,2000,NA,NA,362,223,139,39,13,26,0.11,0.09,0.11,2280,41,157,117
141565,UNIVERSITY OF HAWAII AT HILO,1,0,2001,NA,NA,400,231,169,53,17,36,0.15,0.1,0.13,2304,46,162,170
141565,UNIVERSITY OF HAWAII AT HILO,1,0,2002,NA,NA,404,238,166,57,17,40,0.16,0.1,0.14,2328,50,161,144
141565,UNIVERSITY OF HAWAII AT HILO,1,0,2003,NA,NA,423,274,149,54,17,37,0.13,0.11,0.13,2376,52,167,197
141565,UNIVERSITY OF HAWAII AT HILO,1,0,2004,NA,NA,412,225,187,50,18,32,0.14,0.1,0.12,2424,55,169,146
141565,University of Hawaii at Hilo,1,0,2005,NA,NA,409,215,194,50,15,35,0.16,0.08,0.12,2472,61,185,133
141565,University of Hawaii at Hilo,1,0,2006,NA,NA,448,267,181,48,9,39,0.14,0.05,0.11,3000,70,194,123
141565,University of Hawaii at Hilo,1,0,2007,NA,NA,497,299,198,41,11,30,0.1,0.06,0.08,3528,76,205,122
141565,University of Hawaii at Hilo,1,0,2008,NA,NA,536,326,210,61,16,45,0.13,0.08,0.11,4056,90,216,125
141565,University of Hawaii at Hilo,1,0,2009,NA,NA,460,269,191,54,17,37,0.13,0.09,0.12,4584,99,217,93
141565,University of Hawaii at Hilo,1,0,2010,NA,NA,392,230,162,43,13,30,0.13,0.08,0.11,5112,100,226,71
141574,UNIVERSITY OF HAWAII AT MANOA,1,0,1991,NA,NA,1462,794,668,117,35,82,0.1,0.05,0.08,1387,376,1080,182
141574,UNIVERSITY OF HAWAII AT MANOA,1,0,1992,NA,NA,1485,823,662,158,46,112,0.13,0.07,0.11,1437,413,1104,147
141574,UNIVERSITY OF HAWAII AT MANOA,1,0,1993,NA,NA,1551,899,652,141,44,97,0.1,0.07,0.09,1497,428,1099,196
141574,UNIVERSITY OF HAWAII AT MANOA,1,0,1995,NA,NA,1671,967,704,184,57,127,0.13,0.08,0.11,1631,466,1039,164
141574,UNIVERSITY OF HAWAII AT MANOA,1,0,1996,NA,NA,1357,769,588,154,45,109,0.14,0.08,0.11,2421,449,1090,168
141574,UNIVERSITY OF HAWAII AT MANOA,1,0,1997,NA,NA,1439,807,632,174,50,124,0.15,0.08,0.12,2949,445,1088,169
141574,UNIVERSITY OF HAWAII AT MANOA,1,0,1998,NA,NA,1388,795,593,162,55,107,0.13,0.09,0.12,3046,483,1054,149
141574,UNIVERSITY OF HAWAII AT MANOA,1,0,1999,NA,NA,1421,793,628,164,56,108,0.13,0.09,0.12,3024,481,1044,217
141574,UNIVERSITY OF HAWAII AT MANOA,1,0,2000,NA,NA,1499,846,653,168,48,120,0.14,0.07,0.11,3024,478,1016,294
141574,UNIVERSITY OF HAWAII AT MANOA,1,0,2001,NA,NA,1521,883,638,224,61,163,0.18,0.1,0.15,3120,484,989,330
141574,UNIVERSITY OF HAWAII AT MANOA,1,0,2002,NA,NA,1726,970,756,251,74,177,0.18,0.1,0.15,3216,599,1039,435
141574,UNIVERSITY OF HAWAII AT MANOA,1,0,2003,NA,NA,1878,1035,843,307,92,215,0.2,0.11,0.16,3312,606,1069,545
141574,UNIVERSITY OF HAWAII AT MANOA,1,0,2004,NA,NA,1892,1039,853,325,109,216,0.2,0.13,0.17,3408,639,1078,578
141574,University of Hawaii at Manoa,1,0,2005,NA,NA,1923,1060,863,354,128,226,0.21,0.15,0.18,3504,669,1083,413
141574,University of Hawaii at Manoa,1,0,2006,NA,NA,1679,922,757,293,107,186,0.2,0.14,0.17,4320,728,1119,402
141574,University of Hawaii at Manoa,1,0,2007,NA,NA,1727,946,781,322,111,211,0.22,0.14,0.19,5136,774,1136,401
141574,University of Hawaii at Manoa,1,0,2008,NA,NA,1808,1027,781,358,114,244,0.23,0.15,0.2,5952,838,1163,413
141574,University of Hawaii at Manoa,1,0,2009,NA,NA,1847,984,863,392,155,237,0.24,0.18,0.21,6768,908,1138,406
141574,University of Hawaii at Manoa,1,0,2010,NA,NA,1776,984,792,439,164,275,0.27,0.21,0.25,7584,826,1084,349
142276,IDAHO STATE UNIVERSITY,1,0,1991,NA,NA,1091,569,522,47,14,33,0.05,0.03,0.04,1230,76,421,972
142276,IDAHO STATE UNIVERSITY,1,0,1992,NA,NA,1091,556,535,66,22,44,0.07,0.04,0.06,1454,86,439,982
142276,IDAHO STATE UNIVERSITY,1,0,1993,NA,NA,1165,626,539,44,12,32,0.05,0.02,0.04,1602,93,460,1043
142276,IDAHO STATE UNIVERSITY,1,0,1995,NA,NA,1363,783,580,37,6,31,0.03,0.01,0.03,1570,106,481,1256
142276,IDAHO STATE UNIVERSITY,1,0,1996,NA,NA,1378,789,589,49,15,34,0.04,0.03,0.04,2125,119,484,1274
142276,IDAHO STATE UNIVERSITY,1,0,1997,NA,NA,1400,793,607,44,11,33,0.04,0.02,0.03,2424,122,496,1281
142276,IDAHO STATE UNIVERSITY,1,0,1998,NA,NA,1442,787,655,52,15,37,0.04,0.02,0.04,2590,130,509,1282
142276,IDAHO STATE UNIVERSITY,1,0,1999,NA,NA,1345,740,605,45,10,35,0.04,0.02,0.03,0,143,536,1205
142276,IDAHO STATE UNIVERSITY,1,0,2000,NA,NA,1345,781,564,51,9,42,0.05,0.02,0.04,0,146,564,1183
142276,IDAHO STATE UNIVERSITY,1,0,2001,NA,NA,1485,783,702,53,9,44,0.05,0.01,0.04,0,154,592,1313
142276,IDAHO STATE UNIVERSITY,1,0,2002,NA,NA,704,474,230,59,5,54,0.11,0.02,0.08,0,157,555,615
142276,IDAHO STATE UNIVERSITY,1,0,2003,NA,NA,787,499,288,53,10,43,0.08,0.03,0.07,0,158,547,692
142276,IDAHO STATE UNIVERSITY,1,0,2004,NA,NA,983,522,461,63,18,45,0.08,0.04,0.06,0,171,599,820
142276,Idaho State University,1,0,2005,NA,NA,909,519,390,74,22,52,0.1,0.06,0.08,0,188,644,762
142276,Idaho State University,1,0,2006,NA,NA,994,525,469,85,23,62,0.11,0.05,0.09,2689,195,615,804
142276,Idaho State University,1,0,2007,NA,NA,998,526,472,88,26,62,0.11,0.06,0.09,2882,200,617,803
142276,Idaho State University,1,0,2008,NA,NA,1031,525,506,94,35,59,0.11,0.07,0.09,3114,216,618,827
142276,Idaho State University,1,0,2009,NA,NA,1189,599,590,122,47,75,0.12,0.08,0.1,3318,214,581,976
142276,Idaho State University,1,0,2010,NA,NA,1432,749,683,121,34,87,0.11,0.05,0.08,3800,211,593,650
142285,UNIVERSITY OF IDAHO,1,0,1991,NA,NA,1273,524,749,140,72,68,0.12,0.1,0.11,1236,151,527,1154
142285,UNIVERSITY OF IDAHO,1,0,1992,NA,NA,1290,574,716,173,77,96,0.16,0.11,0.13,1296,165,520,1164
142285,UNIVERSITY OF IDAHO,1,0,1993,NA,NA,1323,613,710,214,71,143,0.23,0.1,0.16,1426,173,546,1167
142285,UNIVERSITY OF IDAHO,1,0,1995,NA,NA,1242,602,640,225,78,147,0.24,0.12,0.18,1620,195,555,1113
142285,UNIVERSITY OF IDAHO,1,0,1996,NA,NA,1201,574,627,222,85,137,0.23,0.14,0.18,1768,198,637,1093
142285,UNIVERSITY OF IDAHO,1,0,1997,NA,NA,1360,687,673,240,82,158,0.23,0.12,0.18,1942,204,638,1220
142285,UNIVERSITY OF IDAHO,1,0,1998,NA,NA,1481,732,749,297,112,185,0.25,0.15,0.2,2136,209,611,1319
142285,UNIVERSITY OF IDAHO,1,0,1999,NA,NA,1457,736,721,318,123,195,0.26,0.17,0.22,0,220,585,1295
142285,UNIVERSITY OF IDAHO,1,0,2000,NA,NA,1560,722,838,311,127,184,0.25,0.15,0.2,0,235,595,1346
142285,UNIVERSITY OF IDAHO,1,0,2001,NA,NA,1642,791,851,340,122,218,0.27,0.14,0.21,0,265,605,1455
142285,UNIVERSITY OF IDAHO,1,0,2002,NA,NA,1619,784,835,371,153,218,0.27,0.18,0.23,0,287,560,1384
142285,UNIVERSITY OF IDAHO,1,0,2003,NA,NA,1590,748,842,393,163,230,0.3,0.19,0.25,0,276,544,1370
142285,UNIVERSITY OF IDAHO,1,0,2004,NA,NA,1602,755,847,383,147,236,0.31,0.17,0.24,0,277,516,1346
142285,University of Idaho,1,0,2005,NA,NA,1673,823,850,386,156,230,0.27,0.18,0.23,0,302,525,1416
142285,University of Idaho,1,0,2006,NA,NA,1582,749,833,369,150,219,0.29,0.18,0.23,0,308,550,1339
142285,University of Idaho,1,0,2007,NA,NA,1615,764,851,402,173,229,0.29,0.2,0.25,0,317,564,1356
142285,University of Idaho,1,0,2008,NA,NA,1663,777,886,460,202,258,0.33,0.23,0.28,0,334,591,1401
142285,University of Idaho,1,0,2009,NA,NA,1754,841,913,512,180,332,0.39,0.2,0.29,0,346,572,1417
142285,University of Idaho,1,0,2010,NA,NA,1709,799,910,511,226,285,0.35000000000000003,0.25,0.3,0,349,538,1430
142461,NORTHWEST NAZARENE COLLEGE,0,1,1991,2000,0,237,129,108,51,17,34,0.26,0.16,0.22,6966,12,67,220
142461,NORTHWEST NAZARENE COLLEGE,0,1,1992,2000,0,284,162,122,82,31,51,0.31,0.25,0.29,8160,13,65,253
142461,NORTHWEST NAZARENE COLLEGE,0,1,1993,2000,0,319,180,139,110,42,68,0.37,0.3,0.34,8766,15,71,269
142461,NORTHWEST NAZARENE COLLEGE,0,1,1995,2000,0,320,183,137,86,27,59,0.32,0.2,0.27,11145,17,85,37
142461,NORTHWEST NAZARENE COLLEGE,0,1,1996,2000,0,264,156,108,18,4,14,0.08,0.04,0.07,11685,17,84,248
142461,NORTHWEST NAZARENE COLLEGE,0,1,1997,2000,0,277,148,129,91,37,54,0.36,0.29,0.33,11823,16,81,263
142461,NORTHWEST NAZARENE COLLEGE,0,1,1998,2000,0,310,193,117,101,27,74,0.38,0.23,0.33,12456,16,81,299
142461,NORTHWEST NAZARENE UNIVERSITY,0,1,1999,2000,0,295,165,130,88,31,57,0.34,0.24,0.3,12510,18,83,275
142461,NORTHWEST NAZARENE UNIVERSITY,1,0,2000,2000,1,240,137,103,74,24,50,0.36,0.23,0.31,12990,19,85,228
142461,NORTHWEST NAZARENE UNIVERSITY,1,0,2001,2000,1,265,150,115,83,31,52,0.34,0.27,0.31,13700,22,88,236
142461,NORTHWEST NAZARENE UNIVERSITY,1,0,2002,2000,1,276,169,107,87,38,49,0.28,0.36,0.32,14520,23,90,227
142461,NORTHWEST NAZARENE UNIVERSITY,1,0,2003,2000,1,241,153,88,89,22,67,0.43,0.25,0.37,15330,25,89,206
142461,NORTHWEST NAZARENE UNIVERSITY,1,0,2004,2000,1,247,159,88,99,28,71,0.44,0.32,0.4,15980,26,95,205
142461,Northwest Nazarene University,1,0,2005,2000,1,249,168,81,88,24,64,0.38,0.3,0.35,17280,27,98,208
142461,Northwest Nazarene University,1,0,2006,2000,1,247,128,119,86,37,49,0.38,0.31,0.35,18430,28,89,199
142461,Northwest Nazarene University,1,0,2007,2000,1,220,139,81,70,22,48,0.34,0.27,0.32,19700,29,98,166
142461,Northwest Nazarene University,1,0,2008,2000,1,301,169,132,96,34,62,0.36,0.26,0.32,20900,33,101,236
142461,Northwest Nazarene University,1,0,2009,2000,1,263,151,112,95,33,62,0.41000000000000003,0.29,0.36,21930,35,102,204
142461,Northwest Nazarene University,1,0,2010,2000,1,253,151,102,78,30,48,0.31,0.29,0.31,22810,35,108,166
143084,AUGUSTANA COLLEGE,0,1,1991,Inf,0,526,296,230,337,145,192,0.64,0.63,0.64,11175,33,141,455
143084,AUGUSTANA COLLEGE,0,1,1992,Inf,0,538,309,229,318,119,199,0.64,0.52,0.59,12009,34,137,496
143084,AUGUSTANA COLLEGE,0,1,1993,Inf,0,498,290,208,309,121,188,0.64,0.58,0.62,12942,35,137,446
143084,AUGUSTANA COLLEGE,0,1,1995,Inf,0,605,352,253,394,151,243,0.6900000000000001,0.6,0.65,14064,40,131,549
143084,AUGUSTANA COLLEGE,0,1,1996,Inf,0,574,345,229,397,153,244,0.7000000000000001,0.67,0.69,14700,43,135,521
143084,AUGUSTANA COLLEGE,0,1,1997,Inf,0,564,328,236,400,146,254,0.77,0.62,0.71,15300,38,145,507
143084,AUGUSTANA COLLEGE,0,1,1998,Inf,0,567,321,246,389,148,241,0.75,0.6,0.69,16323,39,147,527
143084,AUGUSTANA COLLEGE,0,1,1999,Inf,0,565,338,227,402,161,241,0.71,0.71,0.71,16866,43,139,517
143084,AUGUSTANA COLLEGE,0,1,2000,Inf,0,610,359,251,443,172,271,0.75,0.69,0.73,17541,44,140,564
143084,AUGUSTANA COLLEGE,0,1,2001,Inf,0,550,310,240,392,167,225,0.72,0.7,0.71,18330,45,142,511
143084,AUGUSTANA COLLEGE,0,1,2002,Inf,0,601,349,252,417,158,259,0.74,0.63,0.69,19200,47,142,565
143084,AUGUSTANA COLLEGE,0,1,2003,Inf,0,614,369,245,443,153,290,0.78,0.62,0.72,20397,50,145,558
143084,AUGUSTANA COLLEGE,0,1,2004,Inf,0,599,321,278,426,178,248,0.77,0.64,0.71,21672,51,144,547
143084,Augustana College,0,1,2005,Inf,0,679,383,296,474,193,281,0.73,0.65,0.7,22971,54,149,614
143084,Augustana College,0,1,2006,Inf,0,692,392,300,505,216,289,0.73,0.72,0.73,24408,58,164,625
143084,Augustana College,0,1,2007,Inf,0,713,418,295,525,199,326,0.77,0.67,0.74,25935,61,173,576
143084,Augustana College,0,1,2008,Inf,0,640,369,271,454,179,275,0.74,0.66,0.71,30150,66,180,468
143084,Augustana College,0,1,2009,Inf,0,616,342,274,434,168,266,0.77,0.61,0.7,31326,75,174,512
143084,Augustana College,0,1,2010,Inf,0,753,432,321,532,206,326,0.75,0.64,0.71,32235,66,184,616
143288,BLACKBURN COLLEGE,1,0,1991,NA,NA,116,44,72,23,6,17,0.38,0.08,0.2,7750,6,35,91
143288,BLACKBURN COLLEGE,1,0,1992,NA,NA,148,74,74,52,17,35,0.47000000000000003,0.23,0.35,7750,5,32,122
143288,BLACKBURN COLLEGE,1,0,1993,NA,NA,156,76,80,42,15,27,0.35000000000000003,0.19,0.27,7820,5,25,132
143288,BLACKBURN COLLEGE,1,0,1995,NA,NA,157,66,91,37,17,20,0.3,0.19,0.24,6500,5,27,142
143288,BLACKBURN COLLEGE,1,0,1996,NA,NA,142,72,70,35,13,22,0.3,0.19,0.25,6850,6,28,120
143288,BLACKBURN COLLEGE,1,0,1997,NA,NA,155,81,74,39,11,28,0.34,0.15,0.25,7425,52,29,135
143288,BLACKBURN COLLEGE,1,0,1998,NA,NA,144,66,78,37,16,21,0.31,0.21,0.26,7880,5,27,123
143288,BLACKBURN COLLEGE,1,0,1999,NA,NA,145,76,69,44,21,23,0.3,0.3,0.3,7950,4,31,130
143288,BLACKBURN COLLEGE,1,0,2000,NA,NA,191,107,84,56,18,38,0.35000000000000003,0.21,0.29,8190,7,32,158
143288,BLACKBURN COLLEGE,1,0,2001,NA,NA,162,95,67,60,18,42,0.44,0.27,0.37,8600,9,33,120
143288,BLACKBURN COLLEGE,1,0,2002,NA,NA,147,75,72,44,16,28,0.37,0.22,0.3,9200,9,35,115
143288,BLACKBURN COLLEGE,1,0,2003,NA,NA,176,82,94,49,19,30,0.36,0.2,0.28,9890,9,35,140
143288,BLACKBURN COLLEGE,1,0,2004,NA,NA,176,87,89,55,23,32,0.36,0.26,0.31,14600,8,35,146
143288,Blackburn College,1,0,2005,NA,NA,183,92,91,66,30,36,0.39,0.33,0.36,15040,10,34,164
143288,Blackburn College,1,0,2006,NA,NA,177,111,66,63,17,46,0.41000000000000003,0.26,0.36,15700,11,35,148
143288,Blackburn College,1,0,2007,NA,NA,175,93,82,59,23,36,0.38,0.28,0.34,15770,11,33,148
143288,Blackburn College,1,0,2008,NA,NA,171,94,77,52,18,34,0.36,0.23,0.3,13500,11,32,149
143288,Blackburn College,1,0,2009,NA,NA,146,93,53,46,18,28,0.3,0.34,0.32,14176,11,36,128
143288,Blackburn College,1,0,2010,NA,NA,150,105,45,46,9,37,0.35000000000000003,0.2,0.31,14176,11,36,119
144005,CHICAGO STATE UNIVERSITY,1,0,1991,NA,NA,614,414,200,7,3,4,0,0.01,0.01,1784,47,293,6
144005,CHICAGO STATE UNIVERSITY,1,0,1992,NA,NA,576,351,225,3,2,1,0,0.01,0.01,1868,49,308,7
144005,CHICAGO STATE UNIVERSITY,1,0,1993,NA,NA,641,432,209,7,1,6,0.01,0,0.01,2198,54,351,8
144005,CHICAGO STATE UNIVERSITY,1,0,1995,NA,NA,613,410,203,35,3,32,0.07,0.01,0.06,2336,62,339,12
144005,CHICAGO STATE UNIVERSITY,1,0,1996,NA,NA,563,409,154,17,4,13,0.03,0.03,0.03,2420,71,356,7
144005,CHICAGO STATE UNIVERSITY,1,0,1997,NA,NA,487,332,155,6,1,5,0.01,0.01,0.01,2496,75,362,5
144005,CHICAGO STATE UNIVERSITY,1,0,1998,NA,NA,601,399,202,10,3,7,0.01,0.01,0.02,2868,83,355,9
144005,CHICAGO STATE UNIVERSITY,1,0,1999,NA,NA,461,329,132,9,3,6,0.01,0.02,0.02,2290,86,329,8
144005,CHICAGO STATE UNIVERSITY,1,0,2000,NA,NA,345,232,113,10,5,5,0.02,0.04,0.03,2364,95,329,12
144005,CHICAGO STATE UNIVERSITY,1,0,2001,NA,NA,395,280,115,16,3,13,0.04,0.03,0.04,2484,99,329,9
144005,CHICAGO STATE UNIVERSITY,1,0,2002,NA,NA,438,302,136,11,2,9,0.02,0.01,0.03,2732,99,322,12
144005,CHICAGO STATE UNIVERSITY,1,0,2003,NA,NA,476,336,140,12,4,8,0.02,0.03,0.03,3168,94,309,13
144005,CHICAGO STATE UNIVERSITY,1,0,2004,NA,NA,563,367,196,17,13,4,0.01,0.07,0.03,4575,122,305,12
144005,Chicago State University,1,0,2005,NA,NA,405,268,137,15,4,11,0.04,0.03,0.04,4890,101,306,8
144005,Chicago State University,1,0,2006,NA,NA,359,254,105,16,2,14,0.05,0.02,0.04,5090,107,301,9
144005,Chicago State University,1,0,2007,NA,NA,372,255,117,15,4,11,0.04,0.03,0.04,5440,117,310,9
144005,Chicago State University,1,0,2008,NA,NA,402,279,123,10,4,6,0.02,0.03,0.02,5914,128,303,6
144005,Chicago State University,1,0,2009,NA,NA,589,428,161,13,6,7,0.01,0.04,0.02,5976,131,310,12
144005,Chicago State University,1,0,2010,NA,NA,523,354,169,14,2,12,0.03,0.01,0.03,6145,134,289,9
144281,COLUMBIA COLLEGE,1,0,1991,NA,NA,846,439,407,21,8,13,0.02,0.02,0.02,6296,46,157,384
144281,COLUMBIA COLLEGE,1,0,1992,NA,NA,760,373,387,90,42,48,0.12,0.11,0.12,6664,51,165,378
144281,COLUMBIA COLLEGE,1,0,1993,NA,NA,817,398,419,95,34,61,0.15,0.08,0.12,6928,54,171,409
144281,COLUMBIA COLLEGE,1,0,1995,NA,NA,939,464,475,131,67,64,0.13,0.14,0.14,7670,64,191,489
144281,COLUMBIA COLLEGE,1,0,1996,NA,NA,868,411,457,130,52,78,0.18,0.11,0.15,8030,69,196,484
144281,COLUMBIA COLLEGE CHICAGO,1,0,1997,NA,NA,1078,519,559,147,61,86,0.16,0.11,0.14,8498,59,187,552
144281,COLUMBIA COLLEGE CHICAGO,1,0,1998,NA,NA,1210,588,622,229,108,121,0.2,0.17,0.19,9544,67,209,649
144281,COLUMBIA COLLEGE CHICAGO,1,0,1999,NA,NA,1134,560,574,225,103,122,0.21,0.18,0.2,10690,74,246,572
144281,COLUMBIA COLLEGE CHICAGO,1,0,2000,NA,NA,1265,640,625,330,139,191,0.29,0.22,0.26,11600,86,263,675
144281,COLUMBIA COLLEGE CHICAGO,1,0,2001,NA,NA,1448,767,681,353,157,196,0.25,0.23,0.24,12524,97,281,811
144281,COLUMBIA COLLEGE CHICAGO,1,0,2002,NA,NA,1589,854,735,401,164,237,0.27,0.22,0.25,13714,107,288,944
144281,COLUMBIA COLLEGE CHICAGO,1,0,2003,NA,NA,1446,777,669,389,166,223,0.28,0.25,0.27,14880,123,293,860
144281,COLUMBIA COLLEGE CHICAGO,1,0,2004,NA,NA,1744,873,871,449,217,232,0.26,0.25,0.26,14880,129,299,1030
144281,Columbia College Chicago,1,0,2005,NA,NA,1795,933,862,504,219,285,0.3,0.25,0.28,15588,150,302,1148
144281,Columbia College Chicago,1,0,2006,NA,NA,1972,1025,947,547,247,300,0.29,0.26,0.28,16328,168,316,1229
144281,Columbia College Chicago,1,0,2007,NA,NA,2166,1148,1018,692,313,379,0.33,0.31,0.32,17104,185,323,1344
144281,Columbia College Chicago,1,0,2008,NA,NA,2329,1289,1040,690,277,413,0.32,0.27,0.3,17950,208,342,1376
144281,Columbia College Chicago,1,0,2009,NA,NA,2089,1170,919,616,241,375,0.32,0.26,0.29,18490,222,354,1173
144281,Columbia College-Chicago,1,0,2010,NA,NA,2209,1252,957,665,258,407,0.32,0.27,0.3,19140,228,364,1278
144740,DEPAUL UNIVERSITY,0,1,1991,Inf,0,1047,593,454,388,147,241,0.4,0.32,0.37,9342,128,470,748
144740,DEPAUL UNIVERSITY,0,1,1992,Inf,0,927,520,407,350,119,231,0.44,0.29,0.38,10014,142,494,671
144740,DEPAUL UNIVERSITY,0,1,1993,Inf,0,1182,701,481,416,159,257,0.36,0.33,0.35,10590,151,500,832
144740,DEPAUL UNIVERSITY,0,1,1995,Inf,0,1225,700,525,447,177,270,0.38,0.34,0.36,11856,169,500,861
144740,DEPAUL UNIVERSITY,0,1,1996,Inf,0,1122,668,454,483,184,299,0.44,0.41,0.43,12780,192,515,752
144740,DEPAUL UNIVERSITY,0,1,1997,Inf,0,1211,713,498,566,212,354,0.49,0.43,0.47,13490,187,519,777
144740,DEPAUL UNIVERSITY,0,1,1998,Inf,0,1448,852,596,591,216,375,0.44,0.36,0.41,14100,201,532,903
144740,DEPAUL UNIVERSITY,0,1,1999,Inf,0,1700,997,703,771,299,472,0.47000000000000003,0.43,0.45,14670,218,581,1037
144740,DEPAUL UNIVERSITY,0,1,2000,Inf,0,1897,1140,757,852,308,544,0.47000000000000003,0.41,0.45,15390,242,647,1232
144740,DEPAUL UNIVERSITY,0,1,2001,Inf,0,2042,1180,862,866,325,541,0.45,0.38,0.42,16500,272,714,1242
144740,DEPAUL UNIVERSITY,0,1,2002,Inf,0,2231,1323,908,985,346,639,0.48,0.38,0.44,17820,315,775,1271
144740,DEPAUL UNIVERSITY,0,1,2003,Inf,0,2249,1351,898,966,341,625,0.46,0.38,0.43,20555,338,832,1381
144740,DEPAUL UNIVERSITY,0,1,2004,Inf,0,2304,1367,937,1097,377,720,0.52,0.4,0.48,21669,354,839,1425
144740,DePaul University,0,1,2005,Inf,0,2392,1411,981,1168,450,718,0.5,0.46,0.49,22789,343,834,1566
144740,DePaul University,0,1,2006,Inf,0,2531,1428,1103,1280,482,798,0.55,0.44,0.51,22365,352,850,1652
144740,DePaul University,0,1,2007,Inf,0,2513,1458,1055,1363,522,841,0.5700000000000001,0.49,0.54,23820,367,870,1580
144740,DePaul University,0,1,2008,Inf,0,2553,1502,1051,1430,537,893,0.59,0.51,0.56,25770,401,899,1574
144740,DePaul University,0,1,2009,Inf,0,2523,1494,1029,1425,538,887,0.59,0.52,0.56,26765,434,919,1412
144740,DePaul University,0,1,2010,Inf,0,2235,1307,928,1313,501,812,0.62,0.54,0.59,28240,462,938,1337
144892,EASTERN ILLINOIS UNIVERSITY,1,0,1991,NA,NA,1493,911,582,577,185,392,0.43,0.32,0.39,2358,99,555,1342
144892,EASTERN ILLINOIS UNIVERSITY,1,0,1992,NA,NA,1463,893,570,464,132,332,0.37,0.23,0.32,2533,98,564,1309
144892,EASTERN ILLINOIS UNIVERSITY,1,0,1993,NA,NA,1612,969,643,471,112,359,0.37,0.17,0.29,2600,99,562,1457
144892,EASTERN ILLINOIS UNIVERSITY,1,0,1995,NA,NA,1538,973,565,468,117,351,0.36,0.21,0.3,2777,110,578,1349
144892,EASTERN ILLINOIS UNIVERSITY,1,0,1996,NA,NA,1640,1000,640,505,126,379,0.37,0.2,0.31,2905,113,572,1451
144892,EASTERN ILLINOIS UNIVERSITY,1,0,1997,NA,NA,1552,950,602,479,121,358,0.37,0.2,0.31,3078,121,579,1373
144892,EASTERN ILLINOIS UNIVERSITY,1,0,1998,NA,NA,1604,984,620,547,148,399,0.4,0.24,0.34,3232,128,568,1418
144892,EASTERN ILLINOIS UNIVERSITY,1,0,1999,NA,NA,1478,929,549,482,131,351,0.37,0.24,0.33,2254,136,558,1277
144892,EASTERN ILLINOIS UNIVERSITY,1,0,2000,NA,NA,1495,870,625,471,151,320,0.36,0.24,0.32,2910,144,531,1294
144892,EASTERN ILLINOIS UNIVERSITY,1,0,2001,NA,NA,1431,836,595,445,135,310,0.37,0.23,0.31,2993,153,505,1216
144892,EASTERN ILLINOIS UNIVERSITY,1,0,2002,NA,NA,1984,1143,841,582,183,399,0.34,0.22,0.29,3254,153,554,1714
144892,EASTERN ILLINOIS UNIVERSITY,1,0,2003,NA,NA,1892,1098,794,563,185,378,0.34,0.23,0.3,3563,154,565,1682
144892,EASTERN ILLINOIS UNIVERSITY,1,0,2004,NA,NA,1725,1032,693,594,177,417,0.4,0.26,0.34,3830,202,599,1524
144892,Eastern Illinois University,1,0,2005,NA,NA,1645,967,678,521,168,353,0.36,0.25,0.32,4629,178,605,1286
144892,Eastern Illinois University,1,0,2006,NA,NA,1760,1062,698,583,164,419,0.39,0.23,0.33,5207,183,609,1399
144892,Eastern Illinois University,1,0,2007,NA,NA,1641,988,653,551,171,380,0.38,0.26,0.34,5832,196,622,1259
144892,Eastern Illinois University,1,0,2008,NA,NA,1764,1029,735,582,196,386,0.37,0.27,0.33,6540,207,643,1333
144892,Eastern Illinois University,1,0,2009,NA,NA,1637,997,640,520,178,342,0.34,0.28,0.32,7170,220,630,1181
144892,Eastern Illinois University,1,0,2010,NA,NA,1446,892,554,492,157,335,0.37,0.28,0.34,6835,236,617,1039
144962,ELMHURST COLLEGE,1,0,1991,NA,NA,247,130,117,99,38,61,0.46,0.32,0.4,8460,24,97,199
144962,ELMHURST COLLEGE,1,0,1992,NA,NA,229,128,101,92,29,63,0.49,0.29,0.4,9050,25,99,175
144962,ELMHURST COLLEGE,1,0,1993,NA,NA,252,140,112,99,41,58,0.41000000000000003,0.37,0.39,9676,25,97,191
144962,ELMHURST COLLEGE,1,0,1995,NA,NA,253,147,106,128,41,87,0.59,0.39,0.51,10264,29,96,195
144962,ELMHURST COLLEGE,1,0,1996,NA,NA,222,137,85,130,49,81,0.59,0.58,0.59,10976,32,99,181
144962,ELMHURST COLLEGE,1,0,1997,NA,NA,289,155,134,2,1,1,0,0.01,0.01,11900,28,101,230
144962,ELMHURST COLLEGE,1,0,1998,NA,NA,266,152,114,154,51,103,0.67,0.45,0.58,12870,31,106,211
144962,ELMHURST COLLEGE,1,0,1999,NA,NA,269,156,113,158,58,100,0.64,0.51,0.59,13900,32,109,220
144962,ELMHURST COLLEGE,1,0,2000,NA,NA,301,185,116,183,50,133,0.71,0.43,0.61,15000,36,110,237
144962,ELMHURST COLLEGE,1,0,2001,NA,NA,302,169,133,153,47,106,0.62,0.35,0.51,16200,37,112,222
144962,ELMHURST COLLEGE,1,0,2002,NA,NA,295,185,110,157,41,116,0.62,0.37,0.53,17500,38,113,243
144962,ELMHURST COLLEGE,1,0,2003,NA,NA,366,230,136,194,54,140,0.6,0.4,0.53,18600,39,110,279
144962,ELMHURST COLLEGE,1,0,2004,NA,NA,386,225,161,215,66,149,0.66,0.41,0.56,20090,40,108,300
144962,Elmhurst College,1,0,2005,NA,NA,466,282,184,252,84,168,0.59,0.46,0.54,21600,43,121,364
144962,Elmhurst College,1,0,2006,NA,NA,484,296,188,275,100,175,0.59,0.53,0.57,23100,49,124,380
144962,Elmhurst College,1,0,2007,NA,NA,508,304,204,300,99,201,0.66,0.49,0.59,24600,53,129,394
144962,Elmhurst College,1,0,2008,NA,NA,576,348,228,350,113,237,0.68,0.5,0.61,26000,57,141,453
144962,Elmhurst College,1,0,2009,NA,NA,584,341,243,317,106,211,0.61,0.44,0.54,27270,65,144,435
144962,Elmhurst College,1,0,2010,NA,NA,537,330,207,301,99,202,0.61,0.48,0.56,28600,66,145,436
144971,EUREKA COLLEGE,1,0,1991,NA,NA,129,70,59,54,21,33,0.47000000000000003,0.36,0.42,9425,7,39,112
144971,EUREKA COLLEGE,1,0,1992,NA,NA,119,60,59,53,22,31,0.51,0.37,0.45,10325,9,37,110
144971,EUREKA COLLEGE,1,0,1993,NA,NA,109,45,64,50,26,24,0.53,0.41,0.46,11105,9,37,96
144971,EUREKA COLLEGE,1,0,1995,NA,NA,139,58,81,68,35,33,0.56,0.43,0.49,12505,9,36,129
144971,EUREKA COLLEGE,1,0,1996,NA,NA,128,67,61,55,19,36,0.53,0.31,0.43,13216,9,37,118
144971,EUREKA COLLEGE,1,0,1997,NA,NA,141,50,91,54,25,29,0.58,0.27,0.38,13950,8,40,135
144971,EUREKA COLLEGE,1,0,1998,NA,NA,114,57,57,65,31,34,0.59,0.54,0.57,14790,9,44,105
144971,EUREKA COLLEGE,1,0,1999,NA,NA,130,76,54,60,19,41,0.53,0.35,0.46,15200,9,43,119
144971,EUREKA COLLEGE,1,0,2000,NA,NA,121,72,49,49,17,32,0.44,0.35,0.4,15850,9,45,102
144971,EUREKA COLLEGE,1,0,2001,NA,NA,146,75,71,60,26,34,0.45,0.37,0.41,16600,10,47,125
144971,EUREKA COLLEGE,1,0,2002,NA,NA,136,70,66,50,16,34,0.48,0.24,0.37,17430,10,42,106
144971,EUREKA COLLEGE,1,0,2003,NA,NA,92,44,48,15,5,10,0.22,0.1,0.16,18700,10,43,79
144971,EUREKA COLLEGE,1,0,2004,NA,NA,116,57,59,35,15,20,0.35000000000000003,0.25,0.3,13000,10,44,97
144971,Eureka College,1,0,2005,NA,NA,138,74,64,66,29,37,0.5,0.45,0.48,13000,10,42,120
144971,Eureka College,1,0,2006,NA,NA,137,74,63,54,26,28,0.37,0.41,0.39,13760,11,43,120
144971,Eureka College,1,0,2007,NA,NA,122,73,49,53,15,38,0.52,0.31,0.43,14800,11,36,112
144971,Eureka College,1,0,2008,NA,NA,153,75,78,53,18,35,0.46,0.23,0.35,15675,12,44,125
144971,Eureka College,1,0,2009,NA,NA,143,75,68,55,23,32,0.42,0.34,0.38,16650,14,42,125
144971,Eureka College,1,0,2010,NA,NA,174,92,82,70,30,40,0.43,0.37,0.4,17275,14,43,148
145600,UNIVERSITY OF ILLINOIS AT CHICAGO,1,0,1991,NA,NA,2356,1233,1123,197,83,114,0.09,0.07,0.08,3077,698,1126,960
145600,UNIVERSITY OF ILLINOIS AT CHICAGO,1,0,1992,NA,NA,2475,1273,1202,240,95,145,0.11,0.08,0.1,3371,732,1144,995
145600,UNIVERSITY OF ILLINOIS AT CHICAGO,1,0,1993,NA,NA,2589,1360,1229,229,85,144,0.1,0.07,0.09,3439,817,1135,1022
145600,UNIVERSITY OF ILLINOIS AT CHICAGO,1,0,1995,NA,NA,2469,1401,1068,309,110,199,0.14,0.1,0.13,3974,931,1152,1024
145600,UNIVERSITY OF ILLINOIS AT CHICAGO,1,0,1996,NA,NA,2720,1505,1215,454,179,275,0.18,0.15,0.17,4188,955,1163,1176
145600,UNIVERSITY OF ILLINOIS AT CHICAGO,1,0,1997,NA,NA,2820,1560,1260,460,165,295,0.18,0.13,0.16,4358,983,1087,1107
145600,UNIVERSITY OF ILLINOIS AT CHICAGO,1,0,1998,NA,NA,2880,1629,1251,465,166,299,0.18,0.13,0.16,4498,1011,1088,1143
145600,UNIVERSITY OF ILLINOIS AT CHICAGO,1,0,1999,NA,NA,2552,1381,1171,506,215,291,0.21,0.18,0.2,3138,1064,1043,1039
145600,UNIVERSITY OF ILLINOIS AT CHICAGO,1,0,2000,NA,NA,2762,1557,1205,588,203,385,0.24,0.17,0.21,3232,1153,1169,1069
145600,UNIVERSITY OF ILLINOIS AT CHICAGO,1,0,2001,NA,NA,2637,1470,1167,590,210,380,0.25,0.18,0.22,3830,1232,1295,1084
145600,UNIVERSITY OF ILLINOIS AT CHICAGO,1,0,2002,NA,NA,2952,1674,1278,607,248,359,0.21,0.19,0.21,4664,1430,1271,1179
145600,UNIVERSITY OF ILLINOIS AT CHICAGO,1,0,2003,NA,NA,2880,1573,1307,702,275,427,0.27,0.21,0.24,4898,1530,1237,1095
145600,UNIVERSITY OF ILLINOIS AT CHICAGO,1,0,2004,NA,NA,2671,1488,1183,681,278,403,0.27,0.23,0.25,5682,1818,1236,983
145600,University of Illinois at Chicago,1,0,2005,NA,NA,2759,1534,1225,742,294,448,0.29,0.24,0.27,6194,1682,1182,1009
145600,University of Illinois at Chicago,1,0,2006,NA,NA,2830,1554,1276,878,380,498,0.32,0.3,0.31,6780,1744,1202,1153
145600,University of Illinois at Chicago,1,0,2007,NA,NA,3272,1813,1459,978,390,588,0.32,0.27,0.3,7424,1827,1212,1335
145600,University of Illinois at Chicago,1,0,2008,NA,NA,2944,1659,1285,981,392,589,0.35000000000000003,0.31,0.33,8130,1981,1239,1178
145600,University of Illinois at Chicago,1,0,2009,NA,NA,3126,1680,1446,1056,411,645,0.38,0.28,0.34,8342,2072,1199,1209
145600,University of Illinois at Chicago,1,0,2010,NA,NA,3185,1731,1454,984,387,597,0.34,0.27,0.31,9133,2111,1185,1191
145619,ILLINOIS BENEDICTINE COLLEGE,1,0,1991,NA,NA,246,117,129,87,37,50,0.42,0.29,0.35,8980,19,88,165
145619,ILLINOIS BENEDICTINE COLLEGE,1,0,1992,NA,NA,230,110,120,102,43,59,0.53,0.36,0.44,9300,22,88,159
145619,ILLINOIS BENEDICTINE COLLEGE,1,0,1993,NA,NA,270,125,145,104,43,61,0.48,0.3,0.39,9950,24,91,205
145619,BENEDICTINE UNIVERSITY,1,0,1995,NA,NA,245,123,122,95,38,57,0.46,0.31,0.39,11030,28,85,160
145619,BENEDICTINE UNIVERSITY,1,0,1996,NA,NA,231,112,119,82,30,52,0.46,0.25,0.35,11790,29,87,141
145619,BENEDICTINE UNIVERSITY,1,0,1997,NA,NA,300,129,171,117,56,61,0.47000000000000003,0.33,0.39,11990,23,85,191
145619,BENEDICTINE UNIVERSITY,1,0,1998,NA,NA,299,160,139,93,35,58,0.36,0.25,0.31,12600,27,84,173
145619,BENEDICTINE UNIVERSITY,1,0,1999,NA,NA,259,127,132,74,30,44,0.34,0.23,0.29,13700,31,84,145
145619,BENEDICTINE UNIVERSITY,1,0,2000,NA,NA,278,156,122,114,45,69,0.44,0.37,0.41,14500,29,90,103
145619,BENEDICTINE UNIVERSITY,1,0,2001,NA,NA,262,159,103,120,41,79,0.49,0.4,0.46,15200,32,96,125
145619,BENEDICTINE UNIVERSITY,1,0,2002,NA,NA,303,165,138,150,56,94,0.56,0.41,0.5,16250,34,96,161
145619,BENEDICTINE UNIVERSITY,1,0,2003,NA,NA,302,169,133,116,49,67,0.39,0.37,0.38,16960,35,96,137
145619,BENEDICTINE UNIVERSITY,1,0,2004,NA,NA,301,151,150,121,53,68,0.45,0.35,0.4,17800,37,91,125
145619,Benedictine University,1,0,2005,NA,NA,308,163,145,97,42,55,0.33,0.29,0.31,18700,40,88,98
145619,Benedictine University,1,0,2006,NA,NA,379,189,190,139,57,82,0.43,0.3,0.37,19800,43,89,167
145619,Benedictine University,1,0,2007,NA,NA,385,185,200,146,68,78,0.42,0.34,0.38,20800,47,93,159
145619,Benedictine University,1,0,2008,NA,NA,434,227,207,141,57,84,0.37,0.28,0.32,21600,51,101,142
145619,Benedictine University,1,0,2009,NA,NA,451,215,236,156,68,88,0.4,0.29,0.35,21600,58,104,169
145619,Benedictine University,1,0,2010,NA,NA,548,311,237,197,63,134,0.43,0.27,0.36,22500,63,108,190
145637,UNIVERSITY OF ILLINOIS URBANA CAMPUS,1,0,1991,NA,NA,5649,2615,3034,2770,1300,1470,0.56,0.43,0.49,3184,768,1937,4125
145637,UNIVERSITY OF ILLINOIS URBANA CAMPUS,1,0,1992,NA,NA,5491,2566,2925,2656,1267,1389,0.54,0.43,0.48,3458,771,1905,3918
145637,UNIVERSITY OF ILLINOIS AT URBANA,1,0,1993,NA,NA,5705,2588,3117,2665,1307,1358,0.52,0.42,0.47,3506,805,1868,4068
145637,UNIVERSITY OF ILLINOIS AT URBANA,1,0,1995,NA,NA,6101,2944,3157,3312,1492,1820,0.61,0.47,0.54,3958,863,1831,4379
145637,UNIVERSITY OF ILLINOIS AT URBANA,1,0,1996,NA,NA,5938,2865,3073,3321,1507,1814,0.63,0.49,0.56,4153,872,1855,4184
145637,UNIVERSITY OF ILLINOIS AT URBANA,1,0,1997,NA,NA,5789,2865,2924,3331,1523,1808,0.63,0.52,0.58,4340,919,1765,4051
145637,UNIVERSITY OF ILLINOIS AT URBANA,1,0,1998,NA,NA,6453,3174,3279,3729,1680,2049,0.64,0.51,0.58,4554,967,1730,4500
145637,UNIVERSITY OF ILLINOIS AT URBANA,1,0,1999,NA,NA,6458,3131,3327,3849,1733,2116,0.67,0.52,0.6,3546,1011,1759,4521
145637,UNIVERSITY OF ILLINOIS AT URBANA-CHAMPAIGN,1,0,2000,NA,NA,6167,2990,3177,3737,1692,2045,0.68,0.53,0.61,3724,1063,2019,4241
145637,UNIVERSITY OF ILLINOIS AT URBANA-CHAMPAIGN,1,0,2001,NA,NA,6234,3008,3226,3886,1789,2097,0.6900000000000001,0.55,0.62,4410,1121,2280,4149
145637,UNIVERSITY OF ILLINOIS AT URBANA-CHAMPAIGN,1,0,2002,NA,NA,6354,3120,3234,4027,1814,2213,0.7000000000000001,0.56,0.63,5302,1342,2259,4322
145637,UNIVERSITY OF ILLINOIS AT URBANA-CHAMPAIGN,1,0,2003,NA,NA,6807,3268,3539,4390,2070,2320,0.7000000000000001,0.58,0.64,5568,1470,2229,4543
145637,UNIVERSITY OF ILLINOIS AT URBANA-CHAMPAIGN,1,0,2004,NA,NA,7225,3555,3670,4848,2215,2633,0.74,0.6,0.67,6460,1809,2205,4897
145637,University of Illinois at Urbana-Champaign,1,0,2005,NA,NA,7565,3511,4054,4966,2375,2591,0.73,0.59,0.66,7042,1654,2124,5099
145637,University of Illinois at Urbana-Champaign,1,0,2006,NA,NA,7152,3518,3634,4881,2256,2625,0.74,0.62,0.68,7708,1719,2184,4656
145637,University of Illinois at Urbana-Champaign,1,0,2007,NA,NA,6930,3295,3635,4722,2281,2441,0.74,0.63,0.68,8440,1775,2193,4412
145637,University of Illinois at Urbana-Champaign,1,0,2008,NA,NA,7277,3386,3891,5015,2439,2576,0.76,0.63,0.69,9242,1894,2203,4416
145637,University of Illinois at Urbana-Champaign,1,0,2009,NA,NA,6974,3332,3642,4938,2317,2621,0.78,0.64,0.71,9484,1966,2204,4310
145637,University of Illinois at Urbana-Champaign,1,0,2010,NA,NA,6921,3054,3867,4823,2414,2409,0.78,0.62,0.7,11003,2047,2112,3940
145691,ILLINOIS COLLEGE,1,0,1991,NA,NA,241,117,124,85,39,46,0.39,0.31,0.35,6600,13,47,232
145691,ILLINOIS COLLEGE,1,0,1992,NA,NA,260,136,124,114,35,79,0.58,0.28,0.44,7050,13,48,255
145691,ILLINOIS COLLEGE,1,0,1993,NA,NA,261,150,111,113,34,79,0.52,0.31,0.43,7550,13,51,253
145691,ILLINOIS COLLEGE,1,0,1995,NA,NA,223,139,84,98,30,68,0.48,0.36,0.44,8600,16,52,216
145691,ILLINOIS COLLEGE,1,0,1996,NA,NA,200,123,77,87,22,65,0.52,0.29,0.44,9150,18,53,191
145691,ILLINOIS COLLEGE,1,0,1997,NA,NA,242,148,94,102,30,72,0.48,0.32,0.42,9500,15,54,230
145691,ILLINOIS COLLEGE,1,0,1998,NA,NA,238,133,105,107,37,70,0.52,0.35,0.45,9850,13,55,224
145691,ILLINOIS COLLEGE,1,0,1999,NA,NA,241,131,110,97,34,63,0.48,0.31,0.4,10200,13,55,224
145691,ILLINOIS COLLEGE,1,0,2000,NA,NA,239,128,111,102,32,70,0.54,0.29,0.43,10735,14,55,216
145691,ILLINOIS COLLEGE,1,0,2001,NA,NA,205,113,92,94,37,57,0.5,0.4,0.46,11272,15,56,190
145691,ILLINOIS COLLEGE,1,0,2002,NA,NA,306,170,136,156,60,96,0.56,0.44,0.51,11850,17,57,287
145691,ILLINOIS COLLEGE,1,0,2003,NA,NA,318,180,138,157,59,98,0.54,0.43,0.49,13300,19,61,285
145691,ILLINOIS COLLEGE,1,0,2004,NA,NA,258,136,122,135,49,86,0.63,0.4,0.52,14600,22,74,237
145691,Illinois College,1,0,2005,NA,NA,256,117,139,124,60,64,0.54,0.43,0.48,15500,21,71,232
145691,Illinois College,1,0,2006,NA,NA,293,154,139,148,49,99,0.64,0.35,0.51,16610,23,74,260
145691,Illinois College,1,0,2007,NA,NA,258,125,133,144,58,86,0.68,0.44,0.56,17600,23,72,228
145691,Illinois College,1,0,2008,NA,NA,166,84,82,110,51,59,0.7000000000000001,0.62,0.66,18500,24,75,136
145691,Illinois College,1,0,2009,NA,NA,224,99,125,139,71,68,0.68,0.57,0.62,20900,27,75,191
145691,Illinois College,1,0,2010,NA,NA,225,113,112,134,58,76,0.67,0.52,0.6,22350,25,75,169
145813,ILLINOIS STATE UNIVERSITY,1,0,1991,NA,NA,3055,1757,1298,849,286,563,0.32,0.22,0.28,2430,176,738,2588
145813,ILLINOIS STATE UNIVERSITY,1,0,1992,NA,NA,2898,1706,1192,772,229,543,0.31,0.19,0.27,2871,175,715,2457
145813,ILLINOIS STATE UNIVERSITY,1,0,1993,NA,NA,2387,1440,947,648,183,465,0.32,0.19,0.27,3253,185,720,1915
145813,ILLINOIS STATE UNIVERSITY,1,0,1995,NA,NA,2950,1798,1152,823,240,583,0.32,0.21,0.28,3544,185,772,2460
145813,ILLINOIS STATE UNIVERSITY,1,0,1996,NA,NA,2888,1793,1095,877,245,632,0.35000000000000003,0.22,0.3,3720,215,773,2416
145813,ILLINOIS STATE UNIVERSITY,1,0,1997,NA,NA,3253,1981,1272,1016,297,719,0.36,0.23,0.31,3969,227,784,2723
145813,ILLINOIS STATE UNIVERSITY,1,0,1998,NA,NA,2740,1728,1012,915,268,647,0.37,0.26,0.33,4085,246,807,2281
145813,ILLINOIS STATE UNIVERSITY,1,0,1999,NA,NA,3067,1907,1160,1072,301,771,0.4,0.26,0.35,3127,266,839,2690
145813,ILLINOIS STATE UNIVERSITY,1,0,2000,NA,NA,3254,1996,1258,1204,347,857,0.42,0.28,0.37,3219,272,852,2891
145813,ILLINOIS STATE UNIVERSITY,1,0,2001,NA,NA,3331,2080,1251,1316,364,952,0.45,0.29,0.4,3332,294,865,2943
145813,ILLINOIS STATE UNIVERSITY,1,0,2002,NA,NA,3097,1933,1164,1279,366,913,0.47000000000000003,0.31,0.41,3640,310,799,2763
145813,ILLINOIS STATE UNIVERSITY,1,0,2003,NA,NA,3088,1934,1154,1294,411,883,0.45,0.36,0.42,3640,307,833,2639
145813,ILLINOIS STATE UNIVERSITY,1,0,2004,NA,NA,2824,1739,1085,1280,392,888,0.51,0.36,0.45,4800,370,821,2290
145813,Illinois State University,1,0,2005,NA,NA,3167,1970,1197,1388,419,969,0.49,0.35,0.44,5400,316,820,2541
145813,Illinois State University,1,0,2006,NA,NA,3188,1915,1273,1496,471,1025,0.53,0.37,0.47,6150,332,833,2681
145813,Illinois State University,1,0,2007,NA,NA,3140,1887,1253,1457,455,1002,0.53,0.36,0.46,6999,350,815,2650
145813,Illinois State University,1,0,2008,NA,NA,3387,2088,1299,1545,503,1042,0.49,0.39,0.46,7680,375,834,2838
145813,Illinois State University,1,0,2009,NA,NA,3060,1816,1244,1462,500,962,0.52,0.4,0.48,8280,399,864,2413
145813,Illinois State University,1,0,2010,NA,NA,3179,1914,1265,1512,499,1013,0.52,0.39,0.48,8051,442,852,2591
146481,LAKE FOREST COLLEGE,1,0,1991,NA,NA,234,124,110,123,53,70,0.56,0.48,0.53,13895,22,85,201
146481,LAKE FOREST COLLEGE,1,0,1992,NA,NA,235,123,112,145,66,79,0.64,0.59,0.62,15085,23,82,183
146481,LAKE FOREST COLLEGE,1,0,1993,NA,NA,271,140,131,148,65,83,0.59,0.5,0.55,16175,24,81,224
146481,LAKE FOREST COLLEGE,1,0,1995,NA,NA,266,155,111,156,58,98,0.63,0.52,0.59,18116,27,76,218
146481,LAKE FOREST COLLEGE,1,0,1996,NA,NA,324,152,172,188,90,98,0.64,0.52,0.58,19000,29,76,254
146481,LAKE FOREST COLLEGE,1,0,1997,NA,NA,337,191,146,205,77,128,0.67,0.53,0.61,19560,24,81,264
146481,LAKE FOREST COLLEGE,1,0,1998,NA,NA,302,177,125,167,63,104,0.58,0.5,0.55,20080,25,83,246
146481,LAKE FOREST COLLEGE,1,0,1999,NA,NA,341,208,133,216,80,136,0.65,0.6,0.63,20240,27,76,270
146481,LAKE FOREST COLLEGE,1,0,2000,NA,NA,335,187,148,194,78,116,0.62,0.53,0.58,20900,29,80,282
146481,LAKE FOREST COLLEGE,1,0,2001,NA,NA,336,188,148,214,83,131,0.6900000000000001,0.56,0.64,21896,31,84,256
146481,LAKE FOREST COLLEGE,1,0,2002,NA,NA,358,219,139,213,71,142,0.64,0.51,0.59,22976,32,84,270
146481,LAKE FOREST COLLEGE,1,0,2003,NA,NA,347,194,153,203,86,117,0.6,0.56,0.59,24096,34,84,260
146481,LAKE FOREST COLLEGE,1,0,2004,NA,NA,405,247,158,257,83,174,0.7000000000000001,0.53,0.63,25518,35,86,322
146481,Lake Forest College,1,0,2005,NA,NA,358,202,156,213,78,135,0.66,0.5,0.59,27000,38,92,276
146481,Lake Forest College,1,0,2006,NA,NA,386,224,162,241,96,145,0.64,0.59,0.62,28700,39,89,303
146481,Lake Forest College,1,0,2007,NA,NA,356,214,142,208,75,133,0.62,0.53,0.58,30600,42,90,273
146481,Lake Forest College,1,0,2008,NA,NA,378,218,160,242,85,157,0.72,0.53,0.64,32130,43,91,261
146481,Lake Forest College,1,0,2009,NA,NA,354,213,141,232,81,151,0.7000000000000001,0.57,0.66,33576,43,92,248
146481,Lake Forest College,1,0,2010,NA,NA,402,238,164,258,98,160,0.67,0.6,0.64,34885,44,96,232
146612,LEWIS UNIVERSITY,1,0,1991,NA,NA,387,166,221,122,59,63,0.37,0.27,0.32,8502,26,122,302
146612,LEWIS UNIVERSITY,1,0,1992,NA,NA,345,161,184,84,34,50,0.31,0.18,0.24,9536,29,132,278
146612,LEWIS UNIVERSITY,1,0,1993,NA,NA,344,155,189,109,49,60,0.38,0.26,0.32,10112,32,136,252
146612,LEWIS UNIVERSITY,1,0,1995,NA,NA,331,158,173,104,49,55,0.34,0.28,0.31,11008,39,121,219
146612,LEWIS UNIVERSITY,1,0,1996,NA,NA,312,137,175,120,57,63,0.45,0.33,0.38,11552,41,127,219
146612,LEWIS UNIVERSITY,1,0,1997,NA,NA,386,176,210,145,70,75,0.42,0.33,0.38,12416,46,143,252
146612,LEWIS UNIVERSITY,1,0,1998,NA,NA,391,193,198,151,64,87,0.45,0.32,0.39,13024,37,148,254
146612,LEWIS UNIVERSITY,1,0,1999,NA,NA,425,194,231,171,82,89,0.45,0.35,0.4,13664,54,143,290
146612,LEWIS UNIVERSITY,1,0,2000,NA,NA,427,183,244,127,69,58,0.31,0.28,0.3,14208,59,142,293
146612,LEWIS UNIVERSITY,1,0,2001,NA,NA,384,191,193,126,52,74,0.38,0.27,0.33,14976,63,141,272
146612,LEWIS UNIVERSITY,1,0,2002,NA,NA,366,161,205,132,66,66,0.4,0.32,0.36,15250,66,142,272
146612,LEWIS UNIVERSITY,1,0,2003,NA,NA,458,224,234,179,86,93,0.41000000000000003,0.37,0.39,15950,68,144,321
146612,LEWIS UNIVERSITY,1,0,2004,NA,NA,509,275,234,186,81,105,0.38,0.35,0.37,16906,71,150,369
146612,Lewis University,1,0,2005,NA,NA,557,321,236,232,92,140,0.43,0.39,0.42,17990,77,163,404
146612,Lewis University,1,0,2006,NA,NA,568,323,245,223,94,129,0.39,0.38,0.39,19200,87,169,405
146612,Lewis University,1,0,2007,NA,NA,634,365,269,283,131,152,0.41000000000000003,0.49,0.45,20450,95,179,435
146612,Lewis University,1,0,2008,NA,NA,650,345,305,272,127,145,0.42,0.42,0.42,21990,76,183,435
146612,Lewis University,1,0,2009,NA,NA,653,360,293,288,114,174,0.48,0.39,0.44,22990,80,189,433
146612,Lewis University,1,0,2010,NA,NA,632,319,313,257,126,131,0.41000000000000003,0.4,0.41,23780,98,201,387
146719,LOYOLA UNIVERSITY OF CHICAGO,1,0,1991,NA,NA,922,593,329,347,119,228,0.38,0.36,0.38,9270,561,601,579
146719,LOYOLA UNIVERSITY OF CHICAGO,1,0,1992,NA,NA,985,587,398,377,143,234,0.39,0.36,0.38,9840,635,606,707
146719,LOYOLA UNIVERSITY OF CHICAGO,1,0,1993,NA,NA,856,511,345,366,141,225,0.44,0.41,0.43,10470,662,563,562
146719,LOYOLA UNIVERSITY OF CHICAGO,1,0,1995,NA,NA,1182,733,449,544,167,377,0.51,0.37,0.46,13000,641,536,793
146719,LOYOLA UNIVERSITY OF CHICAGO,1,0,1996,NA,NA,1063,690,373,562,175,387,0.56,0.47,0.53,14400,387,532,677
146719,LOYOLA UNIVERSITY OF CHICAGO,1,0,1997,NA,NA,1189,758,431,558,189,369,0.48,0.44,0.47,15654,361,530,739
146719,LOYOLA UNIVERSITY OF CHICAGO,1,0,1998,NA,NA,1340,868,472,641,208,433,0.49,0.44,0.48,16600,297,535,819
146719,LOYOLA UNIVERSITY CHICAGO,1,0,1999,NA,NA,1067,717,350,541,169,372,0.51,0.48,0.51,17750,326,522,638
146719,LOYOLA UNIVERSITY CHICAGO,1,0,2000,NA,NA,889,585,304,542,164,378,0.64,0.54,0.61,18266,315,494,566
146719,LOYOLA UNIVERSITY CHICAGO,1,0,2001,NA,NA,1424,960,464,674,202,472,0.49,0.44,0.47,18814,317,466,875
146719,LOYOLA UNIVERSITY CHICAGO,1,0,2002,NA,NA,1623,1069,554,821,261,560,0.52,0.47,0.51,19472,316,442,1005
146719,LOYOLA UNIVERSITY CHICAGO,1,0,2003,NA,NA,1915,1292,623,924,296,628,0.48,0.48,0.48,20544,309,524,1172
146719,LOYOLA UNIVERSITY CHICAGO,1,0,2004,NA,NA,1787,1176,611,856,296,560,0.47000000000000003,0.48,0.48,21780,310,502,1101
146719,Loyola University Chicago,1,0,2005,NA,NA,2080,1365,715,1053,346,707,0.51,0.48,0.51,23500,327,523,1316
146719,Loyola University Chicago,1,0,2006,NA,NA,2134,1426,708,1104,357,747,0.52,0.5,0.52,24580,354,550,1381
146719,Loyola University Chicago,1,0,2007,NA,NA,2035,1377,658,1215,371,844,0.61,0.56,0.6,27200,375,582,1349
146719,Loyola University Chicago,1,0,2008,NA,NA,2176,1460,716,1419,448,971,0.66,0.63,0.65,28700,410,597,1541
146719,Loyola University Chicago,1,0,2009,NA,NA,2076,1358,718,1323,434,889,0.65,0.6,0.64,29850,421,629,1410
146719,Loyola University-Chicago,1,0,2010,NA,NA,2063,1315,748,1342,444,898,0.68,0.59,0.65,31040,402,658,1400
146825,MACMURRAY COLLEGE,1,0,1991,NA,NA,185,89,96,83,28,55,0.61,0.29,0.45,8150,12,66,160
146825,MACMURRAY COLLEGE,1,0,1992,NA,NA,171,84,87,67,23,44,0.52,0.26,0.39,8620,13,69,155
146825,MACMURRAY COLLEGE,1,0,1993,NA,NA,151,72,79,64,21,43,0.59,0.27,0.42,9160,14,69,130
146825,MACMURRAY COLLEGE,1,0,1995,NA,NA,175,75,100,50,12,38,0.5,0.12,0.29,10190,15,66,156
146825,MACMURRAY COLLEGE,1,0,1996,NA,NA,156,90,66,54,15,39,0.43,0.23,0.35,10940,14,64,134
146825,MACMURRAY COLLEGE,1,0,1997,NA,NA,127,49,78,47,24,23,0.46,0.31,0.37,11400,13,66,109
146825,MACMURRAY COLLEGE,1,0,1998,NA,NA,163,79,84,59,22,37,0.46,0.26,0.36,11820,14,72,142
146825,MACMURRAY COLLEGE,1,0,1999,NA,NA,187,80,107,55,25,30,0.37,0.23,0.29,12300,13,56,138
146825,MACMURRAY COLLEGE,1,0,2000,NA,NA,199,97,102,55,20,35,0.36,0.2,0.28,13140,13,53,158
146825,MACMURRAY COLLEGE,1,0,2001,NA,NA,144,65,79,37,14,23,0.35000000000000003,0.18,0.26,14000,15,51,107
146825,MACMURRAY COLLEGE,1,0,2002,NA,NA,127,72,55,46,14,32,0.44,0.25,0.36,14500,13,45,103
146825,MACMURRAY COLLEGE,1,0,2003,NA,NA,162,79,83,48,17,31,0.39,0.2,0.3,14500,12,40,113
146825,MACMURRAY COLLEGE,1,0,2004,NA,NA,152,74,78,37,17,20,0.27,0.22,0.24,14500,13,39,115
146825,MacMurray College,1,0,2005,NA,NA,159,77,82,35,10,25,0.32,0.12,0.22,15000,13,41,110
146825,MacMurray College,1,0,2006,NA,NA,166,86,80,41,14,27,0.31,0.17,0.25,15500,13,38,114
146825,MacMurray College,1,0,2007,NA,NA,125,73,52,35,3,32,0.43,0.06,0.28,16400,11,35,89
146825,MacMurray College,1,0,2008,NA,NA,90,36,54,21,8,13,0.36,0.15,0.23,17000,10,31,59
146825,MacMurray College,1,0,2009,NA,NA,96,34,62,19,6,13,0.38,0.1,0.2,17940,10,33,61
146825,MacMurray College,1,0,2010,NA,NA,90,39,51,10,4,6,0.15,0.08,0.11,18838,8,33,52
147013,MCKENDREE COLLEGE,1,0,1991,NA,NA,132,79,53,46,15,31,0.39,0.28,0.35,6746,11,41,114
147013,MCKENDREE COLLEGE,1,0,1992,NA,NA,134,82,52,53,19,34,0.41000000000000003,0.37,0.4,7066,12,46,118
147013,MCKENDREE COLLEGE,1,0,1993,NA,NA,119,72,47,34,12,22,0.3,0.26,0.29,7450,13,47,99
147013,MCKENDREE COLLEGE,1,0,1995,NA,NA,188,109,79,54,16,38,0.34,0.2,0.29,8640,13,48,175
147013,MCKENDREE COLLEGE,1,0,1996,NA,NA,309,142,167,106,46,60,0.42,0.28,0.34,9600,15,51,282
147013,MCKENDREE COLLEGE,1,0,1997,NA,NA,242,131,111,98,35,63,0.48,0.32,0.4,10400,14,57,220
147013,MCKENDREE COLLEGE,1,0,1998,NA,NA,247,139,108,91,24,67,0.48,0.22,0.37,11200,15,57,213
147013,MCKENDREE COLLEGE,1,0,1999,NA,NA,246,164,82,101,27,74,0.45,0.33,0.41,12000,17,60,211
147013,MCKENDREE COLLEGE,1,0,2000,NA,NA,265,154,111,97,35,62,0.4,0.32,0.37,12300,19,61,239
147013,MCKENDREE COLLEGE,1,0,2001,NA,NA,284,168,116,128,35,93,0.55,0.3,0.45,13350,21,63,244
147013,MCKENDREE COLLEGE,1,0,2002,NA,NA,258,135,123,127,48,79,0.58,0.39,0.49,14200,22,65,229
147013,MCKENDREE COLLEGE,1,0,2003,NA,NA,287,124,163,113,55,58,0.46,0.34,0.39,15200,21,71,224
147013,MCKENDREE COLLEGE,1,0,2004,NA,NA,337,134,203,122,55,67,0.5,0.27,0.36,16400,23,70,269
147013,McKendree College,1,0,2005,NA,NA,273,126,147,94,39,55,0.43,0.27,0.34,17500,25,76,209
147013,McKendree College,1,0,2006,NA,NA,343,162,181,114,40,74,0.45,0.22,0.33,18300,26,82,265
147013,McKendree University,1,0,2007,NA,NA,298,131,167,94,42,52,0.39,0.25,0.32,19500,29,87,238
147013,McKendree University,1,0,2008,NA,NA,308,145,163,110,40,70,0.48,0.25,0.36,20570,30,94,228
147013,McKendree University,1,0,2009,NA,NA,305,148,157,102,44,58,0.39,0.28,0.33,21370,31,91,231
147013,McKendree University,1,0,2010,NA,NA,335,154,181,121,54,67,0.43,0.3,0.36,22330,31,97,239
147244,MILLIKIN UNIVERSITY,1,0,1991,NA,NA,422,242,180,245,94,151,0.62,0.52,0.58,9990,29,116,390
147244,MILLIKIN UNIVERSITY,1,0,1992,NA,NA,516,302,214,289,102,187,0.61,0.48,0.56,10590,30,118,479
147244,MILLIKIN UNIVERSITY,1,0,1993,NA,NA,452,235,217,256,111,145,0.61,0.51,0.57,11240,34,124,415
147244,MILLIKIN UNIVERSITY,1,0,1995,NA,NA,494,272,222,248,98,150,0.55,0.44,0.5,12596,35,128,409
147244,MILLIKIN UNIVERSITY,1,0,1996,NA,NA,497,284,213,253,80,173,0.6,0.38,0.51,13290,38,130,422
147244,MILLIKIN UNIVERSITY,1,0,1997,NA,NA,569,302,267,286,112,174,0.5700000000000001,0.42,0.5,14138,28,222,473
147244,MILLIKIN UNIVERSITY,1,0,1998,NA,NA,594,331,263,291,91,200,0.6,0.35,0.49,14758,31,136,495
147244,MILLIKIN UNIVERSITY,1,0,1999,NA,NA,595,324,271,323,130,193,0.59,0.48,0.54,15348,35,137,521
147244,MILLIKIN UNIVERSITY,1,0,2000,NA,NA,574,316,258,320,120,200,0.63,0.47,0.56,16192,38,148,487
147244,MILLIKIN UNIVERSITY,1,0,2001,NA,NA,646,356,290,349,139,210,0.58,0.48,0.54,17084,41,159,547
147244,MILLIKIN UNIVERSITY,1,0,2002,NA,NA,634,351,283,335,117,218,0.62,0.41,0.53,18109,48,159,551
147244,MILLIKIN UNIVERSITY,1,0,2003,NA,NA,595,299,296,317,132,185,0.61,0.45,0.53,18834,41,143,491
147244,MILLIKIN UNIVERSITY,1,0,2004,NA,NA,530,302,228,268,99,169,0.55,0.43,0.51,19900,40,138,429
147244,Millikin University,1,0,2005,NA,NA,572,313,259,311,119,192,0.61,0.46,0.54,20696,41,142,470
147244,Millikin University,1,0,2006,NA,NA,475,261,214,214,89,125,0.47000000000000003,0.42,0.45,21524,42,145,386
147244,Millikin University,1,0,2007,NA,NA,475,268,207,228,91,137,0.51,0.44,0.48,23250,46,155,384
147244,Millikin University,1,0,2008,NA,NA,484,298,186,247,83,164,0.55,0.45,0.51,24600,48,158,388
147244,Millikin University,1,0,2009,NA,NA,541,317,224,259,97,162,0.51,0.43,0.48,25750,50,154,421
147244,Millikin University,1,0,2010,NA,NA,498,258,240,244,101,143,0.55,0.42,0.49,26780,48,151,372
147341,MONMOUTH COLLEGE,1,0,1991,NA,NA,252,117,135,113,48,65,0.55,0.36,0.45,12450,14,53,222
147341,MONMOUTH COLLEGE,1,0,1992,NA,NA,125,67,58,61,23,38,0.56,0.4,0.49,12800,15,53,112
147341,MONMOUTH COLLEGE,1,0,1993,NA,NA,204,93,111,77,31,46,0.49,0.28,0.38,12900,14,44,185
147341,MONMOUTH COLLEGE,1,0,1995,NA,NA,308,187,121,156,54,102,0.54,0.45,0.51,13460,18,49,284
147341,MONMOUTH COLLEGE,1,0,1996,NA,NA,282,167,115,139,52,87,0.52,0.45,0.49,13965,20,52,254
147341,MONMOUTH COLLEGE,1,0,1997,NA,NA,272,176,96,150,48,102,0.5700000000000001,0.5,0.55,14420,12,51,234
147341,MONMOUTH COLLEGE,1,0,1998,NA,NA,320,146,174,170,84,86,0.58,0.48,0.53,15120,13,49,271
147341,MONMOUTH COLLEGE,1,0,1999,NA,NA,259,155,104,132,44,88,0.56,0.42,0.51,15720,14,57,233
147341,MONMOUTH COLLEGE,1,0,2000,NA,NA,235,136,99,143,51,92,0.67,0.52,0.61,16370,15,57,214
147341,MONMOUTH COLLEGE,1,0,2001,NA,NA,258,122,136,128,67,61,0.5,0.49,0.5,17000,17,58,236
147341,MONMOUTH COLLEGE,1,0,2002,NA,NA,282,147,135,150,61,89,0.6,0.45,0.53,17760,19,61,261
147341,MONMOUTH COLLEGE,1,0,2003,NA,NA,355,175,180,215,97,118,0.67,0.54,0.61,18600,19,66,324
147341,MONMOUTH COLLEGE,1,0,2004,NA,NA,389,227,162,169,59,110,0.48,0.36,0.43,19350,21,69,349
147341,Monmouth College,1,0,2005,NA,NA,367,180,187,140,50,90,0.5,0.27,0.38,20200,23,73,325
147341,Monmouth College,1,0,2006,NA,NA,392,215,177,172,64,108,0.5,0.36,0.44,21100,25,79,310
147341,Monmouth College,1,0,2007,NA,NA,393,213,180,223,90,133,0.62,0.5,0.57,22000,27,74,344
147341,Monmouth College,1,0,2008,NA,NA,383,179,204,182,84,98,0.54,0.41,0.48,24000,27,81,319
147341,Monmouth College,1,0,2009,NA,NA,378,187,191,183,79,104,0.55,0.41,0.48,24950,28,80,296
147341,Monmouth College,1,0,2010,NA,NA,355,187,168,168,73,95,0.5,0.43,0.47,26900,29,78,249
147703,NORTHERN ILLINOIS UNIVERSITY,1,0,1991,NA,NA,3161,1646,1515,651,251,400,0.24,0.17,0.21,2641,206,1003,2368
147703,NORTHERN ILLINOIS UNIVERSITY,1,0,1992,NA,NA,2742,1537,1205,607,211,396,0.25,0.18,0.22,3084,210,963,1954
147703,NORTHERN ILLINOIS UNIVERSITY,1,0,1993,NA,NA,2380,1320,1060,491,163,328,0.24,0.15,0.21,3339,219,944,1633
147703,NORTHERN ILLINOIS UNIVERSITY,1,0,1995,NA,NA,2429,1368,1061,582,200,382,0.27,0.19,0.24,3746,238,941,1620
147703,NORTHERN ILLINOIS UNIVERSITY,1,0,1996,NA,NA,2434,1339,1095,613,246,367,0.27,0.22,0.25,3948,261,929,1605
147703,NORTHERN ILLINOIS UNIVERSITY,1,0,1997,NA,NA,2673,1444,1229,691,252,439,0.3,0.21,0.26,4122,269,891,1855
147703,NORTHERN ILLINOIS UNIVERSITY,1,0,1998,NA,NA,2818,1513,1305,682,244,438,0.28,0.19,0.24,4210,281,856,1839
147703,NORTHERN ILLINOIS UNIVERSITY,1,0,1999,NA,NA,2924,1587,1337,742,285,457,0.28,0.21,0.25,3060,296,847,1918
147703,NORTHERN ILLINOIS UNIVERSITY,1,0,2000,NA,NA,2765,1341,1424,634,273,361,0.26,0.19,0.23,3150,319,867,1748
147703,NORTHERN ILLINOIS UNIVERSITY,1,0,2001,NA,NA,2792,1459,1333,725,281,444,0.3,0.21,0.26,3293,348,887,1810
147703,NORTHERN ILLINOIS UNIVERSITY,1,0,2002,NA,NA,3015,1585,1430,698,283,415,0.26,0.2,0.23,3581,372,908,1993
147703,NORTHERN ILLINOIS UNIVERSITY,1,0,2003,NA,NA,3229,1635,1594,737,300,437,0.26,0.19,0.23,3956,369,898,2097
147703,NORTHERN ILLINOIS UNIVERSITY,1,0,2004,NA,NA,2933,1585,1348,807,334,473,0.29,0.25,0.28,4612,457,874,2014
147703,Northern Illinois University,1,0,2005,NA,NA,3171,1637,1534,826,360,466,0.28,0.23,0.26,5061,405,891,2095
147703,Northern Illinois University,1,0,2006,NA,NA,3260,1641,1619,903,427,476,0.29,0.26,0.28,5550,420,904,2140
147703,Northern Illinois University,1,0,2007,NA,NA,2997,1584,1413,793,353,440,0.27,0.25,0.26,6150,433,908,1637
147703,Northern Illinois University,1,0,2008,NA,NA,2844,1469,1375,718,315,403,0.27,0.23,0.25,6720,463,926,1633
147703,Northern Illinois University,1,0,2009,NA,NA,2988,1573,1415,754,310,444,0.28,0.22,0.25,7260,484,921,1711
147703,Northern Illinois University,1,0,2010,NA,NA,2663,1338,1325,625,278,347,0.25,0.21,0.23,7020,502,896,1396
147767,NORTHWESTERN UNIVERSITY,0,1,1991,Inf,0,1945,955,990,1601,782,819,0.85,0.79,0.82,14370,589,875,1405
147767,NORTHWESTERN UNIVERSITY,0,1,1992,Inf,0,1889,948,941,1533,719,814,0.85,0.76,0.81,15075,663,886,1364
147767,NORTHWESTERN UNIVERSITY,0,1,1993,Inf,0,1903,950,953,1566,749,817,0.86,0.79,0.82,15804,694,872,1356
147767,NORTHWESTERN UNIVERSITY,0,1,1995,Inf,0,1948,1066,882,1595,672,923,0.86,0.76,0.82,17184,786,878,1235
147767,NORTHWESTERN UNIVERSITY,0,1,1996,Inf,0,1947,1035,912,1639,719,920,0.88,0.79,0.84,18108,848,892,1305
147767,NORTHWESTERN UNIVERSITY,0,1,1997,Inf,0,1889,959,930,1578,743,835,0.87,0.8,0.84,19152,660,879,1206
147767,NORTHWESTERN UNIVERSITY,0,1,1998,Inf,0,1912,1023,889,1601,706,895,0.87,0.79,0.84,22392,672,916,1223
147767,NORTHWESTERN UNIVERSITY,0,1,1999,Inf,0,1951,1039,912,1657,746,911,0.87,0.82,0.85,23476,758,896,1202
147767,NORTHWESTERN UNIVERSITY,0,1,2000,Inf,0,1876,983,893,1612,731,881,0.89,0.82,0.86,24648,819,901,1148
147767,NORTHWESTERN UNIVERSITY,0,1,2001,Inf,0,1947,1026,921,1682,769,913,0.88,0.83,0.86,25839,871,907,1143
147767,NORTHWESTERN UNIVERSITY,0,1,2002,Inf,0,2000,1075,925,1725,759,966,0.89,0.82,0.86,27108,921,915,1199
147767,NORTHWESTERN UNIVERSITY,0,1,2003,Inf,0,1941,1035,906,1694,753,941,0.9,0.83,0.87,28404,958,900,1206
147767,NORTHWESTERN UNIVERSITY,0,1,2004,Inf,0,1914,1030,884,1652,728,924,0.89,0.82,0.86,29940,1063,933,1178
147767,Northwestern University,0,1,2005,Inf,0,1952,1018,934,1669,756,913,0.89,0.81,0.86,31644,1169,1170,1172
147767,Northwestern University,0,1,2006,Inf,0,2060,1089,971,1768,799,969,0.88,0.82,0.86,33408,1245,1223,1221
147767,Northwestern University,0,1,2007,Inf,0,1979,1057,922,1705,770,935,0.88,0.84,0.86,35064,1356,1266,1112
147767,Northwestern University,0,1,2008,Inf,0,2077,1075,1002,1773,822,951,0.88,0.82,0.85,36756,1563,1294,1167
147767,Northwestern University,0,1,2009,Inf,0,2128,1076,1052,1754,826,928,0.86,0.79,0.82,38463,1588,1310,1186
147767,Northwestern University,0,1,2010,Inf,0,2126,1125,1001,1785,790,995,0.88,0.79,0.84,39840,1671,1352,1190
147776,NORTHEASTERN ILLINOIS UNIVERSITY,0,1,1991,1992,0,724,447,277,17,5,12,0.02,0.02,0.02,2092,57,345,314
147776,NORTHEASTERN ILLINOIS UNIVERSITY,1,0,1992,1992,1,688,408,280,21,6,15,0.03,0.02,0.03,1834,59,340,292
147776,NORTHEASTERN ILLINOIS UNIVERSITY,1,0,1993,1992,1,641,374,267,14,3,11,0.02,0.01,0.02,2062,60,331,227
147776,NORTHEASTERN ILLINOIS UNIVERSITY,1,0,1995,1992,1,812,488,324,20,7,13,0.02,0.02,0.02,2244,66,319,316
147776,NORTHEASTERN ILLINOIS UNIVERSITY,1,0,1996,1992,1,799,474,325,12,6,6,0.01,0.02,0.02,2352,74,322,271
147776,NORTHEASTERN ILLINOIS UNIVERSITY,1,0,1997,1992,1,1007,630,377,25,9,16,0.02,0.02,0.02,2469,77,327,364
147776,NORTHEASTERN ILLINOIS UNIVERSITY,1,0,1998,1992,1,961,594,367,15,3,12,0.02,0.01,0.02,2507,76,329,324
147776,NORTHEASTERN ILLINOIS UNIVERSITY,1,0,1999,1992,1,943,573,370,22,7,15,0.02,0.02,0.02,2262,83,312,304
147776,NORTHEASTERN ILLINOIS UNIVERSITY,1,0,2000,1992,1,948,570,378,27,7,20,0.03,0.02,0.03,2340,91,332,323
147776,NORTHEASTERN ILLINOIS UNIVERSITY,1,0,2001,1992,1,964,622,342,21,7,14,0.02,0.02,0.02,2424,99,352,337
147776,NORTHEASTERN ILLINOIS UNIVERSITY,1,0,2002,1992,1,977,589,388,27,9,18,0.03,0.02,0.03,2508,104,370,331
147776,NORTHEASTERN ILLINOIS UNIVERSITY,1,0,2003,1992,1,1046,657,389,36,12,24,0.03,0.03,0.03,2640,105,398,361
147776,NORTHEASTERN ILLINOIS UNIVERSITY,1,0,2004,1992,1,972,580,392,37,7,30,0.05,0.02,0.04,2976,136,415,337
147776,Northeastern Illinois University,1,0,2005,1992,1,960,570,390,51,16,35,0.06,0.04,0.05,3840,120,415,320
147776,Northeastern Illinois University,1,0,2006,1992,1,1022,600,422,40,18,22,0.03,0.04,0.04,4200,123,411,300
147776,Northeastern Illinois University,1,0,2007,1992,1,870,506,364,36,9,27,0.05,0.02,0.04,4680,134,411,298
147776,Northeastern Illinois University,1,0,2008,1992,1,952,519,433,48,18,30,0.05,0.04,0.05,5280,136,421,269
147776,Northeastern Illinois University,1,0,2009,1992,1,996,545,451,50,20,30,0.05,0.04,0.05,5880,137,404,273
147776,Northeastern Illinois University,1,0,2010,1992,1,976,551,425,37,11,26,0.04,0.03,0.04,5520,150,416,274
147828,OLIVET NAZARENE UNIVERSITY,1,0,1991,NA,NA,376,209,167,140,42,98,0.46,0.25,0.37,6476,17,74,338
147828,OLIVET NAZARENE UNIVERSITY,1,0,1992,NA,NA,388,202,186,129,48,81,0.4,0.26,0.33,7050,19,80,350
147828,OLIVET NAZARENE UNIVERSITY,1,0,1993,NA,NA,421,234,187,169,61,108,0.46,0.33,0.4,7836,21,96,386
147828,OLIVET NAZARENE UNIVERSITY,1,0,1995,NA,NA,389,217,172,150,60,90,0.41000000000000003,0.35,0.39,9440,25,82,371
147828,OLIVET NAZARENE UNIVERSITY,1,0,1996,NA,NA,400,231,169,141,55,86,0.37,0.33,0.35,10166,27,81,374
147828,OLIVET NAZARENE UNIVERSITY,1,0,1997,NA,NA,426,229,197,170,53,117,0.51,0.27,0.4,10840,25,85,385
147828,OLIVET NAZARENE UNIVERSITY,1,0,1998,NA,NA,428,227,201,159,59,100,0.44,0.29,0.37,11728,25,84,382
147828,OLIVET NAZARENE UNIVERSITY,1,0,1999,NA,NA,410,224,186,169,61,108,0.48,0.33,0.41,11528,27,83,365
147828,OLIVET NAZARENE UNIVERSITY,1,0,2000,NA,NA,468,278,190,187,61,126,0.45,0.32,0.4,11928,29,82,421
147828,OLIVET NAZARENE UNIVERSITY,1,0,2001,NA,NA,541,297,244,240,90,150,0.5,0.37,0.44,12644,32,81,480
147828,OLIVET NAZARENE UNIVERSITY,1,0,2002,NA,NA,553,328,225,274,95,179,0.54,0.42,0.5,13400,36,86,490
147828,OLIVET NAZARENE UNIVERSITY,1,0,2003,NA,NA,578,339,239,252,93,159,0.46,0.39,0.44,14160,39,92,506
147828,OLIVET NAZARENE UNIVERSITY,1,0,2004,NA,NA,699,427,272,338,97,241,0.56,0.36,0.48,14900,42,96,613
147828,Olivet Nazarene University,1,0,2005,NA,NA,669,404,265,294,94,200,0.49,0.35,0.44,15650,47,106,560
147828,Olivet Nazarene University,1,0,2006,NA,NA,751,414,337,332,126,206,0.49,0.37,0.44,16750,51,107,654
147828,Olivet Nazarene University,1,0,2007,NA,NA,704,384,320,343,135,208,0.54,0.42,0.49,18750,56,119,609
147828,Olivet Nazarene University,1,0,2008,NA,NA,590,357,233,260,76,184,0.51,0.33,0.44,20750,58,118,505
147828,Olivet Nazarene University,1,0,2009,NA,NA,771,447,324,395,134,261,0.58,0.41,0.51,22750,62,122,677
147828,Olivet Nazarene University,1,0,2010,NA,NA,740,417,323,344,128,216,0.51,0.4,0.46,24750,66,122,628
148131,QUINCY COLLEGE,1,0,1991,NA,NA,296,153,143,105,44,61,0.39,0.31,0.35,8604,14,61,278
148131,QUINCY COLLEGE,1,0,1992,NA,NA,313,148,165,80,24,56,0.37,0.15,0.26,9160,15,58,285
148131,QUINCY UNIVERSITY,1,0,1993,NA,NA,297,134,163,71,33,38,0.28,0.2,0.24,9532,15,55,262
148131,QUINCY UNIVERSITY,1,0,1995,NA,NA,259,126,133,89,30,59,0.46,0.23,0.34,10910,16,54,230
148131,QUINCY UNIVERSITY,1,0,1996,NA,NA,283,135,148,112,50,62,0.45,0.34,0.4,11510,17,51,243
148131,QUINCY UNIVERSITY,1,0,1997,NA,NA,224,116,108,77,26,51,0.43,0.24,0.34,12410,13,52,199
148131,QUINCY UNIVERSITY,1,0,1998,NA,NA,232,122,110,109,43,66,0.54,0.39,0.47,13370,14,58,204
148131,QUINCY UNIVERSITY,1,0,1999,NA,NA,273,148,125,98,36,62,0.41000000000000003,0.29,0.36,13450,14,60,223
148131,QUINCY UNIVERSITY,1,0,2000,NA,NA,235,137,98,81,25,56,0.4,0.26,0.34,14300,16,60,201
148131,QUINCY UNIVERSITY,1,0,2001,NA,NA,231,119,112,83,32,51,0.42,0.29,0.36,15010,16,61,190
148131,QUINCY UNIVERSITY,1,0,2002,NA,NA,229,112,117,88,33,55,0.49,0.28,0.38,15910,17,58,197
148131,QUINCY UNIVERSITY,1,0,2003,NA,NA,222,108,114,68,32,36,0.33,0.28,0.31,16400,16,48,179
148131,QUINCY UNIVERSITY,1,0,2004,NA,NA,228,124,104,75,27,48,0.38,0.26,0.33,17140,16,45,167
148131,Quincy University,1,0,2005,NA,NA,202,99,103,69,28,41,0.41000000000000003,0.27,0.34,17800,17,52,150
148131,Quincy University,1,0,2006,NA,NA,161,88,73,67,27,40,0.45,0.37,0.42,18450,18,53,131
148131,Quincy University,1,0,2007,NA,NA,234,104,130,92,42,50,0.48,0.32,0.39,18950,18,48,170
148131,Quincy University,1,0,2008,NA,NA,245,108,137,81,31,50,0.46,0.23,0.33,20100,20,49,176
148131,Quincy University,1,0,2009,NA,NA,248,127,121,81,31,50,0.39,0.26,0.33,21300,21,53,180
148131,Quincy University,1,0,2010,NA,NA,272,136,136,94,44,50,0.36,0.32,0.35,22240,23,58,152
148496,ROSARY COLLEGE,1,0,1991,NA,NA,152,124,28,58,11,47,0.37,0.39,0.38,9226,15,71,113
148496,ROSARY COLLEGE,1,0,1992,NA,NA,142,117,25,67,9,58,0.49,0.36,0.47,9940,16,74,109
148496,ROSARY COLLEGE,1,0,1993,NA,NA,140,101,39,66,17,49,0.48,0.44,0.47,10500,16,72,104
148496,ROSARY COLLEGE,1,0,1995,NA,NA,124,95,29,67,13,54,0.56,0.45,0.54,11550,19,69,98
148496,ROSARY COLLEGE,1,0,1996,NA,NA,153,106,47,80,27,53,0.5,0.57,0.52,12230,19,71,108
148496,DOMINICAN UNIVERSITY,1,0,1997,NA,NA,199,140,59,99,28,71,0.5,0.47,0.5,13050,16,73,154
148496,DOMINICAN UNIVERSITY,1,0,1998,NA,NA,207,137,70,102,36,66,0.48,0.51,0.49,13700,19,76,150
148496,DOMINICAN UNIVERSITY,1,0,1999,NA,NA,195,144,51,112,28,84,0.58,0.55,0.57,14160,21,79,135
148496,DOMINICAN UNIVERSITY,1,0,2000,NA,NA,165,108,57,94,30,64,0.59,0.53,0.57,14720,22,84,114
148496,DOMINICAN UNIVERSITY,1,0,2001,NA,NA,222,139,83,111,34,77,0.55,0.41,0.5,15600,25,90,159
148496,DOMINICAN UNIVERSITY,1,0,2002,NA,NA,192,123,69,111,29,82,0.66,0.42,0.58,16620,28,97,137
148496,DOMINICAN UNIVERSITY,1,0,2003,NA,NA,240,176,64,146,40,106,0.6,0.62,0.61,17850,32,96,175
148496,DOMINICAN UNIVERSITY,1,0,2004,NA,NA,271,181,90,156,41,115,0.63,0.46,0.58,18900,34,100,177
148496,Dominican University,1,0,2005,NA,NA,266,178,88,147,46,101,0.56,0.52,0.55,19950,37,109,161
148496,Dominican University,1,0,2006,NA,NA,362,256,106,203,52,151,0.58,0.49,0.56,21150,40,112,205
148496,Dominican University,1,0,2007,NA,NA,366,265,101,184,43,141,0.53,0.43,0.5,22350,42,122,199
148496,Dominican University,1,0,2008,NA,NA,416,291,125,198,59,139,0.47000000000000003,0.47,0.48,23700,45,125,234
148496,Dominican University,1,0,2009,NA,NA,405,279,126,193,51,142,0.5,0.4,0.48,24600,49,140,231
148496,Dominican University,1,0,2010,NA,NA,427,287,140,212,60,152,0.52,0.43,0.5,25560,52,156,207
148584,COLLEGE OF SAINT FRANCIS,1,0,1991,NA,NA,171,81,90,58,22,36,0.44,0.24,0.34,7982,15,50,144
148584,COLLEGE OF SAINT FRANCIS,1,0,1992,NA,NA,144,67,77,52,23,29,0.43,0.3,0.36,8600,16,51,133
148584,COLLEGE OF SAINT FRANCIS,1,0,1993,NA,NA,149,79,70,61,25,36,0.45,0.36,0.41,9100,17,50,140
148584,COLLEGE OF ST FRANCIS,1,0,1995,NA,NA,165,82,83,67,30,37,0.45,0.36,0.41,10790,19,53,149
148584,COLLEGE OF ST FRANCIS,1,0,1996,NA,NA,151,91,60,53,15,38,0.41000000000000003,0.25,0.35,11490,23,53,102
148584,UNIVERSITY OF ST FRANCIS,1,0,1997,NA,NA,134,82,52,48,13,35,0.42,0.25,0.36,11950,25,69,91
148584,UNIVERSITY OF ST FRANCIS,1,0,1998,NA,NA,176,88,88,64,21,43,0.48,0.24,0.36,12480,28,70,118
148584,UNIVERSITY OF ST FRANCIS,1,0,1999,NA,NA,170,101,69,54,14,40,0.39,0.2,0.32,12800,30,69,145
148584,UNIVERSITY OF ST FRANCIS,1,0,2000,NA,NA,190,109,81,73,25,48,0.44,0.31,0.38,13990,24,72,148
148584,UNIVERSITY OF ST FRANCIS,1,0,2001,NA,NA,177,112,65,72,21,51,0.45,0.32,0.41,14680,28,76,153
148584,UNIVERSITY OF ST FRANCIS,1,0,2002,NA,NA,149,86,63,49,17,32,0.37,0.27,0.33,15710,28,75,101
148584,UNIVERSITY OF ST FRANCIS,1,0,2003,NA,NA,190,110,80,62,27,35,0.31,0.34,0.33,16480,31,79,144
148584,UNIVERSITY OF ST FRANCIS,1,0,2004,NA,NA,157,94,63,64,21,43,0.45,0.33,0.41,17310,40,81,120
148584,University of St Francis,1,0,2005,NA,NA,190,116,74,85,27,58,0.5,0.36,0.45,18170,34,84,137
148584,University of St Francis,1,0,2006,NA,NA,181,104,77,62,21,41,0.39,0.27,0.34,19150,34,87,128
148584,University of St Francis,1,0,2007,NA,NA,198,124,74,63,18,45,0.36,0.24,0.32,20440,35,84,149
148584,University of St Francis,1,0,2008,NA,NA,203,125,78,77,27,50,0.4,0.35,0.38,21450,37,93,160
148584,University of St Francis,1,0,2009,NA,NA,223,144,79,92,26,66,0.45,0.33,0.41,22288,39,96,170
148584,University of St Francis,1,0,2010,NA,NA,210,131,79,93,29,64,0.48,0.37,0.44,24292,39,95,144
148627,SAINT XAVIER COLLEGE,1,0,1991,NA,NA,160,109,51,50,11,39,0.35000000000000003,0.22,0.31,8840,25,133,118
148627,SAINT XAVIER UNIVERSITY,1,0,1992,NA,NA,192,134,58,55,11,44,0.32,0.19,0.29,9650,28,145,129
148627,SAINT XAVIER UNIVERSITY,1,0,1993,NA,NA,272,163,109,75,20,55,0.33,0.18,0.28,10340,29,153,196
148627,SAINT XAVIER UNIVERSITY,1,0,1995,NA,NA,226,139,87,67,19,48,0.34,0.22,0.3,11600,35,137,153
148627,SAINT XAVIER UNIVERSITY,1,0,1996,NA,NA,203,116,87,56,14,42,0.36,0.16,0.28,12080,36,141,133
148627,SAINT XAVIER UNIVERSITY,1,0,1997,NA,NA,270,180,90,82,21,61,0.33,0.23,0.3,12560,29,140,164
148627,SAINT XAVIER UNIVERSITY,1,0,1998,NA,NA,271,180,91,87,21,66,0.36,0.23,0.32,13160,31,142,167
148627,SAINT XAVIER UNIVERSITY,1,0,1999,NA,NA,325,196,129,96,33,63,0.32,0.26,0.3,13650,34,139,222
148627,SAINT XAVIER UNIVERSITY,1,0,2000,NA,NA,352,222,130,112,36,76,0.34,0.28,0.32,14400,36,142,226
148627,SAINT XAVIER UNIVERSITY,1,0,2001,NA,NA,353,208,145,88,31,57,0.27,0.21,0.25,15000,40,145,224
148627,SAINT XAVIER UNIVERSITY,1,0,2002,NA,NA,375,262,113,89,24,65,0.24,0.21,0.24,15750,45,151,240
148627,SAINT XAVIER UNIVERSITY,1,0,2003,NA,NA,371,231,140,107,32,75,0.32,0.23,0.29,16500,51,160,241
148627,SAINT XAVIER UNIVERSITY,1,0,2004,NA,NA,406,259,147,130,44,86,0.33,0.3,0.32,17150,58,168,250
148627,Saint Xavier University,1,0,2005,NA,NA,410,236,174,133,50,83,0.35000000000000003,0.29,0.32,18350,63,168,251
148627,Saint Xavier University,1,0,2006,NA,NA,525,370,155,172,47,125,0.33,0.3,0.33,19640,66,190,310
148627,Saint Xavier University,1,0,2007,NA,NA,507,342,165,152,50,102,0.29,0.3,0.3,21016,72,186,265
148627,Saint Xavier University,1,0,2008,NA,NA,547,375,172,176,55,121,0.32,0.32,0.32,22486,75,176,291
148627,Saint Xavier University,1,0,2009,NA,NA,438,282,156,131,34,97,0.34,0.22,0.3,23610,76,180,241
148627,Saint Xavier University,1,0,2010,NA,NA,488,308,180,153,41,112,0.36,0.23,0.31,24790,78,179,239
149222,SOUTHERN ILLINOIS UNIVERSITY-CARBONDALE,1,0,1991,NA,NA,2376,1018,1358,302,139,163,0.16,0.1,0.13,2382,298,1062,1724
149222,SOUTHERN ILLINOIS UNIVERSITY-CARBONDALE,1,0,1992,NA,NA,2756,1203,1553,442,195,247,0.2,0.13,0.16,2556,297,991,2019
149222,SOUTHERN ILLINOIS UNIVERSITY-CARBONDALE,1,0,1993,NA,NA,2271,969,1302,318,152,166,0.17,0.12,0.14,3052,307,977,1673
149222,SOUTHERN ILLINOIS UNIVERSITY-CARBONDALE,1,0,1995,NA,NA,2277,1006,1271,371,162,209,0.2,0.13,0.16,3338,334,973,1698
149222,SOUTHERN ILLINOIS UNIVERSITY-CARBONDALE,1,0,1996,NA,NA,2404,1054,1350,376,152,224,0.21,0.11,0.16,3522,341,963,1679
149222,SOUTHERN ILLINOIS UNIVERSITY-CARBONDALE,1,0,1997,NA,NA,2400,1051,1349,451,188,263,0.25,0.14,0.19,3716,349,941,1682
149222,SOUTHERN ILLINOIS UNIVERSITY-CARBONDALE,1,0,1998,NA,NA,2637,1131,1506,542,248,294,0.25,0.16,0.21,3821,347,918,1851
149222,SOUTHERN ILLINOIS UNIVERSITY-CARBONDALE,1,0,1999,NA,NA,2547,1094,1453,483,234,249,0.22,0.16,0.19,2865,352,948,1628
149222,SOUTHERN ILLINOIS UNIVERSITY-CARBONDALE,1,0,2000,NA,NA,2325,1036,1289,473,201,272,0.26,0.16,0.2,2408,364,1159,1545
149222,SOUTHERN ILLINOIS UNIVERSITY-CARBONDALE,1,0,2001,NA,NA,2153,967,1186,501,220,281,0.29,0.19,0.23,2482,386,1371,1571
149222,SOUTHERN ILLINOIS UNIVERSITY-CARBONDALE,1,0,2002,NA,NA,2395,1037,1358,550,262,288,0.27,0.19,0.23,2928,479,1279,1650
149222,SOUTHERN ILLINOIS UNIVERSITY-CARBONDALE,1,0,2003,NA,NA,2532,1089,1443,595,280,315,0.28,0.19,0.23,4245,475,1290,1757
149222,SOUTHERN ILLINOIS UNIVERSITY CARBONDALE,1,0,2004,NA,NA,2545,1053,1492,646,308,338,0.32,0.21,0.25,4920,602,973,1762
149222,Southern Illinois University Carbondale,1,0,2005,NA,NA,2382,1034,1348,560,261,299,0.28,0.19,0.24,5310,528,954,1553
149222,Southern Illinois University Carbondale,1,0,2006,NA,NA,2278,1005,1273,586,266,320,0.31,0.21,0.26,5808,555,972,1527
149222,Southern Illinois University Carbondale,1,0,2007,NA,NA,2541,1127,1414,582,268,314,0.27,0.19,0.23,6348,568,926,1489
149222,Southern Illinois University Carbondale,1,0,2008,NA,NA,2592,1183,1409,627,305,322,0.27,0.22,0.24,6975,614,941,1560
149222,Southern Illinois University Carbondale,1,0,2009,NA,NA,2445,1131,1314,624,264,360,0.31,0.2,0.26,7290,652,952,1460
149222,Southern Illinois University Carbondale,1,0,2010,NA,NA,2314,1104,1210,602,283,319,0.28,0.23,0.26,6975,702,914,1217
149231,SOUTHERN ILLINOIS UNIVERSITY AT EDWARDSVILLE,0,1,1991,1993,0,948,539,409,107,30,77,0.14,0.07,0.11,1965,96,459,707
149231,SOUTHERN ILLINOIS UNIVERSITY AT EDWARDSVILLE,0,1,1992,1993,0,965,558,407,100,32,68,0.12,0.08,0.1,2158,98,426,729
149231,SOUTHERN ILLINOIS UNIVERSITY-EDWARDSVILLE,1,0,1993,1993,1,912,523,389,113,38,75,0.14,0.1,0.12,2199,103,421,711
149231,SOUTHERN ILLINOIS UNIVERSITY-EDWARDSVILLE,1,0,1995,1993,1,1085,644,441,154,40,114,0.17,0.09,0.14,2329,116,461,842
149231,SOUTHERN ILLINOIS UNIVERSITY-EDWARDSVILLE,1,0,1996,1993,1,1176,741,435,170,36,134,0.18,0.08,0.14,2469,121,466,940
149231,SOUTHERN ILLINOIS UNIVERSITY-EDWARDSVILLE,1,0,1997,1993,1,1219,734,485,242,65,177,0.24,0.13,0.2,2586,133,482,1004
149231,SOUTHERN ILLINOIS UNIVERSITY-EDWARDSVILLE,1,0,1998,1993,1,1408,853,555,257,70,187,0.21,0.13,0.18,2664,127,481,1125
149231,SOUTHERN ILLINOIS UNIVERSITY-EDWARDSVILLE,1,0,1999,1993,1,1357,800,557,253,66,187,0.23,0.12,0.19,2143,134,491,1081
149231,SOUTHERN ILLINOIS UNIVERSITY-EDWARDSVILLE,1,0,2000,1993,1,1495,848,647,324,103,221,0.26,0.16,0.22,2388,146,488,1221
149231,SOUTHERN ILLINOIS UNIVERSITY-EDWARDSVILLE,1,0,2001,1993,1,1573,895,678,332,108,224,0.25,0.16,0.21,2574,161,486,1313
149231,SOUTHERN ILLINOIS UNIVERSITY-EDWARDSVILLE,1,0,2002,1993,1,1629,866,763,356,126,230,0.26,0.17,0.22,2970,192,494,1394
149231,SOUTHERN ILLINOIS UNIVERSITY-EDWARDSVILLE,1,0,2003,1993,1,1699,982,717,399,129,270,0.27,0.18,0.23,3360,188,518,1427
149231,SOUTHERN ILLINOIS UNIVERSITY EDWARDSVILLE,1,0,2004,1993,1,1695,986,709,485,162,323,0.32,0.23,0.29,4020,246,528,1470
149231,Southern Illinois University Edwardsville,1,0,2005,1993,1,1721,994,727,487,166,321,0.32,0.23,0.28,4350,214,556,1478
149231,Southern Illinois University Edwardsville,1,0,2006,1993,1,1770,1025,745,527,163,364,0.35000000000000003,0.22,0.3,4758,222,578,1535
149231,Southern Illinois University Edwardsville,1,0,2007,1993,1,1833,1026,807,509,179,330,0.32,0.22,0.28,5228,232,592,1426
149231,Southern Illinois University Edwardsville,1,0,2008,1993,1,1901,1101,800,545,194,351,0.31,0.24,0.29,5850,254,610,1492
149231,Southern Illinois University Edwardsville,1,0,2009,1993,1,1911,1068,843,503,198,305,0.28,0.23,0.26,6201,266,622,1437
149231,Southern Illinois University Edwardsville,1,0,2010,1993,1,2022,1104,918,520,196,324,0.29,0.21,0.26,5668,286,627,1460
149772,WESTERN ILLINOIS UNIVERSITY,1,0,1991,NA,NA,1685,877,808,354,155,199,0.22,0.19,0.21,2241,121,604,1355
149772,WESTERN ILLINOIS UNIVERSITY,1,0,1992,NA,NA,1566,763,803,315,137,178,0.23,0.17,0.2,2454,123,604,1264
149772,WESTERN ILLINOIS UNIVERSITY,1,0,1993,NA,NA,1531,793,738,347,146,201,0.25,0.2,0.23,2548,122,606,1228
149772,WESTERN ILLINOIS UNIVERSITY,1,0,1995,NA,NA,1538,757,781,392,168,224,0.29,0.22,0.25,2702,127,616,1316
149772,WESTERN ILLINOIS UNIVERSITY,1,0,1996,NA,NA,1477,720,757,428,171,257,0.35000000000000003,0.23,0.29,2810,139,621,1275
149772,WESTERN ILLINOIS UNIVERSITY,1,0,1997,NA,NA,1602,833,769,450,180,270,0.32,0.23,0.28,3036,143,598,1388
149772,WESTERN ILLINOIS UNIVERSITY,1,0,1998,NA,NA,1749,928,821,504,203,301,0.32,0.25,0.29,3185,155,605,1502
149772,WESTERN ILLINOIS UNIVERSITY,1,0,1999,NA,NA,1690,856,834,542,215,327,0.38,0.26,0.32,2730,165,599,1434
149772,WESTERN ILLINOIS UNIVERSITY,1,0,2000,NA,NA,1762,904,858,557,245,312,0.34,0.29,0.32,2812,177,613,1488
149772,WESTERN ILLINOIS UNIVERSITY,1,0,2001,NA,NA,1677,836,841,557,245,312,0.37,0.29,0.33,2982,194,627,1457
149772,WESTERN ILLINOIS UNIVERSITY,1,0,2002,NA,NA,1917,941,976,619,280,339,0.36,0.29,0.32,3465,196,606,1637
149772,WESTERN ILLINOIS UNIVERSITY,1,0,2003,NA,NA,1938,939,999,675,322,353,0.37,0.32,0.35,3915,191,619,1607
149772,WESTERN ILLINOIS UNIVERSITY,1,0,2004,NA,NA,2056,1025,1031,681,301,380,0.37,0.29,0.33,4537,240,610,1694
149772,Western Illinois University,1,0,2005,NA,NA,1802,885,917,549,265,284,0.32,0.29,0.3,4968,208,632,1449
149772,Western Illinois University,1,0,2006,NA,NA,1907,909,998,583,303,280,0.3,0.3,0.31,5439,215,642,1556
149772,Western Illinois University,1,0,2007,NA,NA,1943,952,991,572,258,314,0.32,0.26,0.29,5895,227,646,1506
149772,Western Illinois University,1,0,2008,NA,NA,1806,881,925,536,278,258,0.29,0.3,0.3,6456,239,668,1353
149772,Western Illinois University,1,0,2009,NA,NA,1633,817,816,515,226,289,0.35000000000000003,0.28,0.32,6779,248,662,1193
149772,Western Illinois University,1,0,2010,NA,NA,1741,886,855,534,265,269,0.3,0.31,0.31,6588,260,648,1172
149781,WHEATON COLLEGE,1,0,1991,NA,NA,544,277,267,373,164,209,0.75,0.61,0.69,9548,45,147,504
149781,WHEATON COLLEGE,1,0,1992,NA,NA,548,294,254,392,172,220,0.74,0.68,0.72,10280,48,154,489
149781,WHEATON COLLEGE,1,0,1993,NA,NA,546,282,264,371,159,212,0.75,0.6,0.68,10640,51,156,480
149781,WHEATON COLLEGE,1,0,1995,NA,NA,546,281,265,425,198,227,0.8,0.75,0.78,12300,57,166,480
149781,WHEATON COLLEGE,1,0,1996,NA,NA,557,278,279,424,207,217,0.78,0.74,0.76,13100,62,171,489
149781,WHEATON COLLEGE,1,0,1997,NA,NA,546,290,256,418,189,229,0.78,0.74,0.77,13780,60,170,485
149781,WHEATON COLLEGE,1,0,1998,NA,NA,573,300,273,409,186,223,0.74,0.68,0.71,14360,58,170,519
149781,WHEATON COLLEGE,1,0,1999,NA,NA,583,311,272,450,204,246,0.79,0.75,0.77,14930,61,166,518
149781,WHEATON COLLEGE,1,0,2000,NA,NA,568,291,277,441,212,229,0.78,0.77,0.78,15540,64,211,491
149781,WHEATON COLLEGE,1,0,2001,NA,NA,572,276,296,416,200,216,0.78,0.68,0.73,16390,68,256,494
149781,WHEATON COLLEGE,1,0,2002,NA,NA,569,286,283,447,213,234,0.81,0.75,0.79,17320,74,185,489
149781,WHEATON COLLEGE,1,0,2003,NA,NA,576,288,288,462,223,239,0.8200000000000001,0.77,0.8,18500,75,183,503
149781,WHEATON COLLEGE,1,0,2004,NA,NA,595,318,277,469,202,267,0.8300000000000001,0.73,0.79,20000,77,188,503
149781,Wheaton College,1,0,2005,NA,NA,578,287,291,458,220,238,0.8200000000000001,0.76,0.79,21100,84,193,496
149781,Wheaton College,1,0,2006,NA,NA,572,278,294,435,219,216,0.77,0.74,0.76,22450,90,196,481
149781,Wheaton College,1,0,2007,NA,NA,580,292,288,432,216,216,0.73,0.75,0.74,23730,94,196,486
149781,Wheaton College,1,0,2008,NA,NA,580,291,289,462,219,243,0.8300000000000001,0.76,0.8,25500,101,202,475
149781,Wheaton College,1,0,2009,NA,NA,620,318,302,501,232,269,0.84,0.77,0.81,26520,106,202,510
149781,Wheaton College,1,0,2010,NA,NA,602,312,290,495,226,269,0.86,0.78,0.82,27580,105,199,502
150066,ANDERSON UNIVERSITY,1,0,1991,NA,NA,460,245,215,123,47,76,0.31,0.22,0.27,8060,24,103,432
150066,ANDERSON UNIVERSITY,1,0,1992,NA,NA,507,297,210,162,53,109,0.36,0.25,0.32,8780,26,123,470
150066,ANDERSON UNIVERSITY,1,0,1993,NA,NA,423,251,172,131,43,88,0.35000000000000003,0.25,0.31,9520,29,136,394
150066,ANDERSON UNIVERSITY,1,0,1995,NA,NA,498,298,200,169,59,110,0.36,0.3,0.34,11240,35,136,470
150066,ANDERSON UNIVERSITY,1,0,1996,NA,NA,406,222,184,144,47,97,0.43,0.26,0.35,11840,35,137,376
150066,ANDERSON UNIVERSITY,1,0,1997,NA,NA,451,266,185,172,54,118,0.44,0.29,0.38,12700,23,136,418
150066,ANDERSON UNIVERSITY,1,0,1998,NA,NA,534,319,215,202,78,124,0.38,0.36,0.38,13360,27,135,500
150066,ANDERSON UNIVERSITY,1,0,1999,NA,NA,498,304,194,206,61,145,0.47000000000000003,0.31,0.41,13740,28,135,455
150066,ANDERSON UNIVERSITY,1,0,2000,NA,NA,538,275,263,212,77,135,0.49,0.29,0.39,14680,29,138,497
150066,ANDERSON UNIVERSITY,1,0,2001,NA,NA,462,272,190,170,45,125,0.45,0.24,0.37,15380,30,141,402
150066,ANDERSON UNIVERSITY,1,0,2002,NA,NA,591,335,256,225,72,153,0.45,0.28,0.38,16140,33,139,522
150066,ANDERSON UNIVERSITY,1,0,2003,NA,NA,559,337,222,246,81,165,0.48,0.36,0.44,17050,38,139,511
150066,ANDERSON UNIVERSITY,1,0,2004,NA,NA,579,340,239,248,92,156,0.45,0.38,0.43,17990,40,137,515
150066,Anderson University,1,0,2005,NA,NA,565,348,217,272,93,179,0.51,0.43,0.48,18900,44,141,500
150066,Anderson University,1,0,2006,NA,NA,447,245,202,206,83,123,0.5,0.41,0.46,19990,46,148,397
150066,Anderson University,1,0,2007,NA,NA,479,239,240,216,90,126,0.52,0.38,0.45,20976,48,145,414
150066,Anderson University,1,0,2008,NA,NA,540,316,224,259,97,162,0.51,0.43,0.48,21920,48,140,470
150066,Anderson University,1,0,2009,NA,NA,547,313,234,238,83,155,0.49,0.35,0.44,22910,50,146,478
150066,Anderson University,1,0,2010,NA,NA,469,264,205,230,79,151,0.5700000000000001,0.39,0.49,23940,50,138,377
150136,BALL STATE UNIVERSITY,1,0,1991,NA,NA,3447,1976,1471,1555,602,953,0.48,0.41,0.45,2280,216,943,3132
150136,BALL STATE UNIVERSITY,1,0,1992,NA,NA,3265,1841,1424,699,236,463,0.25,0.17,0.21,2464,230,939,2983
150136,BALL STATE UNIVERSITY,1,0,1993,NA,NA,3872,2104,1768,701,230,471,0.22,0.13,0.18,2656,233,965,3496
150136,BALL STATE UNIVERSITY,1,0,1995,NA,NA,3855,2068,1787,787,262,525,0.25,0.15,0.2,3048,246,906,3463
150136,BALL STATE UNIVERSITY,1,0,1996,NA,NA,3763,1959,1804,726,241,485,0.24,0.13,0.19,3188,258,893,3377
150136,BALL STATE UNIVERSITY,1,0,1997,NA,NA,4047,2177,1870,837,242,595,0.27,0.13,0.21,3316,268,870,3537
150136,BALL STATE UNIVERSITY,1,0,1998,NA,NA,3512,1905,1607,896,311,585,0.3,0.19,0.26,3454,277,863,3126
150136,BALL STATE UNIVERSITY,1,0,1999,NA,NA,3602,1931,1671,943,348,595,0.3,0.21,0.26,3576,280,841,3171
150136,BALL STATE UNIVERSITY,1,0,2000,NA,NA,3694,2023,1671,1062,372,690,0.34,0.22,0.29,3720,288,862,3242
150136,BALL STATE UNIVERSITY,1,0,2001,NA,NA,3743,2039,1704,1066,344,722,0.35000000000000003,0.2,0.28,3924,305,883,3338
150136,BALL STATE UNIVERSITY,1,0,2002,NA,NA,4010,2207,1803,1327,507,820,0.37,0.28,0.33,4320,288,858,3571
150136,BALL STATE UNIVERSITY,1,0,2003,NA,NA,3963,2139,1824,1329,507,822,0.38,0.28,0.34,4532,303,896,3627
150136,BALL STATE UNIVERSITY,1,0,2004,NA,NA,3662,1951,1711,1141,390,751,0.38,0.23,0.31,5264,314,903,3274
150136,Ball State University,1,0,2005,NA,NA,3660,1892,1768,1063,367,696,0.36,0.21,0.29,6030,328,910,3165
150136,Ball State University,1,0,2006,NA,NA,3947,2027,1920,1155,425,730,0.36,0.22,0.29,6360,342,915,3418
150136,Ball State University,1,0,2007,NA,NA,3747,2033,1714,1223,432,791,0.38,0.25,0.33,6736,356,917,3204
150136,Ball State University,1,0,2008,NA,NA,3983,2188,1795,1384,504,880,0.4,0.28,0.35,7000,385,925,3447
150136,Ball State University,1,0,2009,NA,NA,4131,2240,1891,1542,570,972,0.43,0.3,0.37,7228,396,940,3494
150136,Ball State University,1,0,2010,NA,NA,3849,2123,1726,1588,560,1028,0.48,0.32,0.41,7508,405,950,3259
150145,BETHEL COLLEGE,1,0,1991,NA,NA,116,61,55,29,17,12,0.19,0.31,0.25,7500,6,33,111
150145,BETHEL COLLEGE,1,0,1992,NA,NA,152,88,64,48,16,32,0.36,0.25,0.32,7950,7,33,132
150145,BETHEL COLLEGE,1,0,1993,NA,NA,168,95,73,62,23,39,0.41000000000000003,0.32,0.37,8700,8,36,158
150145,BETHEL COLLEGE,1,0,1995,NA,NA,184,118,66,63,18,45,0.38,0.27,0.34,9750,10,48,166
150145,BETHEL COLLEGE,1,0,1996,NA,NA,201,117,84,68,22,46,0.39,0.26,0.34,10350,12,51,184
150145,BETHEL COLLEGE,1,0,1997,NA,NA,223,144,79,97,33,64,0.44,0.42,0.43,11100,12,58,201
150145,BETHEL COLLEGE,1,0,1998,NA,NA,273,173,100,104,36,68,0.39,0.36,0.38,11500,14,63,257
150145,BETHEL COLLEGE,1,0,1999,NA,NA,265,156,109,98,30,68,0.43,0.28,0.37,11950,15,68,250
150145,BETHEL COLLEGE,1,0,2000,NA,NA,294,182,112,114,41,73,0.4,0.37,0.39,12550,16,68,277
150145,BETHEL COLLEGE,1,0,2001,NA,NA,258,161,97,110,34,76,0.47000000000000003,0.35,0.43,13300,17,69,231
150145,BETHEL COLLEGE,1,0,2002,NA,NA,253,143,110,108,34,74,0.51,0.31,0.43,13990,18,76,231
150145,BETHEL COLLEGE,1,0,2003,NA,NA,291,175,116,117,39,78,0.44,0.34,0.4,14390,20,83,265
150145,BETHEL COLLEGE,1,0,2004,NA,NA,306,174,132,125,38,87,0.5,0.29,0.41,15200,22,88,278
150145,Bethel College,1,0,2005,NA,NA,310,207,103,122,41,81,0.39,0.4,0.39,15950,24,84,283
150145,Bethel College,1,0,2006,NA,NA,303,190,113,136,41,95,0.5,0.36,0.45,17450,26,88,259
150145,Bethel College,1,0,2007,NA,NA,249,159,90,106,33,73,0.45,0.37,0.43,18600,27,84,204
150145,Bethel College,1,0,2008,NA,NA,242,149,93,132,45,87,0.58,0.48,0.55,19996,31,91,199
150145,Bethel College,1,0,2009,NA,NA,295,175,120,165,60,105,0.6,0.5,0.56,20978,30,91,263
150145,Bethel College-Mishawaka,1,0,2010,NA,NA,269,169,100,144,51,93,0.55,0.51,0.54,21990,30,88,225
150163,BUTLER UNIVERSITY,1,0,1991,NA,NA,622,363,259,252,94,158,0.43,0.36,0.41,10500,47,217,550
150163,BUTLER UNIVERSITY,1,0,1992,NA,NA,666,383,283,257,98,159,0.41000000000000003,0.35,0.39,11340,52,216,613
150163,BUTLER UNIVERSITY,1,0,1993,NA,NA,700,437,263,288,94,194,0.44,0.36,0.41,12280,58,220,646
150163,BUTLER UNIVERSITY,1,0,1995,NA,NA,847,510,337,409,145,264,0.51,0.43,0.48,13990,62,231,757
150163,BUTLER UNIVERSITY,1,0,1996,NA,NA,777,475,302,426,137,289,0.6,0.45,0.55,14900,72,230,626
150163,BUTLER UNIVERSITY,1,0,1997,NA,NA,699,458,241,369,120,249,0.54,0.5,0.53,15570,67,227,541
150163,BUTLER UNIVERSITY,1,0,1998,NA,NA,912,557,355,452,145,307,0.55,0.41,0.5,16280,71,239,821
150163,BUTLER UNIVERSITY,1,0,1999,NA,NA,861,529,332,470,168,302,0.5700000000000001,0.51,0.55,17180,82,245,700
150163,BUTLER UNIVERSITY,1,0,2000,NA,NA,868,559,309,516,182,334,0.59,0.59,0.59,18040,80,260,736
150163,BUTLER UNIVERSITY,1,0,2001,NA,NA,929,593,336,512,168,344,0.58,0.5,0.55,18940,81,275,822
150163,BUTLER UNIVERSITY,1,0,2002,NA,NA,936,595,341,485,157,328,0.55,0.46,0.52,19990,81,257,836
150163,BUTLER UNIVERSITY,1,0,2003,NA,NA,972,612,360,550,184,366,0.59,0.51,0.57,20990,83,289,803
150163,BUTLER UNIVERSITY,1,0,2004,NA,NA,925,571,354,458,143,315,0.55,0.4,0.5,22250,87,272,799
150163,Butler University,1,0,2005,NA,NA,864,536,328,391,119,272,0.5,0.36,0.45,23530,90,285,752
150163,Butler University,1,0,2006,NA,NA,965,604,361,479,150,329,0.54,0.42,0.5,24710,95,291,811
150163,Butler University,1,0,2007,NA,NA,987,613,374,502,157,345,0.56,0.42,0.51,26070,103,305,864
150163,Butler University,1,0,2008,NA,NA,934,566,368,580,209,371,0.65,0.57,0.62,27500,112,307,788
150163,Butler University,1,0,2009,NA,NA,944,571,373,501,166,335,0.58,0.45,0.53,28460,118,325,804
150163,Butler University,1,0,2010,NA,NA,1049,616,433,600,211,389,0.63,0.49,0.57,29740,123,332,863
150400,DEPAUW UNIVERSITY,1,0,1991,NA,NA,475,258,217,367,157,210,0.81,0.72,0.77,12288,44,155,404
150400,DEPAUW UNIVERSITY,1,0,1992,NA,NA,566,326,240,410,169,241,0.73,0.7,0.72,13000,44,149,471
150400,DEPAUW UNIVERSITY,1,0,1993,NA,NA,495,250,245,361,179,182,0.72,0.73,0.73,13700,49,146,440
150400,DEPAUW UNIVERSITY,1,0,1995,NA,NA,580,328,252,434,187,247,0.75,0.74,0.75,15475,47,146,479
150400,DEPAUW UNIVERSITY,1,0,1996,NA,NA,619,351,268,450,192,258,0.73,0.72,0.73,16180,53,148,538
150400,DEPAUW UNIVERSITY,1,0,1997,NA,NA,673,363,310,493,228,265,0.73,0.74,0.73,17050,62,153,591
150400,DEPAUW UNIVERSITY,1,0,1998,NA,NA,593,344,249,423,164,259,0.75,0.66,0.71,17650,67,149,510
150400,DEPAUW UNIVERSITY,1,0,1999,NA,NA,579,327,252,436,194,242,0.74,0.77,0.75,19420,73,167,491
150400,DEPAUW UNIVERSITY,1,0,2000,NA,NA,610,336,274,479,202,277,0.8200000000000001,0.74,0.79,20200,80,174,537
150400,DEPAUW UNIVERSITY,1,0,2001,NA,NA,620,350,270,481,205,276,0.78,0.76,0.78,21100,90,182,543
150400,DEPAUW UNIVERSITY,1,0,2002,NA,NA,685,369,316,566,259,307,0.8300000000000001,0.82,0.83,22400,94,185,590
150400,DEPAUW UNIVERSITY,1,0,2003,NA,NA,580,305,275,456,202,254,0.8300000000000001,0.73,0.79,24000,106,209,480
150400,DEPAUW UNIVERSITY,1,0,2004,NA,NA,661,367,294,546,229,317,0.86,0.78,0.83,25000,108,213,572
150400,DePauw University,1,0,2005,NA,NA,586,337,249,470,197,273,0.81,0.79,0.8,26100,112,226,505
150400,DePauw University,1,0,2006,NA,NA,595,334,261,442,186,256,0.76,0.71,0.74,27400,120,221,476
150400,DePauw University,1,0,2007,NA,NA,664,369,295,493,211,282,0.76,0.72,0.74,29300,122,216,524
150400,DePauw University,1,0,2008,NA,NA,600,341,259,448,172,276,0.8,0.66,0.75,31400,93,227,437
150400,DePauw University,1,0,2009,NA,NA,717,405,312,543,222,321,0.79,0.71,0.76,32800,94,220,515
150400,DePauw University,1,0,2010,NA,NA,608,345,263,474,202,272,0.78,0.77,0.78,34440,91,215,400
150534,UNIVERSITY OF EVANSVILLE,1,0,1991,NA,NA,694,403,291,281,101,180,0.44,0.35,0.4,9910,35,154,614
150534,UNIVERSITY OF EVANSVILLE,1,0,1992,NA,NA,754,435,319,322,117,205,0.47000000000000003,0.37,0.43,10700,40,165,677
150534,UNIVERSITY OF EVANSVILLE,1,0,1993,NA,NA,746,424,322,296,113,183,0.43,0.35,0.4,11130,45,170,651
150534,UNIVERSITY OF EVANSVILLE,1,0,1995,NA,NA,826,504,322,370,131,239,0.47000000000000003,0.41,0.45,12600,54,176,710
150534,UNIVERSITY OF EVANSVILLE,1,0,1996,NA,NA,694,428,266,294,99,195,0.45,0.37,0.42,13220,60,183,588
150534,UNIVERSITY OF EVANSVILLE,1,0,1997,NA,NA,719,424,295,312,108,204,0.48,0.37,0.43,13600,43,182,616
150534,UNIVERSITY OF EVANSVILLE,1,0,1998,NA,NA,665,423,242,293,92,201,0.47000000000000003,0.38,0.44,14400,45,176,545
150534,UNIVERSITY OF EVANSVILLE,1,0,1999,NA,NA,594,367,227,276,97,179,0.48,0.43,0.46,15200,46,177,474
150534,UNIVERSITY OF EVANSVILLE,1,0,2000,NA,NA,555,320,235,237,84,153,0.47000000000000003,0.36,0.43,16100,47,175,422
150534,UNIVERSITY OF EVANSVILLE,1,0,2001,NA,NA,511,310,201,226,93,133,0.42,0.46,0.44,17050,48,173,324
150534,UNIVERSITY OF EVANSVILLE,1,0,2002,NA,NA,600,369,231,289,100,189,0.51,0.43,0.48,17900,47,168,385
150534,UNIVERSITY OF EVANSVILLE,1,0,2003,NA,NA,662,418,244,346,119,227,0.54,0.49,0.52,18900,49,168,456
150534,UNIVERSITY OF EVANSVILLE,1,0,2004,NA,NA,634,382,252,357,131,226,0.59,0.52,0.56,19995,51,167,508
150534,University of Evansville,1,0,2005,NA,NA,670,416,254,337,105,232,0.55,0.41,0.5,21120,54,174,535
150534,University of Evansville,1,0,2006,NA,NA,643,379,264,359,139,220,0.58,0.53,0.56,22370,58,179,527
150534,University of Evansville,1,0,2007,NA,NA,651,375,276,344,129,215,0.5700000000000001,0.47,0.53,23710,66,177,510
150534,University of Evansville,1,0,2008,NA,NA,616,377,239,325,116,209,0.55,0.49,0.53,25130,64,176,490
150534,University of Evansville,1,0,2009,NA,NA,701,433,268,403,152,251,0.5700000000000001,0.57,0.57,26010,65,172,574
150534,University of Evansville,1,0,2010,NA,NA,683,403,280,398,136,262,0.65,0.49,0.58,27310,67,174,570
150668,GOSHEN COLLEGE,0,1,1991,1995,0,194,106,88,83,30,53,0.5,0.34,0.43,7720,14,72,167
150668,GOSHEN COLLEGE,0,1,1992,1995,0,201,104,97,73,37,36,0.34,0.38,0.36,8310,14,74,177
150668,GOSHEN COLLEGE,0,1,1993,1995,0,229,140,89,88,34,54,0.38,0.38,0.38,8770,15,84,196
150668,GOSHEN COLLEGE,1,0,1995,1995,1,213,111,102,104,40,64,0.5700000000000001,0.39,0.49,9900,19,74,192
150668,GOSHEN COLLEGE,1,0,1996,1995,1,197,107,90,90,39,51,0.47000000000000003,0.43,0.46,10900,19,74,182
150668,GOSHEN COLLEGE,1,0,1997,1995,1,209,116,93,89,32,57,0.49,0.34,0.43,11450,17,67,180
150668,GOSHEN COLLEGE,1,0,1998,1995,1,207,121,86,99,39,60,0.49,0.45,0.48,12150,17,72,181
150668,GOSHEN COLLEGE,1,0,1999,1995,1,220,135,85,90,30,60,0.44,0.35,0.41,12320,19,76,190
150668,GOSHEN COLLEGE,1,0,2000,1995,1,194,113,81,87,30,57,0.5,0.37,0.45,12870,20,77,158
150668,GOSHEN COLLEGE,1,0,2001,1995,1,172,94,78,87,33,54,0.5700000000000001,0.42,0.51,13600,22,78,140
150668,GOSHEN COLLEGE,1,0,2002,1995,1,133,81,52,74,28,46,0.56,0.54,0.56,14700,25,75,107
150668,GOSHEN COLLEGE,1,0,2003,1995,1,181,99,82,101,41,60,0.6,0.5,0.56,16320,25,69,157
150668,GOSHEN COLLEGE,1,0,2004,1995,1,168,95,73,84,38,46,0.48,0.52,0.5,18200,25,65,143
150668,Goshen College,1,0,2005,1995,1,194,108,86,113,44,69,0.63,0.51,0.58,19300,26,72,162
150668,Goshen College,1,0,2006,1995,1,206,122,84,114,44,70,0.5700000000000001,0.52,0.55,20300,26,73,172
150668,Goshen College,1,0,2007,1995,1,202,114,88,110,44,66,0.5700000000000001,0.5,0.54,21300,28,71,160
150668,Goshen College,1,0,2008,1995,1,172,97,75,95,36,59,0.6,0.48,0.55,22300,30,67,131
150668,Goshen College,1,0,2009,1995,1,238,148,90,126,45,81,0.54,0.5,0.53,23400,30,67,196
150668,Goshen College,1,0,2010,1995,1,179,106,73,100,39,61,0.5700000000000001,0.53,0.56,24500,29,72,128
150941,HUNTINGTON COLLEGE,1,0,1991,NA,NA,154,76,78,55,30,25,0.32,0.38,0.36,7890,9,38,144
150941,HUNTINGTON COLLEGE,1,0,1992,NA,NA,150,92,58,75,24,51,0.55,0.41,0.5,8730,9,37,138
150941,HUNTINGTON COLLEGE,1,0,1993,NA,NA,124,69,55,64,26,38,0.55,0.47,0.52,9490,10,38,117
150941,HUNTINGTON COLLEGE,1,0,1995,NA,NA,191,113,78,87,27,60,0.53,0.35,0.46,10800,11,40,180
150941,HUNTINGTON COLLEGE,1,0,1996,NA,NA,174,104,70,95,37,58,0.55,0.53,0.55,11520,13,41,169
150941,HUNTINGTON COLLEGE,1,0,1997,NA,NA,197,129,68,95,21,74,0.5700000000000001,0.31,0.48,12180,14,43,193
150941,HUNTINGTON COLLEGE,1,0,1998,NA,NA,227,151,76,115,34,81,0.53,0.45,0.51,12250,16,49,221
150941,HUNTINGTON COLLEGE,1,0,1999,NA,NA,221,140,81,127,43,84,0.6,0.53,0.57,12780,13,52,214
150941,HUNTINGTON COLLEGE,1,0,2000,NA,NA,206,109,97,100,46,54,0.49,0.47,0.49,13540,15,53,200
150941,HUNTINGTON COLLEGE,1,0,2001,NA,NA,220,135,85,117,43,74,0.54,0.51,0.53,14270,16,55,212
150941,HUNTINGTON COLLEGE,1,0,2002,NA,NA,236,145,91,110,40,70,0.48,0.44,0.47,15520,17,56,224
150941,HUNTINGTON COLLEGE,1,0,2003,NA,NA,190,103,87,94,45,49,0.47000000000000003,0.52,0.49,16120,18,54,184
150941,HUNTINGTON COLLEGE,1,0,2004,NA,NA,203,123,80,108,44,64,0.52,0.55,0.53,18060,18,57,196
150941,Huntington University,1,0,2005,NA,NA,232,133,99,113,45,68,0.51,0.45,0.49,18060,19,61,219
150941,Huntington University,1,0,2006,NA,NA,250,140,110,126,52,74,0.52,0.47,0.5,18420,20,61,238
150941,Huntington University,1,0,2007,NA,NA,244,138,106,138,63,75,0.54,0.59,0.57,18980,21,61,233
150941,Huntington University,1,0,2008,NA,NA,275,161,114,133,51,82,0.5,0.45,0.48,19840,22,60,249
150941,Huntington University,1,0,2009,NA,NA,250,138,112,142,64,78,0.56,0.57,0.57,20820,24,62,229
150941,Huntington University,1,0,2010,NA,NA,263,146,117,144,62,82,0.56,0.53,0.55,21850,24,60,231
151102,INDIANA UNIVERSITY-PURDUE UNIVERSITY AT FORT WAYNE,1,0,1991,NA,NA,1134,607,527,34,17,17,0.02,0.03,0.03,1981,46,301,1052
151102,INDIANA UNIVERSITY-PURDUE UNIVERSITY AT FORT WAYNE,1,0,1992,NA,NA,1126,612,514,39,14,25,0.04,0.03,0.03,2144,51,307,1050
151102,INDIANA UNIVERSITY-PURDUE UNIVERSITY-FORT WAYNE,1,0,1993,NA,NA,1189,650,539,47,17,30,0.04,0.03,0.04,2310,63,306,1114
151102,INDIANA UNIVERSITY-PURDUE UNIVERSITY-FORT WAYNE,1,0,1995,NA,NA,1063,577,486,43,14,29,0.05,0.03,0.04,2709,54,307,977
151102,INDIANA UNIVERSITY-PURDUE UNIVERSITY-FORT WAYNE,1,0,1996,NA,NA,1196,647,549,44,16,28,0.04,0.03,0.04,3006,56,299,1094
151102,INDIANA UNIVERSITY-PURDUE UNIVERSITY-FORT WAYNE,1,0,1997,NA,NA,1196,659,537,49,7,42,0.06,0.01,0.04,3213,60,299,1086
151102,INDIANA UNIVERSITY-PURDUE UNIVERSITY-FORT WAYNE,1,0,1998,NA,NA,1303,673,630,38,16,22,0.03,0.03,0.03,3350,64,299,1166
151102,INDIANA UNIVERSITY-PURDUE UNIVERSITY-FORT WAYNE,1,0,1999,NA,NA,1303,688,615,48,16,32,0.04,0.03,0.04,3159,68,307,1199
151102,INDIANA UNIVERSITY-PURDUE UNIVERSITY-FORT WAYNE,1,0,2000,NA,NA,1337,723,614,48,22,26,0.03,0.04,0.04,3446,74,310,1248
151102,INDIANA UNIVERSITY-PURDUE UNIVERSITY-FORT WAYNE,1,0,2001,NA,NA,1426,735,691,69,30,39,0.05,0.04,0.05,2815,76,313,1307
151102,INDIANA UNIVERSITY-PURDUE UNIVERSITY-FORT WAYNE,1,0,2002,NA,NA,1409,782,627,61,24,37,0.04,0.04,0.04,3384,74,310,1296
151102,INDIANA UNIVERSITY-PURDUE UNIVERSITY-FORT WAYNE,1,0,2003,NA,NA,1366,757,609,76,29,47,0.06,0.05,0.06,4108,83,323,1218
151102,INDIANA UNIVERSITY-PURDUE UNIVERSITY-FORT WAYNE,1,0,2004,NA,NA,1553,859,694,103,29,74,0.08,0.04,0.07,4266,91,315,1352
151102,Indiana University-Purdue University-Fort Wayne,1,0,2005,NA,NA,1534,850,684,82,31,51,0.06,0.05,0.05,4523,105,306,1334
151102,Indiana University-Purdue University-Fort Wayne,1,0,2006,NA,NA,1608,859,749,61,20,41,0.04,0.03,0.04,4793,121,317,1407
151102,Indiana University-Purdue University-Fort Wayne,1,0,2007,NA,NA,1804,942,862,91,33,58,0.06,0.04,0.05,4982,107,338,1555
151102,Indiana University-Purdue University-Fort Wayne,1,0,2008,NA,NA,1905,1009,896,118,36,82,0.08,0.04,0.06,5181,123,342,1614
151102,Indiana University-Purdue University-Fort Wayne,1,0,2009,NA,NA,2040,1054,986,131,54,77,0.07,0.05,0.06,5441,123,342,1642
151102,Indiana University-Purdue University-Fort Wayne,1,0,2010,NA,NA,2117,1078,1039,134,47,87,0.08,0.05,0.06,5712,135,377,1654
151111,INDIANA UNIVERSITY-PURDUE UNIV AT INDIANAPOLIS,1,0,1991,NA,NA,1536,862,674,54,24,30,0.03,0.04,0.04,2277,626,696,1313
151111,INDIANA UNIVERSITY-PURDUE UNIV INDIANAPOLIS,1,0,1992,NA,NA,1507,837,670,42,18,24,0.02,0.03,0.03,2461,727,686,1300
151111,INDIANA UNIVERSITY-PURDUE UNIVERSITY-INDIANAPOLIS,1,0,1993,NA,NA,1509,830,679,70,29,41,0.04,0.04,0.05,2634,729,688,1342
151111,INDIANA UNIVERSITY-PURDUE UNIVERSITY-INDIANAPOLIS,1,0,1995,NA,NA,1860,1024,836,148,65,83,0.08,0.08,0.08,3156,814,672,1610
151111,INDIANA UNIVERSITY-PURDUE UNIVERSITY-INDIANAPOLIS,1,0,1996,NA,NA,2100,1172,928,87,30,57,0.04,0.03,0.04,3300,535,680,1733
151111,INDIANA UNIVERSITY-PURDUE UNIVERSITY-INDIANAPOLIS,1,0,1997,NA,NA,2154,1198,956,113,55,58,0.04,0.06,0.05,3441,585,705,1784
151111,INDIANA UNIVERSITY-PURDUE UNIVERSITY-INDIANAPOLIS,1,0,1998,NA,NA,2570,1387,1183,110,41,69,0.04,0.03,0.04,3576,632,689,2164
151111,INDIANA UNIVERSITY-PURDUE UNIVERSITY-INDIANAPOLIS,1,0,1999,NA,NA,2552,1409,1143,166,67,99,0.07,0.06,0.07,3432,657,683,2126
151111,INDIANA UNIVERSITY-PURDUE UNIVERSITY-INDIANAPOLIS,1,0,2000,NA,NA,2473,1414,1059,168,48,120,0.08,0.05,0.07,3570,711,708,2081
151111,INDIANA UNIVERSITY-PURDUE UNIVERSITY-INDIANAPOLIS,1,0,2001,NA,NA,2275,1325,950,188,71,117,0.08,0.07,0.08,3839,768,734,1911
151111,INDIANA UNIVERSITY-PURDUE UNIVERSITY-INDIANAPOLIS,1,0,2002,NA,NA,2235,1286,949,195,63,132,0.1,0.07,0.09,4183,776,809,1887
151111,INDIANA UNIVERSITY-PURDUE UNIVERSITY-INDIANAPOLIS,1,0,2003,NA,NA,2336,1361,975,210,79,131,0.09,0.08,0.09,5151,843,787,1964
151111,INDIANA UNIVERSITY-PURDUE UNIVERSITY-INDIANAPOLIS,1,0,2004,NA,NA,2294,1371,923,226,80,146,0.1,0.09,0.1,5357,846,854,1849
151111,Indiana University-Purdue University-Indianapolis,1,0,2005,NA,NA,2396,1414,982,234,88,146,0.1,0.09,0.1,5625,945,711,1895
151111,Indiana University-Purdue University-Indianapolis,1,0,2006,NA,NA,2516,1549,967,317,109,208,0.13,0.11,0.13,5924,994,736,1992
151111,Indiana University-Purdue University-Indianapolis,1,0,2007,NA,NA,2737,1659,1078,392,144,248,0.14,0.13,0.14,6221,990,738,2202
151111,Indiana University-Purdue University-Indianapolis,1,0,2008,NA,NA,2802,1657,1145,463,170,293,0.17,0.15,0.17,6531,1014,758,2204
151111,Indiana University-Purdue University-Indianapolis,1,0,2009,NA,NA,2794,1670,1124,500,187,313,0.18,0.17,0.18,6923,1071,789,2230
151111,Indiana University-Purdue University-Indianapolis,1,0,2010,NA,NA,2679,1607,1072,478,176,302,0.18,0.16,0.18,7255,1059,801,2036
151306,UNIVERSITY OF SOUTHERN INDIANA,1,0,1991,NA,NA,1078,611,467,86,24,62,0.1,0.05,0.08,1808,30,158,1030
151306,UNIVERSITY OF SOUTHERN INDIANA,1,0,1992,NA,NA,1080,624,456,90,27,63,0.1,0.06,0.08,2062,33,168,1014
151306,UNIVERSITY OF SOUTHERN INDIANA,1,0,1993,NA,NA,1162,681,481,79,21,58,0.08,0.04,0.07,2163,36,181,1096
151306,UNIVERSITY OF SOUTHERN INDIANA,1,0,1995,NA,NA,1407,813,594,138,30,108,0.13,0.05,0.1,2285,45,205,1305
151306,UNIVERSITY OF SOUTHERN INDIANA,1,0,1996,NA,NA,1573,912,661,173,45,128,0.14,0.07,0.11,2415,48,211,1496
151306,UNIVERSITY OF SOUTHERN INDIANA,1,0,1997,NA,NA,1839,1053,786,239,63,176,0.16,0.08,0.13,2565,55,220,1734
151306,UNIVERSITY OF SOUTHERN INDIANA,1,0,1998,NA,NA,1552,945,607,197,56,141,0.14,0.09,0.13,2780,63,238,1473
151306,UNIVERSITY OF SOUTHERN INDIANA,1,0,1999,NA,NA,1674,1003,671,200,49,151,0.15,0.07,0.12,2768,70,253,1591
151306,UNIVERSITY OF SOUTHERN INDIANA,1,0,2000,NA,NA,1729,1033,696,247,57,190,0.18,0.08,0.14,2626,78,258,1612
151306,UNIVERSITY OF SOUTHERN INDIANA,1,0,2001,NA,NA,1897,1135,762,236,64,172,0.15,0.08,0.12,2774,81,264,1788
151306,UNIVERSITY OF SOUTHERN INDIANA,1,0,2002,NA,NA,1891,1152,739,217,50,167,0.14,0.07,0.11,3051,81,276,1788
151306,UNIVERSITY OF SOUTHERN INDIANA,1,0,2003,NA,NA,1953,1151,802,271,78,193,0.16,0.1,0.14,3442,85,278,1835
151306,UNIVERSITY OF SOUTHERN INDIANA,1,0,2004,NA,NA,2004,1196,808,269,71,198,0.16,0.09,0.13,3676,96,284,1849
151306,University of Southern Indiana,1,0,2005,NA,NA,2042,1195,847,306,90,216,0.18,0.11,0.15,3807,101,311,1890
151306,University of Southern Indiana,1,0,2006,NA,NA,2021,1253,768,321,70,251,0.2,0.09,0.16,4014,109,296,1843
151306,University of Southern Indiana,1,0,2007,NA,NA,2074,1209,865,299,74,225,0.18,0.09,0.14,4258,112,307,1868
151306,University of Southern Indiana,1,0,2008,NA,NA,2055,1232,823,340,83,257,0.2,0.1,0.17,4509,115,323,1794
151306,University of Southern Indiana,1,0,2009,NA,NA,2048,1199,849,420,100,320,0.26,0.12,0.21,5274,120,343,1809
151306,University of Southern Indiana,1,0,2010,NA,NA,2041,1179,862,378,115,263,0.22,0.13,0.19,5540,127,349,1757
151324,INDIANA STATE UNIVERSITY,1,0,1991,NA,NA,1919,969,950,276,114,162,0.16,0.12,0.14,2272,131,605,1677
151324,INDIANA STATE UNIVERSITY,1,0,1992,NA,NA,2187,1161,1026,339,124,215,0.18,0.12,0.16,2452,131,560,1871
151324,INDIANA STATE UNIVERSITY,1,0,1993,NA,NA,2221,1165,1056,334,128,206,0.17,0.12,0.15,2622,129,548,1939
151324,INDIANA STATE UNIVERSITY,1,0,1995,NA,NA,1980,1032,948,350,132,218,0.21,0.14,0.18,2928,140,549,1661
151324,INDIANA STATE UNIVERSITY,1,0,1996,NA,NA,1911,1026,885,355,111,244,0.23,0.13,0.19,3072,145,535,1606
151324,INDIANA STATE UNIVERSITY,1,0,1997,NA,NA,1878,998,880,356,127,229,0.22,0.14,0.19,3196,155,538,1573
151324,INDIANA STATE UNIVERSITY,1,0,1998,NA,NA,1994,1062,932,368,123,245,0.23,0.13,0.18,3324,157,532,1653
151324,INDIANA STATE UNIVERSITY,1,0,1999,NA,NA,2014,998,1016,352,132,220,0.22,0.13,0.17,3426,166,524,1665
151324,INDIANA STATE UNIVERSITY,1,0,2000,NA,NA,2124,1122,1002,404,126,278,0.24,0.13,0.19,3564,177,547,1766
151324,INDIANA STATE UNIVERSITY,1,0,2001,NA,NA,2156,1166,990,413,148,265,0.22,0.15,0.19,3672,182,571,1746
151324,INDIANA STATE UNIVERSITY,1,0,2002,NA,NA,2083,1065,1018,393,143,250,0.23,0.14,0.19,4116,173,539,1719
151324,INDIANA STATE UNIVERSITY,1,0,2003,NA,NA,1974,974,1000,351,128,223,0.22,0.13,0.18,5322,176,557,1603
151324,INDIANA STATE UNIVERSITY,1,0,2004,NA,NA,1813,901,912,341,128,213,0.23,0.14,0.19,5536,181,544,1445
151324,Indiana State University,1,0,2005,NA,NA,1622,810,812,311,122,189,0.23,0.15,0.19,5756,179,509,1287
151324,Indiana State University,1,0,2006,NA,NA,1657,827,830,335,125,210,0.25,0.15,0.2,6102,174,467,1250
151324,Indiana State University,1,0,2007,NA,NA,1820,924,896,375,138,237,0.25,0.15,0.21,6462,176,461,1365
151324,Indiana State University,1,0,2008,NA,NA,1907,954,953,357,151,206,0.21,0.16,0.19,6792,186,454,1405
151324,Indiana State University,1,0,2009,NA,NA,1969,954,1015,393,183,210,0.22,0.18,0.2,7226,195,447,1412
151324,Indiana State University,1,0,2010,NA,NA,2687,1352,1335,497,199,298,0.22,0.15,0.18,7514,198,436,1816
151333,INDIANA UNIVERSITY AT KOKOMO,1,0,1991,NA,NA,315,199,116,8,1,7,0.03,0.01,0.03,1938,13,73,300
151333,INDIANA UNIVERSITY KOKOMO,1,0,1992,NA,NA,304,200,104,15,4,11,0.05,0.04,0.05,2099,15,77,286
151333,INDIANA UNIVERSITY-KOKOMO,1,0,1993,NA,NA,330,208,122,14,7,7,0.03,0.06,0.04,2244,17,81,319
151333,INDIANA UNIVERSITY-KOKOMO,1,0,1995,NA,NA,294,184,110,27,7,20,0.1,0.06,0.09,2599,19,78,276
151333,INDIANA UNIVERSITY-KOKOMO,1,0,1996,NA,NA,339,227,112,20,6,14,0.06,0.05,0.06,2757,19,69,319
151333,INDIANA UNIVERSITY-KOKOMO,1,0,1997,NA,NA,306,204,102,17,5,12,0.05,0.05,0.06,2890,19,72,291
151333,INDIANA UNIVERSITY-KOKOMO,1,0,1998,NA,NA,333,230,103,25,2,23,0.1,0.02,0.08,3004,20,69,319
151333,INDIANA UNIVERSITY-KOKOMO,1,0,1999,NA,NA,295,213,82,27,7,20,0.09,0.09,0.09,2922,21,67,283
151333,INDIANA UNIVERSITY-KOKOMO,1,0,2000,NA,NA,347,223,124,28,9,19,0.08,0.07,0.08,3024,22,67,334
151333,INDIANA UNIVERSITY-KOKOMO,1,0,2001,NA,NA,343,233,110,36,8,28,0.12,0.07,0.1,3221,22,68,314
151333,INDIANA UNIVERSITY-KOKOMO,1,0,2002,NA,NA,339,226,113,28,5,23,0.1,0.04,0.08,3478,22,74,311
151333,INDIANA UNIVERSITY-KOKOMO,1,0,2003,NA,NA,382,264,118,27,5,22,0.08,0.04,0.07,4117,24,77,358
151333,INDIANA UNIVERSITY-KOKOMO,1,0,2004,NA,NA,356,237,119,18,5,13,0.05,0.04,0.05,4283,22,83,328
151333,Indiana University-Kokomo,1,0,2005,NA,NA,382,251,131,31,6,25,0.09,0.05,0.08,4475,25,85,360
151333,Indiana University-Kokomo,1,0,2006,NA,NA,329,210,119,26,6,20,0.09,0.05,0.08,4694,26,86,297
151333,Indiana University-Kokomo,1,0,2007,NA,NA,381,234,147,27,6,21,0.08,0.04,0.07,4928,26,84,343
151333,Indiana University-Kokomo,1,0,2008,NA,NA,341,212,129,31,6,25,0.11,0.05,0.09,5174,26,80,306
151333,Indiana University-Kokomo,1,0,2009,NA,NA,406,232,174,51,14,37,0.15,0.08,0.13,5408,26,72,350
151333,Indiana University-Kokomo,1,0,2010,NA,NA,345,217,128,59,23,36,0.16,0.18,0.17,5663,26,76,314
151342,INDIANA UNIVERSITY AT SOUTH BEND,1,0,1991,NA,NA,554,352,202,40,15,25,0.07,0.07,0.07,1952,29,171,481
151342,INDIANA UNIVERSITY SOUTH BEND,1,0,1992,NA,NA,564,337,227,34,11,23,0.06,0.05,0.06,2105,34,171,499
151342,INDIANA UNIVERSITY-SOUTH BEND,1,0,1993,NA,NA,554,360,194,32,16,16,0.04,0.08,0.06,2290,37,175,485
151342,INDIANA UNIVERSITY-SOUTH BEND,1,0,1995,NA,NA,626,374,252,51,19,32,0.08,0.08,0.08,2742,40,182,532
151342,INDIANA UNIVERSITY-SOUTH BEND,1,0,1996,NA,NA,593,360,233,41,9,32,0.08,0.04,0.07,2856,40,180,490
151342,INDIANA UNIVERSITY-SOUTH BEND,1,0,1997,NA,NA,629,384,245,47,20,27,0.07,0.08,0.07,2985,41,183,529
151342,INDIANA UNIVERSITY-SOUTH BEND,1,0,1998,NA,NA,732,427,305,31,14,17,0.03,0.05,0.04,3096,47,200,624
151342,INDIANA UNIVERSITY-SOUTH BEND,1,0,1999,NA,NA,637,382,255,37,10,27,0.07,0.04,0.06,2974,49,202,562
151342,INDIANA UNIVERSITY-SOUTH BEND,1,0,2000,NA,NA,637,349,288,22,6,16,0.04,0.02,0.03,3078,51,207,562
151342,INDIANA UNIVERSITY-SOUTH BEND,1,0,2001,NA,NA,750,449,301,40,15,25,0.05,0.05,0.05,3278,54,212,639
151342,INDIANA UNIVERSITY-SOUTH BEND,1,0,2002,NA,NA,660,390,270,36,9,27,0.06,0.03,0.05,3543,68,219,563
151342,INDIANA UNIVERSITY-SOUTH BEND,1,0,2003,NA,NA,707,417,290,42,18,24,0.05,0.06,0.06,4180,57,220,619
151342,INDIANA UNIVERSITY-SOUTH BEND,1,0,2004,NA,NA,704,432,272,29,11,18,0.04,0.04,0.04,4349,54,237,589
151342,Indiana University-South Bend,1,0,2005,NA,NA,805,466,339,34,16,18,0.03,0.05,0.04,4583,65,233,685
151342,Indiana University-South Bend,1,0,2006,NA,NA,772,427,345,31,16,15,0.03,0.05,0.04,4826,67,234,629
151342,Indiana University-South Bend,1,0,2007,NA,NA,876,524,352,44,26,18,0.03,0.07,0.05,5069,64,237,729
151342,Indiana University-South Bend,1,0,2008,NA,NA,943,590,353,54,23,31,0.05,0.07,0.06,5324,75,235,729
151342,Indiana University-South Bend,1,0,2009,NA,NA,1045,611,434,60,21,39,0.06,0.05,0.06,5573,67,251,827
151342,Indiana University-South Bend,1,0,2010,NA,NA,895,503,392,61,25,36,0.07,0.06,0.07,5843,68,248,684
151351,INDIANA UNIVERSITY BLOOMINGTON,1,0,1991,NA,NA,5208,3013,2195,2205,881,1324,0.43,0.4,0.42,2484,532,1428,4596
151351,INDIANA UNIVERSITY BLOOMINGTON,1,0,1992,NA,NA,5529,3233,2296,2231,840,1391,0.43,0.37,0.4,2794,588,1374,4881
151351,INDIANA UNIVERSITY-BLOOMINGTON,1,0,1993,NA,NA,5833,3340,2493,2427,906,1521,0.45,0.36,0.42,2988,580,1361,5174
151351,INDIANA UNIVERSITY-BLOOMINGTON,1,0,1995,NA,NA,5705,3293,2412,3057,1182,1875,0.56,0.49,0.54,3582,682,1344,4952
151351,INDIANA UNIVERSITY-BLOOMINGTON,1,0,1996,NA,NA,5766,3376,2390,2660,975,1685,0.49,0.41,0.46,3783,853,1350,5043
151351,INDIANA UNIVERSITY-BLOOMINGTON,1,0,1997,NA,NA,6036,3497,2539,2827,1045,1782,0.5,0.41,0.47,3929,789,1404,5294
151351,INDIANA UNIVERSITY-BLOOMINGTON,1,0,1998,NA,NA,6735,3810,2925,2747,1088,1659,0.43,0.37,0.41,4068,943,1411,5937
151351,INDIANA UNIVERSITY-BLOOMINGTON,1,0,1999,NA,NA,6503,3828,2675,3137,1138,1999,0.52,0.43,0.48,3752,944,1396,5683
151351,INDIANA UNIVERSITY-BLOOMINGTON,1,0,2000,NA,NA,6862,3839,3023,3421,1362,2059,0.53,0.45,0.5,3902,1028,1384,5994
151351,INDIANA UNIVERSITY-BLOOMINGTON,1,0,2001,NA,NA,6728,3716,3012,3353,1424,1929,0.51,0.47,0.5,4196,1079,1373,5859
151351,INDIANA UNIVERSITY-BLOOMINGTON,1,0,2002,NA,NA,6987,3895,3092,3546,1471,2075,0.53,0.48,0.51,4573,836,1432,6102
151351,INDIANA UNIVERSITY-BLOOMINGTON,1,0,2003,NA,NA,6739,3773,2966,3490,1419,2071,0.54,0.48,0.52,5756,851,1486,5809
151351,INDIANA UNIVERSITY-BLOOMINGTON,1,0,2004,NA,NA,6300,3407,2893,3110,1273,1837,0.53,0.44,0.49,5986,881,1562,5340
151351,Indiana University-Bloomington,1,0,2005,NA,NA,6903,3785,3118,3425,1383,2042,0.53,0.44,0.5,6291,941,1589,5778
151351,Indiana University-Bloomington,1,0,2006,NA,NA,7208,3875,3333,3949,1681,2268,0.58,0.5,0.55,6657,979,1615,6087
151351,Indiana University-Bloomington,1,0,2007,NA,NA,7167,3707,3460,4169,1874,2295,0.61,0.54,0.58,7000,1089,1640,5975
151351,Indiana University-Bloomington,1,0,2008,NA,NA,7550,3990,3560,4485,1959,2526,0.63,0.55,0.59,7368,1136,1682,6307
151351,Indiana University-Bloomington,1,0,2009,NA,NA,7301,3640,3661,4387,2001,2386,0.65,0.55,0.6,7722,1197,1721,5833
151351,Indiana University-Bloomington,1,0,2010,NA,NA,6977,3659,3318,4165,1805,2360,0.64,0.54,0.6,8124,1233,1726,5174
151360,INDIANA UNIVERSITY NORTHWEST,1,0,1991,NA,NA,614,396,218,35,14,21,0.05,0.06,0.06,1952,24,134,447
151360,INDIANA UNIVERSITY NORTHWEST,1,0,1992,NA,NA,597,386,211,26,9,17,0.04,0.04,0.04,2105,27,151,405
151360,INDIANA UNIVERSITY-NORTHWEST,1,0,1993,NA,NA,665,415,250,26,13,13,0.03,0.05,0.04,2250,30,152,473
151360,INDIANA UNIVERSITY-NORTHWEST,1,0,1995,NA,NA,599,383,216,42,13,29,0.07,0.06,0.07,2595,34,150,376
151360,INDIANA UNIVERSITY-NORTHWEST,1,0,1996,NA,NA,560,355,205,37,14,23,0.06,0.07,0.07,2768,34,143,368
151360,INDIANA UNIVERSITY-NORTHWEST,1,0,1997,NA,NA,508,340,168,21,7,14,0.04,0.04,0.04,2883,34,147,315
151360,INDIANA UNIVERSITY-NORTHWEST,1,0,1998,NA,NA,535,347,188,31,8,23,0.06,0.04,0.06,3021,36,142,329
151360,INDIANA UNIVERSITY-NORTHWEST,1,0,1999,NA,NA,540,345,195,45,16,29,0.08,0.08,0.08,2955,37,138,352
151360,INDIANA UNIVERSITY-NORTHWEST,1,0,2000,NA,NA,517,318,199,33,16,17,0.05,0.08,0.06,3024,41,134,332
151360,INDIANA UNIVERSITY-NORTHWEST,1,0,2001,NA,NA,511,340,171,43,12,31,0.09,0.07,0.08,3221,41,130,330
151360,INDIANA UNIVERSITY-NORTHWEST,1,0,2002,NA,NA,602,365,237,39,14,25,0.06,0.06,0.06,3478,32,141,402
151360,INDIANA UNIVERSITY-NORTHWEST,1,0,2003,NA,NA,660,417,243,49,14,35,0.08,0.06,0.07,4117,42,165,433
151360,INDIANA UNIVERSITY-NORTHWEST,1,0,2004,NA,NA,604,375,229,28,10,18,0.04,0.04,0.05,4283,38,164,401
151360,Indiana University-Northwest,1,0,2005,NA,NA,471,280,191,33,19,14,0.05,0.1,0.07,4475,46,163,312
151360,Indiana University-Northwest,1,0,2006,NA,NA,561,352,209,31,8,23,0.06,0.04,0.06,4710,50,167,369
151360,Indiana University-Northwest,1,0,2007,NA,NA,556,356,200,38,13,25,0.07,0.06,0.07,4962,49,168,362
151360,Indiana University-Northwest,1,0,2008,NA,NA,596,387,209,47,13,34,0.08,0.06,0.08,5228,46,155,373
151360,Indiana University-Northwest,1,0,2009,NA,NA,773,483,290,70,22,48,0.09,0.08,0.09,5478,50,161,437
151360,Indiana University-Northwest,1,0,2010,NA,NA,784,495,289,47,13,34,0.06,0.04,0.06,5752,50,161,440
151379,INDIANA UNIVERSITY SOUTHEAST,1,0,1991,NA,NA,589,343,246,23,6,17,0.04,0.02,0.04,1962,22,114,572
151379,INDIANA UNIVERSITY SOUTHEAST,1,0,1992,NA,NA,638,381,257,27,6,21,0.05,0.02,0.04,2115,25,127,621
151379,INDIANA UNIVERSITY-SOUTHEAST,1,0,1993,NA,NA,700,392,308,37,12,25,0.06,0.04,0.05,2260,27,125,668
151379,INDIANA UNIVERSITY-SOUTHEAST,1,0,1995,NA,NA,593,357,236,74,27,47,0.13,0.11,0.12,2572,28,119,570
151379,INDIANA UNIVERSITY-SOUTHEAST,1,0,1996,NA,NA,643,375,268,60,18,42,0.11,0.07,0.09,2718,30,124,629
151379,INDIANA UNIVERSITY-SOUTHEAST,1,0,1997,NA,NA,641,376,265,57,12,45,0.11,0.05,0.09,2847,31,138,617
151379,INDIANA UNIVERSITY-SOUTHEAST,1,0,1998,NA,NA,727,407,320,28,6,22,0.05,0.02,0.04,2986,34,141,698
151379,INDIANA UNIVERSITY-SOUTHEAST,1,0,1999,NA,NA,719,448,271,54,13,41,0.09,0.05,0.08,2922,36,139,694
151379,INDIANA UNIVERSITY-SOUTHEAST,1,0,2000,NA,NA,700,413,287,57,18,39,0.09,0.06,0.08,3024,39,145,688
151379,INDIANA UNIVERSITY-SOUTHEAST,1,0,2001,NA,NA,722,440,282,57,13,44,0.1,0.05,0.08,3221,42,151,639
151379,INDIANA UNIVERSITY-SOUTHEAST,1,0,2002,NA,NA,678,419,259,53,11,42,0.1,0.04,0.08,3479,48,163,627
151379,INDIANA UNIVERSITY-SOUTHEAST,1,0,2003,NA,NA,674,400,274,53,15,38,0.09,0.05,0.08,4117,46,175,622
151379,INDIANA UNIVERSITY-SOUTHEAST,1,0,2004,NA,NA,714,420,294,63,12,51,0.12,0.04,0.09,4283,42,181,663
151379,Indiana University-Southeast,1,0,2005,NA,NA,664,409,255,53,12,41,0.1,0.05,0.08,4475,52,172,594
151379,Indiana University-Southeast,1,0,2006,NA,NA,727,430,297,63,24,39,0.09,0.08,0.09,4698,52,175,663
151379,Indiana University-Southeast,1,0,2007,NA,NA,783,449,334,69,21,48,0.1,0.06,0.09,4934,52,178,714
151379,Indiana University-Southeast,1,0,2008,NA,NA,970,590,380,81,26,55,0.09,0.07,0.08,5184,67,180,841
151379,Indiana University-Southeast,1,0,2009,NA,NA,995,612,383,80,27,53,0.08,0.07,0.08,5417,59,179,866
151379,Indiana University-Southeast,1,0,2010,NA,NA,945,581,364,111,29,82,0.14,0.08,0.12,5672,58,182,821
151388,INDIANA UNIVERSITY EAST,1,0,1991,NA,NA,222,146,76,2,0,2,0.01,0,0.01,1952,10,54,207
151388,INDIANA UNIVERSITY EAST,1,0,1992,NA,NA,263,197,66,8,2,6,0.03,0.03,0.03,2105,12,54,254
151388,INDIANA UNIVERSITY-EAST,1,0,1993,NA,NA,264,168,96,8,2,6,0.03,0.02,0.03,2250,14,59,247
151388,INDIANA UNIVERSITY-EAST,1,0,1995,NA,NA,242,144,98,12,5,7,0.04,0.05,0.05,2615,15,62,220
151388,INDIANA UNIVERSITY-EAST,1,0,1996,NA,NA,233,148,85,9,3,6,0.04,0.04,0.04,2728,16,62,220
151388,INDIANA UNIVERSITY-EAST,1,0,1997,NA,NA,278,193,85,14,7,7,0.03,0.08,0.05,2849,17,59,259
151388,INDIANA UNIVERSITY-EAST,1,0,1998,NA,NA,230,146,84,7,2,5,0.03,0.02,0.03,2987,18,59,210
151388,INDIANA UNIVERSITY-EAST,1,0,1999,NA,NA,255,161,94,10,1,9,0.05,0.01,0.04,2922,19,61,226
151388,INDIANA UNIVERSITY-EAST,1,0,2000,NA,NA,249,161,88,10,1,9,0.05,0.01,0.04,3024,21,60,230
151388,INDIANA UNIVERSITY-EAST,1,0,2001,NA,NA,264,172,92,18,5,13,0.07,0.05,0.07,3221,23,59,236
151388,INDIANA UNIVERSITY-EAST,1,0,2002,NA,NA,303,200,103,19,4,15,0.07,0.04,0.06,3478,18,69,281
151388,INDIANA UNIVERSITY-EAST,1,0,2003,NA,NA,318,203,115,20,7,13,0.06,0.06,0.06,4117,26,74,283
151388,INDIANA UNIVERSITY-EAST,1,0,2004,NA,NA,270,182,88,14,3,11,0.06,0.03,0.05,4283,23,77,250
151388,Indiana University-East,1,0,2005,NA,NA,284,179,105,13,2,11,0.06,0.02,0.05,4475,27,83,256
151388,Indiana University-East,1,0,2006,NA,NA,225,135,90,9,3,6,0.04,0.03,0.04,4697,26,78,209
151388,Indiana University-East,1,0,2007,NA,NA,264,157,107,22,4,18,0.11,0.04,0.08,4932,25,76,243
151388,Indiana University-East,1,0,2008,NA,NA,291,190,101,26,8,18,0.09,0.08,0.09,5178,24,71,262
151388,Indiana University-East,1,0,2009,NA,NA,358,217,141,51,11,40,0.18,0.08,0.14,5416,26,75,323
151388,Indiana University-East,1,0,2010,NA,NA,378,224,154,54,15,39,0.17,0.1,0.14,5676,28,72,347
151777,MANCHESTER COLLEGE,1,0,1991,NA,NA,277,146,131,121,48,73,0.5,0.37,0.44,8270,16,71,253
151777,MANCHESTER COLLEGE,1,0,1992,NA,NA,245,120,125,109,51,58,0.48,0.41,0.44,8960,17,71,225
151777,MANCHESTER COLLEGE,1,0,1993,NA,NA,238,118,120,94,43,51,0.43,0.36,0.39,9600,17,74,217
151777,MANCHESTER COLLEGE,1,0,1995,NA,NA,321,158,163,136,61,75,0.47000000000000003,0.37,0.42,11470,19,69,301
151777,MANCHESTER COLLEGE,1,0,1996,NA,NA,305,151,154,113,46,67,0.44,0.3,0.37,12120,21,70,278
151777,MANCHESTER COLLEGE,1,0,1997,NA,NA,288,135,153,122,47,75,0.55,0.31,0.42,12660,16,68,257
151777,MANCHESTER COLLEGE,1,0,1998,NA,NA,309,173,136,139,47,92,0.53,0.35,0.45,13280,17,65,287
151777,MANCHESTER COLLEGE,1,0,1999,NA,NA,328,166,162,132,41,91,0.54,0.25,0.4,13930,18,70,277
151777,MANCHESTER COLLEGE,1,0,2000,NA,NA,333,178,155,142,46,96,0.53,0.3,0.43,14510,19,70,292
151777,MANCHESTER COLLEGE,1,0,2001,NA,NA,334,179,155,145,53,92,0.51,0.34,0.43,15230,19,70,289
151777,MANCHESTER COLLEGE,1,0,2002,NA,NA,309,178,131,137,54,83,0.46,0.41,0.44,15990,19,67,269
151777,MANCHESTER COLLEGE,1,0,2003,NA,NA,335,168,167,127,53,74,0.44,0.32,0.38,16940,20,68,298
151777,MANCHESTER COLLEGE,1,0,2004,NA,NA,278,154,124,113,34,79,0.51,0.27,0.41,17950,21,67,243
151777,Manchester College,1,0,2005,NA,NA,329,170,159,140,50,90,0.52,0.31,0.43,18860,21,79,290
151777,Manchester College,1,0,2006,NA,NA,311,137,174,136,62,74,0.54,0.36,0.44,19800,23,73,270
151777,Manchester College,1,0,2007,NA,NA,316,147,169,126,55,71,0.48,0.33,0.4,21000,23,77,277
151777,Manchester College,1,0,2008,NA,NA,396,202,194,190,77,113,0.55,0.4,0.48,22000,24,69,346
151777,Manchester College,1,0,2009,NA,NA,426,210,216,198,88,110,0.52,0.41,0.46,23000,25,72,383
151777,Manchester College,1,0,2010,NA,NA,405,217,188,200,81,119,0.54,0.43,0.49,24100,25,74,349
151786,MARIAN COLLEGE,1,0,1991,NA,NA,217,154,63,53,13,40,0.25,0.21,0.24,7584,9,51,195
151786,MARIAN COLLEGE,1,0,1992,NA,NA,244,149,95,75,32,43,0.28,0.34,0.31,8594,13,76,113
151786,MARIAN COLLEGE,1,0,1993,NA,NA,239,150,89,74,23,51,0.34,0.26,0.31,9360,14,78,198
151786,MARIAN COLLEGE,1,0,1995,NA,NA,255,168,87,90,28,62,0.36,0.32,0.35,10824,16,74,190
151786,MARIAN COLLEGE,1,0,1996,NA,NA,221,151,70,67,16,51,0.33,0.23,0.3,11440,19,72,137
151786,MARIAN COLLEGE,1,0,1997,NA,NA,255,156,99,73,21,52,0.33,0.21,0.29,12458,14,72,196
151786,MARIAN COLLEGE,1,0,1998,NA,NA,205,158,47,70,14,56,0.35000000000000003,0.3,0.34,13406,15,56,162
151786,MARIAN COLLEGE,1,0,1999,NA,NA,251,181,70,88,19,69,0.38,0.27,0.35,14012,16,71,210
151786,MARIAN COLLEGE,1,0,2000,NA,NA,208,126,82,58,12,46,0.36,0.15,0.28,14432,16,67,185
151786,MARIAN COLLEGE,1,0,2001,NA,NA,183,113,70,66,21,45,0.39,0.3,0.36,15226,17,63,148
151786,MARIAN COLLEGE,1,0,2002,NA,NA,230,153,77,73,16,57,0.37,0.21,0.32,16000,17,62,186
151786,MARIAN COLLEGE,1,0,2003,NA,NA,239,162,77,71,27,44,0.27,0.35,0.3,16800,19,66,201
151786,MARIAN COLLEGE,1,0,2004,NA,NA,245,166,79,84,26,58,0.34,0.33,0.34,17600,20,70,210
151786,Marian College,1,0,2005,NA,NA,189,127,62,64,17,47,0.37,0.27,0.34,18400,23,72,154
151786,Marian College,1,0,2006,NA,NA,277,148,129,108,32,76,0.51,0.25,0.39,19900,24,71,240
151786,Marian College,1,0,2007,NA,NA,271,142,129,76,23,53,0.37,0.18,0.28,20800,26,67,224
151786,Marian College,1,0,2008,NA,NA,326,158,168,111,50,61,0.38,0.3,0.34,22400,29,81,262
151786,Marian University,1,0,2009,NA,NA,312,166,146,103,39,64,0.38,0.27,0.33,24000,32,86,250
151786,Marian University,1,0,2010,NA,NA,317,166,151,124,49,75,0.45,0.32,0.39,24960,34,91,266
152080,UNIVERSITY OF NOTRE DAME,1,0,1991,NA,NA,1880,717,1163,1635,988,647,0.9,0.85,0.87,6752,278,625,1567
152080,UNIVERSITY OF NOTRE DAME,1,0,1992,NA,NA,1879,822,1057,1631,900,731,0.88,0.85,0.87,14650,305,640,1580
152080,UNIVERSITY OF NOTRE DAME,1,0,1993,NA,NA,1901,851,1050,1685,910,775,0.91,0.87,0.89,15810,319,644,1602
152080,UNIVERSITY OF NOTRE DAME,1,0,1995,NA,NA,1902,870,1032,1667,887,780,0.89,0.86,0.88,17830,376,670,1586
152080,UNIVERSITY OF NOTRE DAME,1,0,1996,NA,NA,1920,862,1058,1698,915,783,0.9,0.86,0.88,18810,393,687,1589
152080,UNIVERSITY OF NOTRE DAME,1,0,1997,NA,NA,1904,875,1029,1675,879,796,0.9,0.85,0.88,19800,395,698,1620
152080,UNIVERSITY OF NOTRE DAME,1,0,1998,NA,NA,1937,895,1042,1706,891,815,0.91,0.86,0.88,20900,372,704,1633
152080,UNIVERSITY OF NOTRE DAME,1,0,1999,NA,NA,1967,932,1035,1739,880,859,0.92,0.85,0.88,22030,395,726,1627
152080,UNIVERSITY OF NOTRE DAME,1,0,2000,NA,NA,1955,919,1036,1757,921,836,0.9,0.89,0.9,23180,444,744,1580
152080,UNIVERSITY OF NOTRE DAME,1,0,2001,NA,NA,2036,958,1078,1825,956,869,0.9,0.89,0.9,24320,486,763,1636
152080,UNIVERSITY OF NOTRE DAME,1,0,2002,NA,NA,1945,935,1010,1765,909,856,0.91,0.9,0.91,25510,535,760,1561
152080,UNIVERSITY OF NOTRE DAME,1,0,2003,NA,NA,1995,928,1067,1797,955,842,0.9,0.9,0.9,27170,552,783,1511
152080,UNIVERSITY OF NOTRE DAME,1,0,2004,NA,NA,1987,947,1040,1789,914,875,0.92,0.88,0.9,29070,584,780,1513
152080,University of Notre Dame,1,0,2005,NA,NA,1990,935,1055,1800,942,858,0.91,0.89,0.9,31100,615,877,1493
152080,University of Notre Dame,1,0,2006,NA,NA,2029,928,1101,1800,962,838,0.9,0.87,0.89,32900,643,853,1445
152080,University of Notre Dame,1,0,2007,NA,NA,1984,948,1036,1782,913,869,0.91,0.88,0.9,34680,680,890,1471
152080,University of Notre Dame,1,0,2008,NA,NA,1991,951,1040,1806,932,874,0.91,0.9,0.91,36340,730,907,1515
152080,University of Notre Dame,1,0,2009,NA,NA,2055,930,1125,1867,1009,858,0.92,0.9,0.91,37970,773,947,1500
152080,University of Notre Dame,1,0,2010,NA,NA,2056,966,1090,1846,966,880,0.91,0.89,0.9,39412,829,982,1477
152248,PURDUE UNIVERSITY CALUMET CAMPUS,1,0,1991,NA,NA,921,466,455,17,6,11,0.02,0.01,0.02,1985,36,235,704
152248,PURDUE UNIVERSITY CALUMET CAMPUS,1,0,1992,NA,NA,985,535,450,22,8,14,0.02,0.02,0.02,2145,39,241,741
152248,PURDUE UNIVERSITY-CALUMET CAMPUS,1,0,1993,NA,NA,847,475,372,64,32,32,0.06,0.09,0.08,2290,43,247,607
152248,PURDUE UNIVERSITY-CALUMET CAMPUS,1,0,1995,NA,NA,906,487,419,71,21,50,0.1,0.05,0.08,2658,45,251,642
152248,PURDUE UNIVERSITY-CALUMET CAMPUS,1,0,1996,NA,NA,1026,558,468,92,42,50,0.08,0.09,0.09,2775,48,247,741
152248,PURDUE UNIVERSITY-CALUMET CAMPUS,1,0,1997,NA,NA,1071,556,515,101,49,52,0.09,0.1,0.09,2970,49,257,771
152248,PURDUE UNIVERSITY-CALUMET CAMPUS,1,0,1998,NA,NA,1062,560,502,38,17,21,0.03,0.03,0.04,3093,54,262,745
152248,PURDUE UNIVERSITY-CALUMET CAMPUS,1,0,1999,NA,NA,1112,593,519,42,13,29,0.04,0.03,0.04,2926,55,260,800
152248,PURDUE UNIVERSITY-CALUMET CAMPUS,1,0,2000,NA,NA,1043,577,466,37,14,23,0.03,0.03,0.04,3043,58,269,773
152248,PURDUE UNIVERSITY-CALUMET CAMPUS,1,0,2001,NA,NA,958,507,451,37,12,25,0.04,0.03,0.04,3272,65,278,713
152248,PURDUE UNIVERSITY-CALUMET CAMPUS,1,0,2002,NA,NA,927,474,453,36,16,20,0.04,0.04,0.04,3125,63,272,669
152248,PURDUE UNIVERSITY-CALUMET CAMPUS,1,0,2003,NA,NA,997,527,470,56,21,35,0.06,0.04,0.06,3708,65,273,741
152248,PURDUE UNIVERSITY-CALUMET CAMPUS,1,0,2004,NA,NA,954,492,462,55,24,31,0.06,0.05,0.06,3974,68,263,630
152248,Purdue University-Calumet Campus,1,0,2005,NA,NA,1093,599,494,57,23,34,0.05,0.05,0.05,4212,72,256,689
152248,Purdue University-Calumet Campus,1,0,2006,NA,NA,1036,546,490,52,19,33,0.06,0.04,0.05,4464,85,262,641
152248,Purdue University-Calumet Campus,1,0,2007,NA,NA,1220,630,590,104,40,64,0.1,0.07,0.09,4666,84,279,728
152248,Purdue University-Calumet Campus,1,0,2008,NA,NA,1213,624,589,108,50,58,0.09,0.08,0.09,4875,95,287,672
152248,Purdue University-Calumet Campus,1,0,2009,NA,NA,1060,499,561,92,37,55,0.11,0.07,0.09,5119,102,293,624
152248,Purdue University-Calumet Campus,1,0,2010,NA,NA,965,484,481,101,48,53,0.1,0.1,0.1,5374,107,297,555
152363,SAINT JOSEPH'S COLLEGE,1,0,1991,NA,NA,252,94,158,95,51,44,0.46,0.32,0.38,9410,16,48,227
152363,SAINT JOSEPH'S COLLEGE,1,0,1992,NA,NA,258,129,129,94,40,54,0.41000000000000003,0.31,0.36,10030,15,48,233
152363,SAINT JOSEPHS COLLEGE,1,0,1993,NA,NA,292,140,152,110,59,51,0.36,0.39,0.38,10830,15,45,262
152363,SAINT JOSEPHS COLLEGE,1,0,1995,NA,NA,237,106,131,99,52,47,0.44,0.4,0.42,11900,19,42,200
152363,SAINT JOSEPHS COLLEGE,1,0,1996,NA,NA,212,107,105,93,40,53,0.49,0.38,0.44,12260,19,49,190
152363,SAINT JOSEPHS COLLEGE,1,0,1997,NA,NA,267,138,129,112,46,66,0.47000000000000003,0.36,0.42,12620,14,47,239
152363,SAINT JOSEPHS COLLEGE,1,0,1998,NA,NA,254,136,118,113,46,67,0.49,0.39,0.44,13590,14,50,227
152363,SAINT JOSEPHS COLLEGE,1,0,1999,NA,NA,290,122,168,114,56,58,0.47000000000000003,0.33,0.39,14070,15,54,246
152363,SAINT JOSEPHS COLLEGE,1,0,2000,NA,NA,246,132,114,109,50,59,0.44,0.44,0.44,14920,16,53,222
152363,SAINT JOSEPHS COLLEGE,1,0,2001,NA,NA,232,121,111,105,43,62,0.51,0.39,0.45,15880,17,53,205
152363,SAINT JOSEPHS COLLEGE,1,0,2002,NA,NA,276,155,121,108,34,74,0.47000000000000003,0.28,0.39,16900,17,56,242
152363,SAINT JOSEPHS COLLEGE,1,0,2003,NA,NA,306,159,147,134,66,68,0.42,0.45,0.44,17900,19,56,255
152363,SAINT JOSEPHS COLLEGE,1,0,2004,NA,NA,246,145,101,128,37,91,0.62,0.37,0.52,19000,20,52,210
152363,Saint Josephs College,1,0,2005,NA,NA,266,145,121,128,41,87,0.6,0.34,0.48,19960,21,56,229
152363,Saint Josephs College,1,0,2006,NA,NA,251,111,140,100,49,51,0.45,0.35,0.4,20800,21,53,198
152363,Saint Josephs College,1,0,2007,NA,NA,300,138,162,107,50,57,0.41000000000000003,0.31,0.36,21710,20,53,226
152363,Saint Josephs College,1,0,2008,NA,NA,296,144,152,118,51,67,0.46,0.34,0.4,23000,22,54,234
152363,Saint Josephs College,1,0,2009,NA,NA,240,108,132,102,41,61,0.56,0.31,0.42,24350,22,51,187
152363,Saint Josephs College,1,0,2010,NA,NA,257,120,137,111,43,68,0.56,0.31,0.43,25080,21,56,191
152530,TAYLOR UNIVERSITY,1,0,1991,NA,NA,466,248,218,247,94,153,0.61,0.43,0.53,9353,25,86,439
152530,TAYLOR UNIVERSITY-UPLAND,1,0,1992,NA,NA,491,256,235,324,153,171,0.66,0.65,0.66,10000,27,89,466
152530,TAYLOR UNIVERSITY-UPLAND,1,0,1993,NA,NA,435,233,202,270,107,163,0.6900000000000001,0.53,0.62,10650,29,94,399
152530,TAYLOR UNIVERSITY-UPLAND,1,0,1995,NA,NA,419,224,195,270,112,158,0.7000000000000001,0.57,0.64,11914,32,103,389
152530,TAYLOR UNIVERSITY-UPLAND,1,0,1996,NA,NA,485,270,215,348,147,201,0.74,0.68,0.72,12774,35,102,452
152530,TAYLOR UNIVERSITY-UPLAND,1,0,1997,NA,NA,486,262,224,321,143,178,0.67,0.64,0.66,13484,30,106,457
152530,TAYLOR UNIVERSITY-UPLAND,1,0,1998,NA,NA,460,243,217,293,128,165,0.67,0.59,0.64,14456,33,109,426
152530,TAYLOR UNIVERSITY-UPLAND,1,0,1999,NA,NA,473,256,217,341,142,199,0.77,0.65,0.72,14900,34,113,438
152530,TAYLOR UNIVERSITY-UPLAND,1,0,2000,NA,NA,482,242,240,332,149,183,0.75,0.62,0.69,15600,37,115,443
152530,TAYLOR UNIVERSITY-UPLAND,1,0,2001,NA,NA,491,251,240,341,160,181,0.72,0.67,0.69,16350,36,118,464
152530,TAYLOR UNIVERSITY-UPLAND,1,0,2002,NA,NA,452,244,208,322,142,180,0.73,0.68,0.71,17270,37,118,414
152530,TAYLOR UNIVERSITY-UPLAND,1,0,2003,NA,NA,468,270,198,331,137,194,0.71,0.69,0.71,18306,40,119,438
152530,TAYLOR UNIVERSITY-UPLAND,1,0,2004,NA,NA,476,265,211,334,134,200,0.75,0.64,0.7,19450,41,119,446
152530,Taylor University-Upland,1,0,2005,NA,NA,459,271,188,342,142,200,0.73,0.76,0.75,20520,44,126,427
152530,Taylor University,1,0,2006,NA,NA,492,266,226,341,146,195,0.73,0.65,0.69,21800,46,132,450
152530,Taylor University,1,0,2007,NA,NA,472,272,200,306,129,177,0.65,0.64,0.65,23030,53,122,422
152530,Taylor University,1,0,2008,NA,NA,465,266,199,312,115,197,0.74,0.58,0.67,24314,57,126,410
152530,Taylor University,1,0,2009,NA,NA,482,263,219,342,141,201,0.76,0.64,0.71,25164,54,129,426
152530,Taylor University,1,0,2010,NA,NA,467,270,197,308,112,196,0.72,0.57,0.66,26150,58,140,417
152600,VALPARAISO UNIVERSITY,1,0,1991,NA,NA,615,340,275,327,114,213,0.62,0.41,0.53,9900,49,224,565
152600,VALPARAISO UNIVERSITY,1,0,1992,NA,NA,601,334,267,305,117,188,0.56,0.44,0.51,10840,51,225,563
152600,VALPARAISO UNIVERSITY,1,0,1993,NA,NA,487,251,236,278,109,169,0.67,0.46,0.57,11720,56,204,438
152600,VALPARAISO UNIVERSITY,1,0,1995,NA,NA,673,370,303,405,141,264,0.71,0.47,0.6,12860,59,172,574
152600,VALPARAISO UNIVERSITY,1,0,1996,NA,NA,656,348,308,381,149,232,0.66,0.48,0.58,13980,60,196,558
152600,VALPARAISO UNIVERSITY,1,0,1997,NA,NA,702,382,320,416,163,253,0.66,0.51,0.59,14560,53,201,601
152600,VALPARAISO UNIVERSITY,1,0,1998,NA,NA,685,350,335,396,162,234,0.66,0.48,0.58,15400,56,207,580
152600,VALPARAISO UNIVERSITY,1,0,1999,NA,NA,730,376,354,429,192,237,0.63,0.54,0.59,16280,59,224,660
152600,VALPARAISO UNIVERSITY,1,0,2000,NA,NA,707,388,319,450,188,262,0.67,0.59,0.64,17100,63,219,624
152600,VALPARAISO UNIVERSITY,1,0,2001,NA,NA,660,339,321,442,187,255,0.75,0.58,0.67,18100,66,214,598
152600,VALPARAISO UNIVERSITY,1,0,2002,NA,NA,715,365,350,454,197,257,0.7000000000000001,0.56,0.63,19000,69,225,635
152600,VALPARAISO UNIVERSITY,1,0,2003,NA,NA,791,400,391,501,229,272,0.68,0.59,0.63,20000,71,232,700
152600,VALPARAISO UNIVERSITY,1,0,2004,NA,NA,746,376,370,446,201,245,0.65,0.54,0.6,21000,74,237,637
152600,Valparaiso University,1,0,2005,NA,NA,672,332,340,421,183,238,0.71,0.54,0.63,22000,81,243,586
152600,Valparaiso University,1,0,2006,NA,NA,760,394,366,469,206,263,0.66,0.56,0.62,23200,87,254,626
152600,Valparaiso University,1,0,2007,NA,NA,713,370,343,413,193,220,0.59,0.56,0.58,24360,91,265,580
152600,Valparaiso University,1,0,2008,NA,NA,655,336,319,390,169,221,0.65,0.53,0.6,26070,98,261,556
152600,Valparaiso University,1,0,2009,NA,NA,671,330,341,371,157,214,0.64,0.46,0.55,27360,107,242,539
152600,Valparaiso University,1,0,2010,NA,NA,691,360,331,376,148,228,0.63,0.45,0.54,28590,105,254,544
153001,BUENA VISTA COLLEGE,1,0,1991,NA,NA,273,110,163,107,57,50,0.45,0.35,0.39,10900,20,71,263
153001,BUENA VISTA COLLEGE,1,0,1992,NA,NA,290,132,158,129,56,73,0.55,0.35,0.44,11663,26,70,276
153001,BUENA VISTA COLLEGE,1,0,1993,NA,NA,284,143,141,130,47,83,0.58,0.33,0.46,12565,28,70,274
153001,BUENA VISTA UNIVERSITY,1,0,1995,NA,NA,352,167,185,168,71,97,0.58,0.38,0.48,14078,32,64,341
153001,BUENA VISTA UNIVERSITY,1,0,1996,NA,NA,311,161,150,124,52,72,0.44,0.35,0.4,14458,30,72,304
153001,BUENA VISTA UNIVERSITY,1,0,1997,NA,NA,385,185,200,169,70,99,0.53,0.35,0.44,14848,30,73,374
153001,BUENA VISTA UNIVERSITY,1,0,1998,NA,NA,323,165,158,165,68,97,0.58,0.43,0.51,15292,34,79,309
153001,BUENA VISTA UNIVERSITY,1,0,1999,NA,NA,322,144,178,146,69,77,0.53,0.39,0.45,15751,36,84,313
153001,BUENA VISTA UNIVERSITY,1,0,2000,NA,NA,326,182,144,153,62,91,0.5,0.43,0.47,17176,30,83,309
153001,BUENA VISTA UNIVERSITY,1,0,2001,NA,NA,379,189,190,166,69,97,0.51,0.36,0.44,17846,33,82,353
153001,BUENA VISTA UNIVERSITY,1,0,2002,NA,NA,356,192,164,184,79,105,0.54,0.48,0.52,18738,34,81,317
153001,BUENA VISTA UNIVERSITY,1,0,2003,NA,NA,377,193,184,172,74,98,0.5,0.4,0.46,19862,35,88,331
153001,BUENA VISTA UNIVERSITY,1,0,2004,NA,NA,331,173,158,150,63,87,0.5,0.4,0.45,20854,34,81,280
153001,Buena Vista University,1,0,2005,NA,NA,286,143,143,121,50,71,0.49,0.35,0.42,21688,37,81,256
153001,Buena Vista University,1,0,2006,NA,NA,265,133,132,111,51,60,0.45,0.39,0.42,22556,37,82,241
153001,Buena Vista University,1,0,2007,NA,NA,226,122,104,97,35,62,0.5,0.34,0.43,23842,40,86,195
153001,Buena Vista University,1,0,2008,NA,NA,273,117,156,96,46,50,0.42,0.29,0.35,24796,40,84,213
153001,Buena Vista University,1,0,2009,NA,NA,271,123,148,116,55,61,0.49,0.37,0.43,25540,41,82,216
153001,Buena Vista University,1,0,2010,NA,NA,265,139,126,117,43,74,0.53,0.34,0.44,26306,41,83,200
153108,CENTRAL UNIVERSITY OF IOWA,0,1,1991,1996,0,414,239,175,224,95,129,0.53,0.54,0.54,9198,25,88,384
153108,CENTRAL UNIVERSITY OF IOWA,0,1,1992,1996,0,428,235,193,242,98,144,0.61,0.51,0.57,9875,25,88,394
153108,CENTRAL UNIVERSITY OF IOWA,0,1,1993,1996,0,397,210,187,211,87,124,0.59,0.47,0.53,10239,26,89,369
153108,CENTRAL COLLEGE,0,1,1995,1996,0,410,249,161,247,92,155,0.62,0.57,0.6,11836,26,83,378
153108,CENTRAL COLLEGE,1,0,1996,1996,1,303,178,125,160,58,102,0.5700000000000001,0.46,0.53,12304,27,82,286
153108,CENTRAL COLLEGE,1,0,1997,1996,1,306,178,128,183,67,116,0.65,0.52,0.6,12802,27,82,298
153108,CENTRAL COLLEGE,1,0,1998,1996,1,411,222,189,249,101,148,0.66,0.53,0.61,13388,21,81,403
153108,CENTRAL COLLEGE,1,0,1999,1996,1,403,219,184,7,0,7,0.03,0,0.02,14070,23,83,386
153108,CENTRAL COLLEGE,1,0,2000,1996,1,369,214,155,226,84,142,0.66,0.54,0.61,14638,27,82,353
153108,CENTRAL COLLEGE,1,0,2001,1996,1,412,237,175,274,108,166,0.7000000000000001,0.62,0.67,15598,28,82,393
153108,CENTRAL COLLEGE,1,0,2002,1996,1,425,234,191,263,103,160,0.68,0.54,0.62,16612,32,86,402
153108,CENTRAL COLLEGE,1,0,2003,1996,1,416,227,189,231,87,144,0.63,0.46,0.56,17609,33,89,397
153108,CENTRAL COLLEGE,1,0,2004,1996,1,441,223,218,260,118,142,0.63,0.54,0.59,18648,37,90,420
153108,Central College,1,0,2005,1996,1,366,203,163,213,93,120,0.59,0.57,0.58,19684,38,87,339
153108,Central College,1,0,2006,1996,1,413,218,195,256,103,153,0.7000000000000001,0.53,0.62,20972,38,87,383
153108,Central College,1,0,2007,1996,1,422,219,203,260,111,149,0.68,0.55,0.62,22230,40,83,389
153108,Central College,1,0,2008,1996,1,404,204,200,255,101,154,0.75,0.5,0.63,23564,42,88,377
153108,Central College,1,0,2009,1996,1,442,213,229,264,117,147,0.6900000000000001,0.51,0.6,24630,43,88,401
153108,Central College,1,0,2010,1996,1,402,212,190,235,99,136,0.64,0.52,0.58,25862,43,88,355
153269,DRAKE UNIVERSITY,1,0,1991,NA,NA,744,424,320,398,154,244,0.5700000000000001,0.48,0.53,11040,78,271,651
153269,DRAKE UNIVERSITY,1,0,1992,NA,NA,838,476,362,407,150,257,0.53,0.41,0.49,11780,84,278,731
153269,DRAKE UNIVERSITY,1,0,1993,NA,NA,832,492,340,422,158,264,0.53,0.46,0.51,12780,90,285,742
153269,DRAKE UNIVERSITY,1,0,1995,NA,NA,734,435,299,365,144,221,0.5,0.48,0.5,14100,92,270,594
153269,DRAKE UNIVERSITY,1,0,1996,NA,NA,638,385,253,352,145,207,0.53,0.57,0.55,14380,93,267,537
153269,DRAKE UNIVERSITY,1,0,1997,NA,NA,636,368,268,389,141,248,0.67,0.53,0.61,15200,76,269,513
153269,DRAKE UNIVERSITY,1,0,1998,NA,NA,670,379,291,378,134,244,0.64,0.46,0.56,16000,78,259,563
153269,DRAKE UNIVERSITY,1,0,1999,NA,NA,670,364,306,371,151,220,0.6,0.49,0.55,16480,77,262,553
153269,DRAKE UNIVERSITY,1,0,2000,NA,NA,760,475,285,353,127,226,0.47000000000000003,0.45,0.46,17090,80,258,628
153269,DRAKE UNIVERSITY,1,0,2001,NA,NA,755,476,279,361,122,239,0.5,0.44,0.48,17580,81,255,627
153269,DRAKE UNIVERSITY,1,0,2002,NA,NA,775,459,316,360,148,212,0.46,0.47,0.46,18190,84,244,650
153269,DRAKE UNIVERSITY,1,0,2003,NA,NA,809,474,335,410,151,259,0.54,0.45,0.51,19100,85,237,694
153269,DRAKE UNIVERSITY,1,0,2004,NA,NA,782,462,320,408,162,246,0.53,0.51,0.52,20200,89,249,653
153269,Drake University,1,0,2005,NA,NA,809,465,344,438,173,265,0.56,0.5,0.54,21100,92,246,688
153269,Drake University,1,0,2006,NA,NA,779,470,309,429,173,256,0.54,0.56,0.55,22270,97,246,638
153269,Drake University,1,0,2007,NA,NA,923,557,366,484,170,314,0.56,0.46,0.52,23280,104,257,778
153269,Drake University,1,0,2008,NA,NA,901,544,357,507,199,308,0.56,0.56,0.56,24430,109,270,797
153269,Drake University,1,0,2009,NA,NA,860,512,348,482,185,297,0.58,0.53,0.56,25160,113,275,744
153269,Drake University,1,0,2010,NA,NA,864,474,390,513,218,295,0.62,0.56,0.59,26400,118,275,754
153384,GRINNELL COLLEGE,1,0,1991,NA,NA,324,184,140,248,104,144,0.78,0.74,0.77,13742,36,131,256
153384,GRINNELL COLLEGE,1,0,1992,NA,NA,295,168,127,234,101,133,0.79,0.8,0.79,14532,38,121,223
153384,GRINNELL COLLEGE,1,0,1993,NA,NA,434,224,210,321,151,170,0.75,0.72,0.74,15368,40,128,341
153384,GRINNELL COLLEGE,1,0,1995,NA,NA,307,168,139,238,106,132,0.78,0.76,0.78,16628,48,143,243
153384,GRINNELL COLLEGE,1,0,1996,NA,NA,354,210,144,271,106,165,0.78,0.74,0.77,17134,50,141,268
153384,GRINNELL COLLEGE,1,0,1997,NA,NA,413,234,179,330,140,190,0.81,0.78,0.8,17568,55,142,319
153384,GRINNELL COLLEGE,1,0,1998,NA,NA,350,194,156,282,127,155,0.79,0.81,0.81,18446,48,134,258
153384,GRINNELL COLLEGE,1,0,1999,NA,NA,325,168,157,271,126,145,0.86,0.8,0.83,18990,49,136,223
153384,GRINNELL COLLEGE,1,0,2000,NA,NA,363,209,154,312,127,185,0.88,0.82,0.86,19982,58,148,245
153384,GRINNELL COLLEGE,1,0,2001,NA,NA,356,184,172,291,130,161,0.87,0.76,0.82,21700,59,160,242
153384,GRINNELL COLLEGE,1,0,2002,NA,NA,368,202,166,297,132,165,0.81,0.8,0.81,22960,60,170,261
153384,GRINNELL COLLEGE,1,0,2003,NA,NA,403,214,189,315,138,177,0.8200000000000001,0.73,0.78,23898,67,179,285
153384,GRINNELL COLLEGE,1,0,2004,NA,NA,434,237,197,363,155,208,0.87,0.79,0.84,25200,69,176,301
153384,Grinnell College,1,0,2005,NA,NA,385,206,179,320,148,172,0.8300000000000001,0.83,0.83,27060,72,180,245
153384,Grinnell College,1,0,2006,NA,NA,405,206,199,348,166,182,0.88,0.83,0.86,28566,77,183,270
153384,Grinnell College,1,0,2007,NA,NA,426,233,193,344,152,192,0.8200000000000001,0.79,0.81,29710,82,186,260
153384,Grinnell College,1,0,2008,NA,NA,462,251,211,392,171,221,0.88,0.81,0.85,34932,90,193,299
153384,Grinnell College,1,0,2009,NA,NA,377,202,175,299,124,175,0.86,0.71,0.79,35976,94,189,202
153384,Grinnell College,1,0,2010,NA,NA,415,231,184,336,140,196,0.84,0.76,0.81,36948,97,188,230
153603,IOWA STATE UNIVERSITY,1,0,1991,NA,NA,3228,1368,1860,665,281,384,0.28,0.15,0.21,2072,485,1207,2787
153603,IOWA STATE UNIVERSITY,1,0,1992,NA,NA,3333,1432,1901,723,309,414,0.28,0.16,0.22,2228,474,1197,2833
153603,IOWA STATE UNIVERSITY,1,0,1993,NA,NA,3416,1435,1981,763,327,436,0.3,0.17,0.22,2352,517,1188,2893
153603,IOWA STATE UNIVERSITY,1,0,1995,NA,NA,3274,1490,1784,822,341,481,0.32,0.19,0.25,2574,556,1029,2937
153603,IOWA STATE UNIVERSITY,1,0,1996,NA,NA,3599,1592,2007,1022,455,567,0.35000000000000003,0.23,0.28,2666,579,1035,3170
153603,IOWA STATE UNIVERSITY,1,0,1997,NA,NA,4007,1790,2217,1081,437,644,0.35000000000000003,0.2,0.27,2766,593,1016,3500
153603,IOWA STATE UNIVERSITY,1,0,1998,NA,NA,3800,1775,2025,1111,438,673,0.37,0.22,0.29,2874,620,1006,3348
153603,IOWA STATE UNIVERSITY,1,0,1999,NA,NA,4020,1830,2190,1261,520,741,0.4,0.24,0.31,2786,649,1327,3494
153603,IOWA STATE UNIVERSITY,1,0,2000,NA,NA,4282,1928,2354,1340,515,825,0.42,0.22,0.31,2906,688,1307,3697
153603,IOWA STATE UNIVERSITY,1,0,2001,NA,NA,4589,2087,2502,1463,591,872,0.41000000000000003,0.24,0.32,3116,714,1288,3910
153603,IOWA STATE UNIVERSITY,1,0,2002,NA,NA,4167,1915,2252,1399,566,833,0.43,0.25,0.34,3692,691,1376,3557
153603,IOWA STATE UNIVERSITY,1,0,2003,NA,NA,3860,1683,2177,1364,577,787,0.46,0.27,0.35,4342,721,1415,3288
153603,IOWA STATE UNIVERSITY,1,0,2004,NA,NA,3674,1618,2056,1348,572,776,0.47000000000000003,0.28,0.37,4702,769,1391,3142
153603,Iowa State University,1,0,2005,NA,NA,3737,1629,2108,1248,535,713,0.43,0.25,0.33,4890,765,1115,3214
153603,Iowa State University,1,0,2006,NA,NA,3933,1780,2153,1525,649,876,0.49,0.3,0.39,5086,806,1118,3350
153603,Iowa State University,1,0,2007,NA,NA,4307,1920,2387,1622,682,940,0.48,0.29,0.38,5352,828,1097,3671
153603,Iowa State University,1,0,2008,NA,NA,4528,2074,2454,1787,772,1015,0.48,0.31,0.39,5524,874,1368,3740
153603,Iowa State University,1,0,2009,NA,NA,4320,1974,2346,1757,742,1015,0.51,0.32,0.41,5756,919,1374,3501
153603,Iowa State University,1,0,2010,NA,NA,4518,2077,2441,2006,847,1159,0.55,0.35,0.44,6102,929,1305,3623
153834,LUTHER COLLEGE,1,0,1991,NA,NA,578,349,229,368,134,234,0.67,0.59,0.64,10600,33,145,538
153834,LUTHER COLLEGE,1,0,1992,NA,NA,579,357,222,389,144,245,0.68,0.65,0.67,11600,37,150,543
153834,LUTHER COLLEGE,1,0,1993,NA,NA,586,341,245,411,176,235,0.68,0.72,0.7,12375,40,155,554
153834,LUTHER COLLEGE,1,0,1995,NA,NA,590,372,218,375,122,253,0.68,0.56,0.64,14100,46,159,538
153834,LUTHER COLLEGE,1,0,1996,NA,NA,615,347,268,437,190,247,0.71,0.71,0.71,14900,46,160,557
153834,LUTHER COLLEGE,1,0,1997,NA,NA,629,385,244,431,161,270,0.7000000000000001,0.66,0.69,15630,37,165,562
153834,LUTHER COLLEGE,1,0,1998,NA,NA,678,396,282,446,179,267,0.67,0.63,0.66,16525,39,166,592
153834,LUTHER COLLEGE,1,0,1999,NA,NA,606,354,252,393,155,238,0.67,0.62,0.65,17290,41,173,552
153834,LUTHER COLLEGE,1,0,2000,NA,NA,662,396,266,420,161,259,0.65,0.61,0.63,18080,45,173,588
153834,LUTHER COLLEGE,1,0,2001,NA,NA,636,397,239,401,144,257,0.64,0.6,0.63,19325,46,174,537
153834,LUTHER COLLEGE,1,0,2002,NA,NA,608,365,243,371,135,236,0.64,0.56,0.61,20310,47,175,541
153834,LUTHER COLLEGE,1,0,2003,NA,NA,667,397,270,436,172,264,0.66,0.64,0.65,21600,48,183,612
153834,LUTHER COLLEGE,1,0,2004,NA,NA,661,387,274,435,183,252,0.65,0.67,0.66,23070,51,186,601
153834,Luther College,1,0,2005,NA,NA,629,354,275,367,140,227,0.64,0.51,0.58,24570,53,182,558
153834,Luther College,1,0,2006,NA,NA,610,350,260,417,180,237,0.67,0.69,0.68,26380,58,188,542
153834,Luther College,1,0,2007,NA,NA,659,374,285,439,177,262,0.7000000000000001,0.62,0.67,28840,61,182,552
153834,Luther College,1,0,2008,NA,NA,630,371,259,469,194,275,0.74,0.75,0.74,30920,63,182,511
153834,Luther College,1,0,2009,NA,NA,657,380,277,451,190,261,0.68,0.69,0.69,32140,69,181,507
153834,Luther College,1,0,2010,NA,NA,611,342,269,438,177,261,0.76,0.66,0.72,33330,75,182,551
154095,UNIVERSITY OF NORTHERN IOWA,1,0,1991,NA,NA,1949,1181,768,470,151,319,0.27,0.2,0.24,1952,122,600,1840
154095,UNIVERSITY OF NORTHERN IOWA,1,0,1992,NA,NA,1659,984,675,435,143,292,0.29,0.21,0.26,2228,123,615,1558
154095,UNIVERSITY OF NORTHERN IOWA,1,0,1993,NA,NA,1808,1112,696,491,152,339,0.3,0.22,0.27,2352,135,622,1691
154095,UNIVERSITY OF NORTHERN IOWA,1,0,1995,NA,NA,2007,1244,763,604,170,434,0.34,0.22,0.3,2558,148,636,1912
154095,UNIVERSITY OF NORTHERN IOWA,1,0,1996,NA,NA,2012,1234,778,673,224,449,0.36,0.29,0.33,2650,157,646,1899
154095,UNIVERSITY OF NORTHERN IOWA,1,0,1997,NA,NA,1920,1192,728,553,169,384,0.32,0.23,0.29,2752,164,646,1790
154095,UNIVERSITY OF NORTHERN IOWA,1,0,1998,NA,NA,1982,1257,725,585,146,439,0.34,0.2,0.3,2860,171,641,1864
154095,UNIVERSITY OF NORTHERN IOWA,1,0,1999,NA,NA,2122,1303,819,713,211,502,0.38,0.26,0.34,2786,184,646,1978
154095,UNIVERSITY OF NORTHERN IOWA,1,0,2000,NA,NA,2218,1337,881,751,243,508,0.38,0.28,0.34,2906,192,646,2009
154095,UNIVERSITY OF NORTHERN IOWA,1,0,2001,NA,NA,2055,1310,745,665,189,476,0.36,0.25,0.32,3116,210,647,1878
154095,UNIVERSITY OF NORTHERN IOWA,1,0,2002,NA,NA,1821,1139,682,610,194,416,0.36,0.28,0.33,3692,211,641,1674
154095,UNIVERSITY OF NORTHERN IOWA,1,0,2003,NA,NA,1739,1088,651,613,182,431,0.39,0.28,0.35,4342,211,587,1598
154095,UNIVERSITY OF NORTHERN IOWA,1,0,2004,NA,NA,1652,995,657,581,172,409,0.41000000000000003,0.26,0.35,4702,217,564,1508
154095,University of Northern Iowa,1,0,2005,NA,NA,1693,1062,631,618,184,434,0.4,0.29,0.37,4890,217,597,1550
154095,University of Northern Iowa,1,0,2006,NA,NA,1684,1010,674,648,200,448,0.44,0.3,0.38,5086,226,587,1525
154095,University of Northern Iowa,1,0,2007,NA,NA,1922,1177,745,708,237,471,0.4,0.32,0.37,5352,227,576,1767
154095,University of Northern Iowa,1,0,2008,NA,NA,1972,1206,766,747,254,493,0.4,0.33,0.38,5524,242,587,1804
154095,University of Northern Iowa,1,0,2009,NA,NA,1913,1194,719,721,220,501,0.41000000000000003,0.31,0.38,5756,266,575,1761
154095,University of Northern Iowa,1,0,2010,NA,NA,1934,1214,720,759,229,530,0.43,0.32,0.39,6102,258,577,1790
155089,FRIENDS UNIVERSITY,1,0,1991,NA,NA,165,99,66,44,12,32,0.32,0.18,0.27,7155,12,48,133
155089,FRIENDS UNIVERSITY,1,0,1992,NA,NA,150,101,49,31,6,25,0.24,0.12,0.21,7655,12,48,127
155089,FRIENDS UNIVERSITY,1,0,1993,NA,NA,230,125,105,55,22,33,0.26,0.21,0.24,8185,13,48,192
155089,FRIENDS UNIVERSITY,1,0,1995,NA,NA,200,109,91,43,19,24,0.22,0.21,0.22,9017,22,61,161
155089,FRIENDS UNIVERSITY,1,0,1996,NA,NA,196,111,85,47,12,35,0.31,0.14,0.24,9465,23,63,153
155089,FRIENDS UNIVERSITY,1,0,1997,NA,NA,179,99,80,39,11,28,0.28,0.14,0.22,9974,18,63,130
155089,FRIENDS UNIVERSITY,1,0,1998,NA,NA,195,106,89,35,14,21,0.19,0.16,0.18,10490,21,67,161
155089,FRIENDS UNIVERSITY,1,0,1999,NA,NA,226,125,101,36,13,23,0.18,0.13,0.16,10920,24,69,182
155089,FRIENDS UNIVERSITY,1,0,2000,NA,NA,231,127,104,49,18,31,0.24,0.17,0.21,11460,27,70,177
155089,FRIENDS UNIVERSITY,1,0,2001,NA,NA,197,133,64,23,6,17,0.12,0.09,0.12,12210,26,71,155
155089,FRIENDS UNIVERSITY,1,0,2002,NA,NA,203,121,82,35,15,20,0.16,0.18,0.17,12845,28,78,163
155089,FRIENDS UNIVERSITY,1,0,2003,NA,NA,201,102,99,38,14,24,0.23,0.14,0.19,13620,28,75,141
155089,FRIENDS UNIVERSITY,1,0,2004,NA,NA,207,112,95,27,14,13,0.11,0.15,0.13,14430,29,79,132
155089,Friends University,1,0,2005,NA,NA,151,72,79,16,7,9,0.12,0.09,0.11,15150,29,72,114
155089,Friends University,1,0,2006,NA,NA,139,64,75,12,8,4,0.06,0.11,0.09,16050,30,80,101
155089,Friends University,1,0,2007,NA,NA,139,72,67,14,7,7,0.09,0.1,0.1,17100,33,76,88
155089,Friends University,1,0,2008,NA,NA,169,100,69,20,2,18,0.18,0.03,0.12,18200,34,75,121
155089,Friends University,1,0,2009,NA,NA,217,114,103,62,33,29,0.25,0.32,0.29,18930,34,74,161
155089,Friends University,1,0,2010,NA,NA,199,90,109,42,17,25,0.27,0.16,0.21,19890,35,74,132
155317,UNIVERSITY OF KANSAS MAIN CAMPUS,1,0,1991,NA,NA,3287,1755,1532,749,291,458,0.26,0.19,0.23,1662,278,942,2810
155317,UNIVERSITY OF KANSAS MAIN CAMPUS,1,0,1992,NA,NA,3495,1778,1717,814,304,510,0.28,0.18,0.23,1798,293,954,2987
155317,UNIVERSITY OF KANSAS MAIN CAMPUS,1,0,1993,NA,NA,3603,1849,1754,843,335,508,0.27,0.19,0.23,1920,309,981,3090
155317,UNIVERSITY OF KANSAS MAIN CAMPUS,1,0,1995,NA,NA,3474,1857,1617,905,351,554,0.29,0.22,0.26,2182,336,993,3022
155317,UNIVERSITY OF KANSAS MAIN CAMPUS,1,0,1996,NA,NA,3546,1902,1644,926,349,577,0.3,0.21,0.26,2310,347,978,3072
155317,UNIVERSITY OF KANSAS MAIN CAMPUS,1,0,1997,NA,NA,3808,1989,1819,1093,424,669,0.33,0.23,0.29,2385,366,958,3261
155317,UNIVERSITY OF KANSAS MAIN CAMPUS,1,0,1998,NA,NA,3698,2069,1629,974,322,652,0.31,0.2,0.26,2470,398,943,3201
155317,UNIVERSITY OF KANSAS MAIN CAMPUS,1,0,1999,NA,NA,3784,2099,1685,1155,374,781,0.37,0.22,0.31,2090,431,946,3281
155317,UNIVERSITY OF KANSAS MAIN CAMPUS,1,0,2000,NA,NA,4119,2268,1851,1282,455,827,0.36,0.25,0.31,2267,466,974,3550
155317,UNIVERSITY OF KANSAS MAIN CAMPUS,1,0,2001,NA,NA,4024,2198,1826,1267,476,791,0.35000000000000003,0.26,0.31,2333,493,1002,3513
155317,UNIVERSITY OF KANSAS MAIN CAMPUS,1,0,2002,NA,NA,4013,2181,1832,1227,477,750,0.34,0.26,0.31,2921,488,994,3482
155317,UNIVERSITY OF KANSAS MAIN CAMPUS,1,0,2003,NA,NA,3971,2126,1845,1261,480,781,0.36,0.26,0.32,3527,517,1004,3316
155317,UNIVERSITY OF KANSAS MAIN CAMPUS,1,0,2004,NA,NA,4182,2148,2034,1345,527,818,0.38,0.26,0.32,4163,557,1000,3429
155317,University of Kansas Main Campus,1,0,2005,NA,NA,4106,2115,1991,1332,518,814,0.38,0.26,0.32,4824,611,1055,3462
155317,University of Kansas Main Campus,1,0,2006,NA,NA,4092,2092,2000,1500,607,893,0.42,0.3,0.37,5513,663,1080,3417
155317,University of Kansas,1,0,2007,NA,NA,4028,2084,1944,1444,582,862,0.41000000000000003,0.3,0.36,5844,1014,1228,3332
155317,University of Kansas,1,0,2008,NA,NA,4435,2260,2175,1649,670,979,0.43,0.31,0.37,6195,957,1244,3609
155317,University of Kansas,1,0,2009,NA,NA,3894,1984,1910,1459,599,860,0.43,0.31,0.37,6567,987,1152,3067
155317,University of Kansas,1,0,2010,NA,NA,3489,1743,1746,1435,603,832,0.47000000000000003,0.35,0.41,7167,1025,1154,2837
155335,KANSAS NEWMAN COLLEGE,1,0,1991,NA,NA,82,61,21,15,3,12,0.19,0.14,0.18,6380,6,46,71
155335,KANSAS NEWMAN COLLEGE,1,0,1992,NA,NA,83,57,26,28,8,20,0.35000000000000003,0.31,0.34,6636,8,70,69
155335,KANSAS NEWMAN COLLEGE,1,0,1993,NA,NA,98,72,26,20,5,15,0.2,0.19,0.2,7380,12,71,78
155335,KANSAS NEWMAN COLLEGE,1,0,1995,NA,NA,118,74,44,23,6,17,0.22,0.14,0.19,8100,15,75,97
155335,KANSAS NEWMAN COLLEGE,1,0,1996,NA,NA,96,61,35,29,10,19,0.31,0.29,0.3,8500,15,76,74
155335,KANSAS NEWMAN COLLEGE,1,0,1997,NA,NA,89,50,39,22,10,12,0.24,0.26,0.25,9000,12,82,75
155335,NEWMAN UNIVERSITY,1,0,1998,NA,NA,110,65,45,28,8,20,0.3,0.18,0.25,9000,13,83,96
155335,NEWMAN UNIVERSITY,1,0,1999,NA,NA,148,87,61,50,18,32,0.36,0.3,0.34,9000,15,81,130
155335,NEWMAN UNIVERSITY,1,0,2000,NA,NA,171,112,59,49,14,35,0.31,0.24,0.29,10148,15,73,132
155335,NEWMAN UNIVERSITY,1,0,2001,NA,NA,130,76,54,40,18,22,0.28,0.33,0.31,11060,15,65,92
155335,NEWMAN UNIVERSITY,1,0,2002,NA,NA,143,79,64,37,17,20,0.25,0.27,0.26,11890,15,63,107
155335,NEWMAN UNIVERSITY,1,0,2003,NA,NA,200,118,82,57,19,38,0.32,0.23,0.28,13198,15,63,132
155335,NEWMAN UNIVERSITY,1,0,2004,NA,NA,216,112,104,43,17,26,0.23,0.16,0.2,14650,16,71,114
155335,Newman University,1,0,2005,NA,NA,181,84,97,31,12,19,0.22,0.12,0.17,15822,17,79,112
155335,Newman University,1,0,2006,NA,NA,167,96,71,48,18,30,0.31,0.25,0.29,17008,19,70,109
155335,Newman University,1,0,2007,NA,NA,133,72,61,44,13,31,0.43,0.21,0.33,17688,19,75,94
155335,Newman University,1,0,2008,NA,NA,115,74,41,36,10,26,0.35000000000000003,0.24,0.31,18574,20,80,84
155335,Newman University,1,0,2009,NA,NA,174,106,68,55,16,39,0.36,0.24,0.32,19200,21,77,112
155335,Newman University,1,0,2010,NA,NA,196,118,78,69,23,46,0.38,0.29,0.35,19872,21,76,153
155399,KANSAS STATE UNIVERSITY OF AGRICULTURE AND APP SCI,1,0,1991,NA,NA,2670,1322,1348,480,158,322,0.24,0.12,0.18,1699,247,918,2467
155399,KANSAS STATE UNIVERSITY OF AGRICULTURE AND APP SCI,1,0,1992,NA,NA,2778,1357,1421,484,189,295,0.21,0.13,0.17,1841,261,904,2525
155399,KANSAS STATE UNIVERSITY OF AGRICULTURE AND APP SCI,1,0,1993,NA,NA,2739,1356,1383,550,203,347,0.25,0.15,0.2,1975,254,895,2503
155399,KANSAS STATE UNIVERSITY OF AGRICULTURE AND APP SCI,1,0,1995,NA,NA,2877,1380,1497,558,219,339,0.24,0.15,0.19,2199,277,831,2626
155399,KANSAS STATE UNIVERSITY OF AGRICULTURE AND APP SCI,1,0,1996,NA,NA,2681,1326,1355,583,208,375,0.28,0.15,0.22,2373,282,808,2463
155399,KANSAS STATE UNIVERSITY,1,0,1997,NA,NA,2906,1382,1524,640,232,408,0.29,0.15,0.22,2467,297,862,2650
155399,KANSAS STATE UNIVERSITY,1,0,1998,NA,NA,2921,1388,1533,755,295,460,0.33,0.19,0.26,2544,315,876,2640
155399,KANSAS STATE UNIVERSITY,1,0,1999,NA,NA,3280,1574,1706,723,288,435,0.27,0.17,0.22,2090,332,876,2921
155399,KANSAS STATE UNIVERSITY,1,0,2000,NA,NA,3399,1711,1688,829,289,540,0.31,0.17,0.24,2267,354,866,3035
155399,KANSAS STATE UNIVERSITY,1,0,2001,NA,NA,3358,1689,1669,836,274,562,0.33,0.16,0.25,2333,369,857,2973
155399,KANSAS STATE UNIVERSITY,1,0,2002,NA,NA,3338,1652,1686,828,278,550,0.33,0.16,0.25,2918,410,882,2988
155399,KANSAS STATE UNIVERSITY,1,0,2003,NA,NA,3098,1529,1569,855,303,552,0.36,0.19,0.28,3510,435,850,2794
155399,KANSAS STATE UNIVERSITY,1,0,2004,NA,NA,3282,1691,1591,823,270,553,0.32,0.17,0.25,4110,453,893,2869
155399,Kansas State University,1,0,2005,NA,NA,3105,1561,1544,697,255,442,0.28,0.17,0.22,4560,469,888,2721
155399,Kansas State University,1,0,2006,NA,NA,3140,1602,1538,832,288,544,0.33,0.19,0.26,4830,493,921,2748
155399,Kansas State University,1,0,2007,NA,NA,3301,1629,1672,843,290,553,0.33,0.17,0.26,5625,508,943,2826
155399,Kansas State University,1,0,2008,NA,NA,3518,1780,1738,960,339,621,0.34,0.2,0.27,5954,552,986,2850
155399,Kansas State University,1,0,2009,NA,NA,3420,1686,1734,972,343,629,0.37,0.2,0.28,6186,615,973,2748
155399,Kansas State University,1,0,2010,NA,NA,3465,1753,1712,1068,416,652,0.37,0.24,0.31,6672,613,949,2884
155520,MID-AMERICA NAZARENE COLLEGE,1,0,1991,NA,NA,200,112,88,51,15,36,0.32,0.17,0.26,5250,11,58,177
155520,MID-AMERICA NAZARENE COLLEGE,1,0,1992,NA,NA,217,107,110,42,16,26,0.24,0.15,0.19,6006,13,57,188
155520,MID-AMERICA NAZARENE COLLEGE,1,0,1993,NA,NA,212,97,115,36,16,20,0.2,0.14,0.17,6483,13,61,184
155520,MIDAMERICA NAZARENE COLLEGE,1,0,1995,NA,NA,246,124,122,62,17,45,0.36,0.14,0.25,7440,16,64,216
155520,MIDAMERICA NAZARENE COLLEGE,1,0,1996,NA,NA,230,129,101,70,21,49,0.37,0.21,0.3,8668,17,67,214
155520,MIDAMERICA NAZARENE UNIVERSITY,1,0,1997,NA,NA,256,140,116,107,38,69,0.49,0.33,0.42,9498,15,67,234
155520,MIDAMERICA NAZARENE UNIVERSITY,1,0,1998,NA,NA,254,114,140,64,27,37,0.32,0.19,0.25,10122,18,67,229
155520,MIDAMERICA NAZARENE UNIVERSITY,1,0,1999,NA,NA,205,111,94,71,28,43,0.38,0.3,0.35,9580,18,72,189
155520,MIDAMERICA NAZARENE UNIVERSITY,1,0,2000,NA,NA,260,133,127,113,39,74,0.55,0.31,0.43,10150,19,71,235
155520,MIDAMERICA NAZARENE UNIVERSITY,1,0,2001,NA,NA,248,124,124,74,20,54,0.43,0.16,0.3,10650,20,71,230
155520,MIDAMERICA NAZARENE UNIVERSITY,1,0,2002,NA,NA,306,156,150,128,46,82,0.52,0.31,0.42,11270,21,74,281
155520,MIDAMERICA NAZARENE UNIVERSITY,1,0,2003,NA,NA,260,125,135,103,41,62,0.49,0.3,0.4,11910,21,70,227
155520,MIDAMERICA NAZARENE UNIVERSITY,1,0,2004,NA,NA,249,117,132,84,40,44,0.37,0.3,0.34,12630,22,73,212
155520,MidAmerica Nazarene University,1,0,2005,NA,NA,216,109,107,61,21,40,0.36,0.2,0.28,13754,23,77,177
155520,MidAmerica Nazarene University,1,0,2006,NA,NA,239,118,121,82,36,46,0.38,0.3,0.34,14968,24,79,218
155520,MidAmerica Nazarene University,1,0,2007,NA,NA,217,109,108,89,33,56,0.51,0.31,0.41,16090,25,82,186
155520,MidAmerica Nazarene University,1,0,2008,NA,NA,208,114,94,69,25,44,0.38,0.27,0.33,17216,27,80,177
155520,MidAmerica Nazarene University,1,0,2009,NA,NA,198,110,88,83,29,54,0.49,0.33,0.42,18146,28,81,159
155520,MidAmerica Nazarene University,1,0,2010,NA,NA,232,120,112,100,36,64,0.53,0.32,0.43,19250,29,86,185
155627,OTTAWA UNIVERSITY,1,0,1991,NA,NA,120,48,72,19,11,8,0.16,0.15,0.16,6450,12,34,97
155627,OTTAWA UNIVERSITY,1,0,1992,NA,NA,119,43,76,24,9,15,0.34,0.12,0.2,6900,12,34,93
155627,OTTAWA UNIVERSITY,1,0,1993,NA,NA,130,51,79,39,16,23,0.45,0.2,0.3,7250,14,30,110
155627,OTTAWA UNIVERSITY,1,0,1995,NA,NA,137,44,93,21,9,12,0.27,0.1,0.15,7960,17,27,115
155627,OTTAWA UNIVERSITY,1,0,1996,NA,NA,130,48,82,52,23,29,0.6,0.28,0.4,8350,13,30,117
155627,OTTAWA UNIVERSITY,1,0,1997,NA,NA,149,39,110,39,23,16,0.41000000000000003,0.21,0.26,8850,10,31,113
155627,OTTAWA UNIVERSITY,1,0,1998,NA,NA,117,43,74,24,10,14,0.32,0.14,0.21,9560,8,27,91
155627,OTTAWA UNIVERSITY,1,0,1999,NA,NA,136,50,86,22,10,12,0.24,0.12,0.16,10040,9,30,92
155627,OTTAWA UNIVERSITY,1,0,2000,NA,NA,111,40,71,30,12,18,0.45,0.17,0.27,10750,10,25,84
155627,OTTAWA UNIVERSITY,1,0,2001,NA,NA,132,46,86,35,11,24,0.52,0.13,0.27,11550,11,21,104
155627,OTTAWA UNIVERSITY,1,0,2002,NA,NA,112,35,77,32,15,17,0.48,0.19,0.29,12200,12,18,76
155627,OTTAWA UNIVERSITY,1,0,2003,NA,NA,114,47,67,28,6,22,0.46,0.09,0.25,12810,12,24,86
155627,OTTAWA UNIVERSITY,1,0,2004,NA,NA,79,30,49,23,11,12,0.4,0.22,0.29,13850,27,22,65
155627,Ottawa University,1,0,2005,NA,NA,113,47,66,36,19,17,0.36,0.29,0.32,14500,26,20,90
155627,Ottawa University,1,0,2006,NA,NA,90,38,52,19,6,13,0.34,0.12,0.21,15500,27,25,78
155627,Ottawa University,1,0,2007,NA,NA,161,79,82,35,11,24,0.3,0.13,0.22,17000,31,26,109
155627,Ottawa University,1,0,2008,NA,NA,201,100,101,40,17,23,0.23,0.17,0.2,18070,32,28,121
155627,Ottawa University,1,0,2009,NA,NA,150,67,83,55,30,25,0.37,0.36,0.37,19100,33,27,96
155627,Ottawa University-Ottawa,1,0,2010,NA,NA,156,66,90,37,12,25,0.37,0.13,0.24,20000,37,27,101
155937,STERLING COLLEGE,1,0,1991,NA,NA,131,55,76,42,20,22,0.4,0.26,0.32,6800,6,30,108
155937,STERLING COLLEGE,1,0,1992,NA,NA,118,52,66,33,9,24,0.46,0.14,0.28,7230,7,31,106
155937,STERLING COLLEGE,1,0,1993,NA,NA,156,76,80,42,18,24,0.31,0.22,0.27,7890,7,30,144
155937,STERLING COLLEGE,1,0,1995,NA,NA,120,63,57,42,12,30,0.47000000000000003,0.21,0.35,8926,8,32,98
155937,STERLING COLLEGE,1,0,1996,NA,NA,146,72,74,50,18,32,0.44,0.24,0.34,9596,7,31,125
155937,STERLING COLLEGE,1,0,1997,NA,NA,140,56,84,45,21,24,0.42,0.25,0.32,10076,8,30,118
155937,STERLING COLLEGE,1,0,1998,NA,NA,161,81,80,52,18,34,0.41000000000000003,0.22,0.32,10504,8,31,141
155937,STERLING COLLEGE,1,0,1999,NA,NA,110,63,47,61,20,41,0.65,0.43,0.55,11030,8,31,106
155937,STERLING COLLEGE,1,0,2000,NA,NA,126,60,66,47,18,29,0.48,0.27,0.37,11582,9,32,109
155937,STERLING COLLEGE,1,0,2001,NA,NA,105,51,54,39,16,23,0.45,0.3,0.37,12100,10,34,86
155937,STERLING COLLEGE,1,0,2002,NA,NA,98,50,48,43,14,29,0.58,0.29,0.44,12750,11,38,76
155937,STERLING COLLEGE,1,0,2003,NA,NA,124,57,67,44,16,28,0.49,0.24,0.35,13150,11,34,92
155937,STERLING COLLEGE,1,0,2004,NA,NA,136,52,84,36,19,17,0.32,0.23,0.26,13807,8,37,110
155937,Sterling College,1,0,2005,NA,NA,126,57,69,38,16,22,0.38,0.23,0.3,13806,11,37,104
155937,Sterling College,1,0,2006,NA,NA,197,79,118,40,10,30,0.37,0.08,0.2,14300,9,34,155
155937,Sterling College,1,0,2007,NA,NA,165,70,95,50,25,25,0.35000000000000003,0.26,0.3,15500,10,37,118
155937,Sterling College,1,0,2008,NA,NA,150,71,79,44,15,29,0.4,0.19,0.29,16500,11,39,122
155937,Sterling College,1,0,2009,NA,NA,182,82,100,49,24,25,0.3,0.24,0.27,18000,11,41,143
155937,Sterling College,1,0,2010,NA,NA,149,70,79,50,21,29,0.41000000000000003,0.27,0.34,19000,11,44,120
156213,ASBURY COLLEGE,1,0,1991,NA,NA,250,144,106,78,31,47,0.32,0.29,0.31,7350,13,71,236
156213,ASBURY COLLEGE,1,0,1992,NA,NA,268,165,103,95,38,57,0.34,0.37,0.35,7863,14,72,259
156213,ASBURY COLLEGE,1,0,1993,NA,NA,268,177,91,109,36,73,0.41000000000000003,0.4,0.41,8322,15,69,251
156213,ASBURY COLLEGE,1,0,1995,NA,NA,298,180,118,140,65,75,0.41000000000000003,0.55,0.47,9819,17,80,286
156213,ASBURY COLLEGE,1,0,1996,NA,NA,289,184,105,133,50,83,0.45,0.48,0.46,10595,19,84,272
156213,ASBURY COLLEGE,1,0,1997,NA,NA,365,223,142,179,66,113,0.5,0.46,0.49,11237,18,86,343
156213,ASBURY COLLEGE,1,0,1998,NA,NA,333,204,129,211,82,129,0.63,0.64,0.63,12020,20,86,325
156213,ASBURY COLLEGE,1,0,1999,NA,NA,326,198,128,200,76,124,0.62,0.59,0.61,12810,23,87,309
156213,ASBURY COLLEGE,1,0,2000,NA,NA,304,180,124,166,60,106,0.58,0.48,0.55,13744,20,89,294
156213,ASBURY COLLEGE,1,0,2001,NA,NA,331,206,125,178,66,112,0.54,0.53,0.54,14624,22,92,319
156213,ASBURY COLLEGE,1,0,2002,NA,NA,323,200,123,195,80,115,0.5700000000000001,0.65,0.6,15574,24,92,313
156213,ASBURY COLLEGE,1,0,2003,NA,NA,258,146,112,148,68,80,0.54,0.61,0.57,16352,24,90,249
156213,ASBURY COLLEGE,1,0,2004,NA,NA,302,183,119,160,68,92,0.5,0.57,0.53,17660,24,88,288
156213,Asbury College,1,0,2005,NA,NA,276,173,103,168,64,104,0.6,0.62,0.61,18808,25,86,259
156213,Asbury College,1,0,2006,NA,NA,276,161,115,178,67,111,0.68,0.58,0.64,19260,25,82,263
156213,Asbury College,1,0,2007,NA,NA,311,173,138,175,65,110,0.63,0.47,0.56,21132,25,79,293
156213,Asbury College,1,0,2008,NA,NA,313,208,105,173,57,116,0.55,0.54,0.55,22242,24,80,283
156213,Asbury College,1,0,2009,NA,NA,315,198,117,168,64,104,0.52,0.55,0.53,22242,27,83,291
156213,Asbury University,1,0,2010,NA,NA,285,187,98,149,51,98,0.52,0.52,0.52,23132,28,85,252
156286,BELLARMINE COLLEGE,1,0,1991,NA,NA,267,157,110,122,42,80,0.5,0.38,0.46,7160,14,80,250
156286,BELLARMINE COLLEGE,1,0,1992,NA,NA,283,155,128,98,40,58,0.37,0.31,0.35,7580,16,81,261
156286,BELLARMINE COLLEGE,1,0,1993,NA,NA,309,172,137,135,65,70,0.4,0.47,0.44,8072,17,84,291
156286,BELLARMINE COLLEGE,1,0,1995,NA,NA,329,189,140,151,49,102,0.53,0.35,0.46,9550,21,91,312
156286,BELLARMINE COLLEGE,1,0,1996,NA,NA,327,203,124,164,57,107,0.52,0.46,0.5,10320,22,89,302
156286,BELLARMINE COLLEGE,1,0,1997,NA,NA,318,178,140,155,62,93,0.52,0.44,0.49,10970,19,86,302
156286,BELLARMINE COLLEGE,1,0,1998,NA,NA,362,212,150,165,61,104,0.49,0.41,0.46,11770,20,94,337
156286,BELLARMINE COLLEGE,1,0,1999,NA,NA,324,223,101,182,54,128,0.5700000000000001,0.53,0.56,12480,22,103,304
156286,BELLARMINE UNIVERSITY,1,0,2000,NA,NA,355,224,131,172,63,109,0.48,0.48,0.48,13590,23,106,325
156286,BELLARMINE UNIVERSITY,1,0,2001,NA,NA,376,255,121,178,47,131,0.51,0.39,0.47,14990,24,109,343
156286,BELLARMINE UNIVERSITY,1,0,2002,NA,NA,325,214,111,165,46,119,0.55,0.41,0.51,16340,28,115,292
156286,BELLARMINE UNIVERSITY,1,0,2003,NA,NA,450,289,161,235,79,156,0.53,0.49,0.52,17820,30,115,410
156286,BELLARMINE UNIVERSITY,1,0,2004,NA,NA,407,271,136,225,58,167,0.61,0.43,0.55,19250,34,118,374
156286,Bellarmine University,1,0,2005,NA,NA,435,282,153,224,69,155,0.54,0.45,0.51,20800,35,114,389
156286,Bellarmine University,1,0,2006,NA,NA,429,279,150,206,60,146,0.52,0.4,0.48,23300,37,112,372
156286,Bellarmine University,1,0,2007,NA,NA,567,351,216,304,97,207,0.58,0.45,0.54,25200,40,126,495
156286,Bellarmine University,1,0,2008,NA,NA,567,356,211,301,109,192,0.53,0.52,0.53,27000,44,142,468
156286,Bellarmine University,1,0,2009,NA,NA,600,383,217,303,98,205,0.53,0.45,0.5,27800,51,138,524
156286,Bellarmine University,1,0,2010,NA,NA,573,362,211,301,107,194,0.53,0.51,0.53,29160,51,138,470
156295,BEREA COLLEGE,1,0,1991,NA,NA,436,246,190,147,58,89,0.36,0.31,0.34,177,44,113,359
156295,BEREA COLLEGE,1,0,1992,NA,NA,397,206,191,148,66,82,0.39,0.35,0.37,183,47,111,324
156295,BEREA COLLEGE,1,0,1993,NA,NA,453,230,223,150,78,72,0.31,0.35,0.33,183,49,112,382
156295,BEREA COLLEGE,1,0,1995,NA,NA,416,220,196,146,64,82,0.37,0.33,0.35,188,50,113,347
156295,BEREA COLLEGE,1,0,1996,NA,NA,396,225,171,125,53,72,0.32,0.31,0.32,195,54,116,313
156295,BEREA COLLEGE,1,0,1997,NA,NA,404,239,165,118,36,82,0.34,0.22,0.29,195,45,118,321
156295,BEREA COLLEGE,1,0,1998,NA,NA,414,237,177,161,70,91,0.38,0.4,0.39,195,47,118,312
156295,BEREA COLLEGE,1,0,1999,NA,NA,423,233,190,150,57,93,0.39,0.3,0.35,0,50,122,313
156295,BEREA COLLEGE,1,0,2000,NA,NA,421,245,176,169,60,109,0.44,0.34,0.4,0,49,126,315
156295,BEREA COLLEGE,1,0,2001,NA,NA,424,241,183,192,76,116,0.48,0.42,0.45,0,55,131,314
156295,BEREA COLLEGE,1,0,2002,NA,NA,356,206,150,158,61,97,0.47000000000000003,0.41,0.44,0,60,134,240
156295,BEREA COLLEGE,1,0,2003,NA,NA,396,240,156,203,83,120,0.5,0.53,0.51,0,63,130,284
156295,BEREA COLLEGE,1,0,2004,NA,NA,400,209,191,201,84,117,0.55,0.44,0.5,0,55,134,265
156295,Berea College,1,0,2005,NA,NA,378,219,159,161,67,94,0.42,0.42,0.43,0,62,136,261
156295,Berea College,1,0,2006,NA,NA,388,220,168,185,78,107,0.48,0.46,0.48,0,63,133,266
156295,Berea College,1,0,2007,NA,NA,420,252,168,197,72,125,0.49,0.43,0.47,0,66,132,296
156295,Berea College,1,0,2008,NA,NA,413,241,172,184,72,112,0.46,0.42,0.45,0,67,144,289
156295,Berea College,1,0,2009,NA,NA,391,221,170,174,74,100,0.45,0.44,0.45,0,69,137,266
156295,Berea College,1,0,2010,NA,NA,429,230,199,204,72,132,0.5700000000000001,0.36,0.48,0,70,123,300
156365,CAMPBELLSVILLE COLLEGE,1,0,1991,NA,NA,255,122,133,29,6,23,0.18,0.05,0.11,4900,8,43,236
156365,CAMPBELLSVILLE COLLEGE,1,0,1992,NA,NA,208,85,123,27,9,18,0.21,0.07,0.13,5400,9,45,189
156365,CAMPBELLSVILLE COLLEGE,1,0,1993,NA,NA,286,122,164,48,19,29,0.23,0.12,0.17,5720,10,46,255
156365,CAMPBELLSVILLE UNIVERSITY,1,0,1995,NA,NA,322,156,166,84,34,50,0.32,0.2,0.26,6420,12,53,301
156365,CAMPBELLSVILLE UNIVERSITY,1,0,1996,NA,NA,295,151,144,66,21,45,0.29,0.15,0.22,6800,14,60,271
156365,CAMPBELLSVILLE UNIVERSITY,1,0,1997,NA,NA,342,182,160,93,32,61,0.33,0.2,0.27,7200,10,60,310
156365,CAMPBELLSVILLE UNIVERSITY,1,0,1998,NA,NA,359,194,165,82,25,57,0.29,0.15,0.23,7400,11,66,311
156365,CAMPBELLSVILLE UNIVERSITY,1,0,1999,NA,NA,290,155,135,77,31,46,0.29,0.23,0.27,8000,13,68,260
156365,CAMPBELLSVILLE UNIVERSITY,1,0,2000,NA,NA,317,167,150,88,25,63,0.37,0.17,0.28,8790,14,69,289
156365,CAMPBELLSVILLE UNIVERSITY,1,0,2001,NA,NA,330,175,155,58,24,34,0.19,0.15,0.18,9800,15,70,306
156365,CAMPBELLSVILLE UNIVERSITY,1,0,2002,NA,NA,288,138,150,61,18,43,0.31,0.12,0.21,11160,17,70,261
156365,CAMPBELLSVILLE UNIVERSITY,1,0,2003,NA,NA,351,162,189,86,37,49,0.3,0.2,0.25,12504,19,73,299
156365,CAMPBELLSVILLE UNIVERSITY,1,0,2004,NA,NA,381,178,203,102,39,63,0.35000000000000003,0.19,0.27,13632,20,82,335
156365,Campbellsville University,1,0,2005,NA,NA,345,174,171,83,29,54,0.31,0.17,0.24,15140,23,86,298
156365,Campbellsville University,1,0,2006,NA,NA,346,182,164,81,32,49,0.26,0.2,0.23,15960,23,91,294
156365,Campbellsville University,1,0,2007,NA,NA,377,168,209,98,47,51,0.3,0.22,0.26,16880,24,98,295
156365,Campbellsville University,1,0,2008,NA,NA,442,192,250,112,56,56,0.29,0.22,0.25,17700,26,105,327
156365,Campbellsville University,1,0,2009,NA,NA,515,260,255,127,44,83,0.31,0.17,0.25,18410,29,115,403
156365,Campbellsville University,1,0,2010,NA,NA,502,247,255,122,46,76,0.3,0.18,0.24,19310,32,128,374
156541,CUMBERLAND COLLEGE,1,0,1991,NA,NA,460,240,220,77,29,48,0.2,0.13,0.17,5296,19,108,414
156541,CUMBERLAND COLLEGE,1,0,1992,NA,NA,332,185,147,97,36,61,0.32,0.24,0.29,5880,20,99,305
156541,CUMBERLAND COLLEGE,1,0,1993,NA,NA,397,205,192,80,24,56,0.27,0.12,0.2,6230,19,97,372
156541,CUMBERLAND COLLEGE,1,0,1995,NA,NA,377,204,173,107,33,74,0.36,0.19,0.28,7130,21,87,355
156541,CUMBERLAND COLLEGE,1,0,1996,NA,NA,421,210,211,95,40,55,0.26,0.19,0.23,7930,22,90,400
156541,CUMBERLAND COLLEGE,1,0,1997,NA,NA,418,227,191,87,30,57,0.25,0.16,0.21,8430,19,88,391
156541,CUMBERLAND COLLEGE,1,0,1998,NA,NA,412,177,235,87,30,57,0.32,0.13,0.21,8980,22,95,375
156541,CUMBERLAND COLLEGE,1,0,1999,NA,NA,403,201,202,114,41,73,0.36,0.2,0.28,9298,22,98,382
156541,CUMBERLAND COLLEGE,1,0,2000,NA,NA,403,195,208,82,37,45,0.23,0.18,0.2,9698,23,98,376
156541,CUMBERLAND COLLEGE,1,0,2001,NA,NA,406,203,203,93,33,60,0.29,0.16,0.23,10000,26,98,364
156541,CUMBERLAND COLLEGE,1,0,2002,NA,NA,386,209,177,93,31,62,0.29,0.18,0.24,10598,28,98,348
156541,CUMBERLAND COLLEGE,1,0,2003,NA,NA,401,191,210,98,33,65,0.34,0.16,0.24,11098,29,93,354
156541,CUMBERLAND COLLEGE,1,0,2004,NA,NA,418,190,228,104,36,68,0.35000000000000003,0.16,0.25,11498,25,89,368
156541,University of the Cumberlands,1,0,2005,NA,NA,424,192,232,111,48,63,0.32,0.21,0.26,12298,25,86,369
156541,University of the Cumberlands,1,0,2006,NA,NA,349,177,172,99,34,65,0.36,0.2,0.28,13298,26,93,300
156541,University of the Cumberlands,1,0,2007,NA,NA,481,217,264,115,45,70,0.32,0.17,0.24,13298,28,86,399
156541,University of the Cumberlands,1,0,2008,NA,NA,478,223,255,120,38,82,0.36,0.15,0.25,14298,29,94,349
156541,University of the Cumberlands,1,0,2009,NA,NA,453,211,242,107,31,76,0.36,0.13,0.24,15298,33,99,388
156541,University of the Cumberlands,1,0,2010,NA,NA,446,202,244,144,66,78,0.38,0.27,0.32,16664,33,105,369
156745,GEORGETOWN COLLEGE,1,0,1991,NA,NA,309,161,148,103,38,65,0.4,0.26,0.33,6250,16,68,297
156745,GEORGETOWN COLLEGE,1,0,1992,NA,NA,325,174,151,109,37,72,0.41000000000000003,0.25,0.34,6760,18,69,318
156745,GEORGETOWN COLLEGE,1,0,1993,NA,NA,285,153,132,79,20,59,0.38,0.15,0.28,7300,18,69,265
156745,GEORGETOWN COLLEGE,1,0,1995,NA,NA,304,201,103,134,30,104,0.51,0.29,0.44,8840,20,73,294
156745,GEORGETOWN COLLEGE,1,0,1996,NA,NA,326,193,133,131,41,90,0.46,0.31,0.4,9540,21,76,317
156745,GEORGETOWN COLLEGE,1,0,1997,NA,NA,394,239,155,208,59,149,0.62,0.38,0.53,10190,19,81,385
156745,GEORGETOWN COLLEGE,1,0,1998,NA,NA,408,224,184,194,61,133,0.59,0.33,0.48,10800,25,86,395
156745,GEORGETOWN COLLEGE,1,0,1999,NA,NA,340,205,135,158,51,107,0.52,0.38,0.46,11350,29,87,333
156745,GEORGETOWN COLLEGE,1,0,2000,NA,NA,331,189,142,158,49,109,0.5700000000000001,0.35,0.48,12140,30,89,319
156745,GEORGETOWN COLLEGE,1,0,2001,NA,NA,356,203,153,173,69,104,0.51,0.45,0.49,13200,30,92,345
156745,GEORGETOWN COLLEGE,1,0,2002,NA,NA,328,199,129,150,53,97,0.48,0.41,0.46,14260,31,92,312
156745,GEORGETOWN COLLEGE,1,0,2003,NA,NA,368,213,155,181,54,127,0.59,0.35,0.49,15690,31,87,349
156745,GEORGETOWN COLLEGE,1,0,2004,NA,NA,354,192,162,205,73,132,0.68,0.45,0.58,17750,30,101,332
156745,Georgetown College,1,0,2005,NA,NA,416,216,200,209,83,126,0.58,0.42,0.5,19170,31,101,394
156745,Georgetown College,1,0,2006,NA,NA,363,226,137,185,53,132,0.58,0.39,0.51,20700,35,106,346
156745,Georgetown College,1,0,2007,NA,NA,366,206,160,180,59,121,0.58,0.37,0.49,22360,36,111,289
156745,Georgetown College,1,0,2008,NA,NA,379,209,170,169,61,108,0.51,0.36,0.45,24150,37,111,334
156745,Georgetown College,1,0,2009,NA,NA,378,211,167,186,63,123,0.58,0.38,0.49,26080,37,110,342
156745,Georgetown College,1,0,2010,NA,NA,336,191,145,172,57,115,0.6,0.39,0.51,27640,37,113,297
157058,KENTUCKY STATE UNIVERSITY,1,0,1991,NA,NA,390,215,175,33,9,24,0.11,0.05,0.08,1332,30,124,122
157058,KENTUCKY STATE UNIVERSITY,1,0,1992,NA,NA,393,226,167,16,4,12,0.05,0.02,0.04,1440,35,124,90
157058,KENTUCKY STATE UNIVERSITY,1,0,1993,NA,NA,335,163,172,18,7,11,0.06,0.04,0.05,1600,34,122,101
157058,KENTUCKY STATE UNIVERSITY,1,0,1995,NA,NA,370,189,181,13,10,3,0.01,0.06,0.04,1860,39,127,96
157058,KENTUCKY STATE UNIVERSITY,1,0,1996,NA,NA,364,163,201,27,7,20,0.12,0.03,0.07,1950,40,123,74
157058,KENTUCKY STATE UNIVERSITY,1,0,1997,NA,NA,302,172,130,33,5,28,0.16,0.04,0.11,2050,41,121,65
157058,KENTUCKY STATE UNIVERSITY,1,0,1998,NA,NA,379,215,164,34,9,25,0.11,0.05,0.09,2170,42,125,87
157058,KENTUCKY STATE UNIVERSITY,1,0,1999,NA,NA,366,186,180,40,8,32,0.17,0.04,0.11,2020,43,126,61
157058,KENTUCKY STATE UNIVERSITY,1,0,2000,NA,NA,340,171,169,49,17,32,0.18,0.1,0.14,2100,47,146,64
157058,KENTUCKY STATE UNIVERSITY,1,0,2001,NA,NA,387,199,188,31,4,27,0.13,0.02,0.08,2100,55,167,57
157058,KENTUCKY STATE UNIVERSITY,1,0,2002,NA,NA,373,203,170,34,6,28,0.13,0.04,0.09,2630,49,136,50
157058,KENTUCKY STATE UNIVERSITY,1,0,2003,NA,NA,309,162,147,23,9,14,0.08,0.06,0.07,2828,52,148,62
157058,KENTUCKY STATE UNIVERSITY,1,0,2004,NA,NA,346,196,150,37,8,29,0.14,0.05,0.11,3110,55,152,66
157058,Kentucky State University,1,0,2005,NA,NA,408,223,185,17,4,13,0.05,0.02,0.04,3550,55,152,60
157058,Kentucky State University,1,0,2006,NA,NA,569,277,292,21,6,15,0.05,0.02,0.04,3900,56,129,64
157058,Kentucky State University,1,0,2007,NA,NA,602,343,259,39,5,34,0.09,0.02,0.06,4270,56,139,62
157058,Kentucky State University,1,0,2008,NA,NA,566,293,273,32,7,25,0.08,0.03,0.06,4942,61,131,58
157058,Kentucky State University,1,0,2009,NA,NA,476,265,211,24,7,17,0.06,0.03,0.05,5086,66,128,53
157058,Kentucky State University,1,0,2010,NA,NA,569,316,253,25,8,17,0.05,0.03,0.04,4920,67,129,47
157076,KENTUCKY WESLEYAN COLLEGE,1,0,1991,NA,NA,204,75,129,48,24,24,0.32,0.19,0.24,6690,8,50,180
157076,KENTUCKY WESLEYAN COLLEGE,1,0,1992,NA,NA,147,71,76,41,13,28,0.39,0.17,0.28,7170,9,50,138
157076,KENTUCKY WESLEYAN COLLEGE,1,0,1993,NA,NA,173,79,94,41,17,24,0.3,0.18,0.24,7600,9,51,161
157076,KENTUCKY WESLEYAN COLLEGE,1,0,1995,NA,NA,151,79,72,49,17,32,0.4,0.24,0.32,9100,11,48,147
157076,KENTUCKY WESLEYAN COLLEGE,1,0,1996,NA,NA,179,103,76,44,22,22,0.21,0.29,0.25,9100,10,47,169
157076,KENTUCKY WESLEYAN COLLEGE,1,0,1997,NA,NA,203,131,72,84,27,57,0.43,0.38,0.41,9220,8,43,191
157076,KENTUCKY WESLEYAN COLLEGE,1,0,1998,NA,NA,152,95,57,53,18,35,0.36,0.32,0.35,9730,8,43,140
157076,KENTUCKY WESLEYAN COLLEGE,1,0,1999,NA,NA,191,102,89,51,18,33,0.32,0.2,0.27,9770,8,41,183
157076,KENTUCKY WESLEYAN COLLEGE,1,0,2000,NA,NA,159,75,84,37,12,25,0.33,0.14,0.23,10070,9,42,150
157076,KENTUCKY WESLEYAN COLLEGE,1,0,2001,NA,NA,164,60,104,24,8,16,0.26,0.08,0.15,10570,10,43,145
157076,KENTUCKY WESLEYAN COLLEGE,1,0,2002,NA,NA,150,77,73,44,13,31,0.4,0.18,0.29,11100,8,39,123
157076,KENTUCKY WESLEYAN COLLEGE,1,0,2003,NA,NA,165,91,74,58,19,39,0.42,0.26,0.35,11700,10,34,145
157076,KENTUCKY WESLEYAN COLLEGE,1,0,2004,NA,NA,210,93,117,64,25,39,0.41000000000000003,0.21,0.3,12160,10,34,164
157076,Kentucky Wesleyan College,1,0,2005,NA,NA,209,100,109,67,22,45,0.45,0.2,0.32,12590,10,34,160
157076,Kentucky Wesleyan College,1,0,2006,NA,NA,326,127,199,82,41,41,0.32,0.21,0.25,13200,11,40,256
157076,Kentucky Wesleyan College,1,0,2007,NA,NA,280,120,160,69,27,42,0.35000000000000003,0.17,0.25,14100,13,42,221
157076,Kentucky Wesleyan College,1,0,2008,NA,NA,219,103,116,81,44,37,0.35000000000000003,0.38,0.37,15500,14,45,171
157076,Kentucky Wesleyan College,1,0,2009,NA,NA,227,118,109,79,30,49,0.41000000000000003,0.28,0.35,16870,14,43,156
157076,Kentucky Wesleyan College,1,0,2010,NA,NA,202,96,106,64,26,38,0.39,0.25,0.32,17980,13,41,148
157085,UNIVERSITY OF KENTUCKY,1,0,1991,NA,NA,2817,1434,1383,389,138,251,0.17,0.1,0.14,1844,632,1223,2500
157085,UNIVERSITY OF KENTUCKY,1,0,1992,NA,NA,2562,1374,1188,528,195,333,0.24,0.16,0.21,1998,686,1200,2280
157085,UNIVERSITY OF KENTUCKY,1,0,1993,NA,NA,2662,1391,1271,599,210,389,0.27,0.17,0.23,2278,689,1200,2341
157085,UNIVERSITY OF KENTUCKY,1,0,1995,NA,NA,2612,1383,1229,620,235,385,0.27,0.19,0.24,2594,763,1238,2306
157085,UNIVERSITY OF KENTUCKY,1,0,1996,NA,NA,2640,1459,1181,720,253,467,0.32,0.21,0.27,2676,825,1239,2329
157085,UNIVERSITY OF KENTUCKY,1,0,1997,NA,NA,2740,1499,1241,743,281,462,0.3,0.23,0.27,2736,944,1222,2408
157085,UNIVERSITY OF KENTUCKY,1,0,1998,NA,NA,2931,1548,1383,815,331,484,0.31,0.24,0.28,3016,968,1228,2595
157085,UNIVERSITY OF KENTUCKY,1,0,1999,NA,NA,2742,1499,1243,792,293,499,0.33,0.24,0.29,2960,994,1239,2468
157085,UNIVERSITY OF KENTUCKY,1,0,2000,NA,NA,2971,1590,1381,884,333,551,0.34,0.24,0.3,3110,1099,1202,2640
157085,UNIVERSITY OF KENTUCKY,1,0,2001,NA,NA,3129,1679,1450,942,374,568,0.33,0.26,0.3,3270,1162,1165,2852
157085,UNIVERSITY OF KENTUCKY,1,0,2002,NA,NA,3701,1999,1702,1045,362,683,0.34,0.21,0.28,3480,1173,1202,3347
157085,UNIVERSITY OF KENTUCKY,1,0,2003,NA,NA,3678,1951,1727,1160,460,700,0.35000000000000003,0.27,0.32,4002,1225,1209,3289
157085,UNIVERSITY OF KENTUCKY,1,0,2004,NA,NA,3935,2097,1838,1276,486,790,0.37,0.26,0.32,4602,1376,1198,3464
157085,University of Kentucky,1,0,2005,NA,NA,3824,2045,1779,1291,502,789,0.38,0.28,0.34,5162,1487,1211,3437
157085,University of Kentucky,1,0,2006,NA,NA,4113,2201,1912,1253,443,810,0.36,0.23,0.3,5782,1646,1233,3517
157085,University of Kentucky,1,0,2007,NA,NA,3826,2006,1820,1276,498,778,0.38,0.27,0.33,6302,1831,1251,3271
157085,University of Kentucky,1,0,2008,NA,NA,4074,2086,1988,1323,513,810,0.38,0.26,0.32,6870,1930,1245,3391
157085,University of Kentucky,1,0,2009,NA,NA,4105,2102,2003,1438,551,887,0.42,0.28,0.35,7214,2045,1276,3368
157085,University of Kentucky,1,0,2010,NA,NA,4270,2203,2067,1625,615,1010,0.45,0.3,0.38,7656,2135,1313,3376
157289,UNIVERSITY OF LOUISVILLE,1,0,1991,NA,NA,2050,1007,1043,105,28,77,0.07,0.03,0.05,1740,308,676,1701
157289,UNIVERSITY OF LOUISVILLE,1,0,1992,NA,NA,1745,843,902,133,45,88,0.1,0.05,0.08,1880,316,681,1404
157289,UNIVERSITY OF LOUISVILLE,1,0,1993,NA,NA,1743,858,885,157,57,100,0.11,0.06,0.09,2170,317,674,1384
157289,UNIVERSITY OF LOUISVILLE,1,0,1995,NA,NA,1835,903,932,193,69,124,0.13,0.07,0.11,2470,324,672,1451
157289,UNIVERSITY OF LOUISVILLE,1,0,1996,NA,NA,1861,950,911,197,69,128,0.13,0.08,0.11,2570,381,691,1463
157289,UNIVERSITY OF LOUISVILLE,1,0,1997,NA,NA,1931,1024,907,241,86,155,0.15,0.09,0.12,2630,398,704,1528
157289,UNIVERSITY OF LOUISVILLE,1,0,1998,NA,NA,2032,1011,1021,222,81,141,0.13,0.08,0.11,2920,426,703,1662
157289,UNIVERSITY OF LOUISVILLE,1,0,1999,NA,NA,2297,1232,1065,289,90,199,0.16,0.08,0.13,2960,435,756,1838
157289,UNIVERSITY OF LOUISVILLE,1,0,2000,NA,NA,2249,1162,1087,321,113,208,0.17,0.1,0.14,3149,472,738,1802
157289,UNIVERSITY OF LOUISVILLE,1,0,2001,NA,NA,2209,1150,1059,351,137,214,0.18,0.13,0.16,3794,507,720,1786
157289,UNIVERSITY OF LOUISVILLE,1,0,2002,NA,NA,2209,1153,1056,428,157,271,0.23,0.15,0.19,4082,497,726,1773
157289,UNIVERSITY OF LOUISVILLE,1,0,2003,NA,NA,2197,1118,1079,468,173,295,0.26,0.16,0.21,4450,520,780,1789
157289,UNIVERSITY OF LOUISVILLE,1,0,2004,NA,NA,2303,1197,1106,489,164,325,0.27,0.15,0.21,5040,559,796,1867
157289,University of Louisville,1,0,2005,NA,NA,2255,1144,1111,497,205,292,0.25,0.18,0.22,5532,592,802,1799
157289,University of Louisville,1,0,2006,NA,NA,2380,1230,1150,628,257,371,0.3,0.22,0.26,6252,633,829,1916
157289,University of Louisville,1,0,2007,NA,NA,2525,1314,1211,634,262,372,0.28,0.22,0.25,6940,688,861,2033
157289,University of Louisville,1,0,2008,NA,NA,2548,1344,1204,915,391,524,0.38,0.32,0.36,7564,746,862,2076
157289,University of Louisville,1,0,2009,NA,NA,2441,1273,1168,622,270,352,0.27,0.23,0.25,7944,759,867,1943
157289,University of Louisville,1,0,2010,NA,NA,2507,1266,1241,696,308,388,0.3,0.25,0.28,8424,788,894,1955
157386,MOREHEAD STATE UNIVERSITY,1,0,1991,NA,NA,1261,674,587,99,32,67,0.09,0.05,0.08,1510,66,346,1197
157386,MOREHEAD STATE UNIVERSITY,1,0,1992,NA,NA,1349,769,580,133,39,94,0.12,0.07,0.1,1630,72,328,1260
157386,MOREHEAD STATE UNIVERSITY,1,0,1993,NA,NA,1266,706,560,143,41,102,0.14,0.07,0.11,1800,70,336,1201
157386,MOREHEAD STATE UNIVERSITY,1,0,1995,NA,NA,1119,646,473,104,7,97,0.15,0.01,0.09,2000,77,337,1069
157386,MOREHEAD STATE UNIVERSITY,1,0,1996,NA,NA,1271,687,584,157,55,102,0.14,0.09,0.12,2090,79,326,1176
157386,MOREHEAD STATE UNIVERSITY,1,0,1997,NA,NA,1227,674,553,160,55,105,0.15,0.1,0.13,2150,79,317,1134
157386,MOREHEAD STATE UNIVERSITY,1,0,1998,NA,NA,1369,739,630,157,48,109,0.14,0.08,0.11,2270,84,321,1255
157386,MOREHEAD STATE UNIVERSITY,1,0,1999,NA,NA,1325,756,569,156,55,101,0.13,0.1,0.12,2020,87,320,1242
157386,MOREHEAD STATE UNIVERSITY,1,0,2000,NA,NA,1473,849,624,181,59,122,0.14,0.09,0.12,2510,89,330,1397
157386,MOREHEAD STATE UNIVERSITY,1,0,2001,NA,NA,1588,894,694,185,66,119,0.13,0.1,0.12,2710,99,340,1482
157386,MOREHEAD STATE UNIVERSITY,1,0,2002,NA,NA,1563,882,681,172,59,113,0.12,0.09,0.11,2926,99,353,1461
157386,MOREHEAD STATE UNIVERSITY,1,0,2003,NA,NA,1555,867,688,185,60,125,0.14,0.09,0.12,3364,104,361,1462
157386,MOREHEAD STATE UNIVERSITY,1,0,2004,NA,NA,1307,737,570,125,39,86,0.11,0.07,0.1,3840,111,358,1223
157386,Morehead State University,1,0,2005,NA,NA,1310,745,565,162,55,107,0.14,0.1,0.12,4320,113,378,1205
157386,Morehead State University,1,0,2006,NA,NA,1330,741,589,201,65,136,0.18,0.11,0.15,4870,119,384,1236
157386,Morehead State University,1,0,2007,NA,NA,1445,803,642,257,87,170,0.21,0.14,0.18,5280,121,379,1347
157386,Morehead State University,1,0,2008,NA,NA,1313,777,536,235,78,157,0.2,0.15,0.18,5400,136,369,1210
157386,Morehead State University,1,0,2009,NA,NA,1240,708,532,231,74,157,0.22,0.14,0.19,6036,138,370,1143
157386,Morehead State University,1,0,2010,NA,NA,1175,662,513,294,118,176,0.26,0.23,0.25,6492,143,374,1072
157401,MURRAY STATE UNIVERSITY,1,0,1991,NA,NA,1147,633,514,120,34,86,0.13,0.07,0.1,1410,75,363,1056
157401,MURRAY STATE UNIVERSITY,1,0,1992,NA,NA,982,538,444,223,76,147,0.27,0.17,0.23,1600,77,337,911
157401,MURRAY STATE UNIVERSITY,1,0,1993,NA,NA,946,510,436,228,77,151,0.29,0.18,0.24,1780,75,336,861
157401,MURRAY STATE UNIVERSITY,1,0,1995,NA,NA,1201,661,540,262,82,180,0.27,0.15,0.22,1960,82,338,1095
157401,MURRAY STATE UNIVERSITY,1,0,1996,NA,NA,1366,749,617,339,105,234,0.31,0.17,0.25,2060,89,347,1242
157401,MURRAY STATE UNIVERSITY,1,0,1997,NA,NA,1206,691,515,184,51,133,0.19,0.1,0.15,2120,97,355,1087
157401,MURRAY STATE UNIVERSITY,1,0,1998,NA,NA,1275,707,568,341,122,219,0.3,0.21,0.27,2300,97,369,1133
157401,MURRAY STATE UNIVERSITY,1,0,1999,NA,NA,1177,666,511,345,114,231,0.34,0.22,0.29,2020,108,371,1051
157401,MURRAY STATE UNIVERSITY,1,0,2000,NA,NA,1210,730,480,348,108,240,0.32,0.22,0.29,2172,109,373,1070
157401,MURRAY STATE UNIVERSITY,1,0,2001,NA,NA,1409,827,582,423,135,288,0.34,0.23,0.3,2334,118,376,1282
157401,MURRAY STATE UNIVERSITY,1,0,2002,NA,NA,1467,879,588,439,130,309,0.35000000000000003,0.22,0.3,2540,115,390,1322
157401,MURRAY STATE UNIVERSITY,1,0,2003,NA,NA,1500,876,624,477,160,317,0.36,0.26,0.32,2944,123,393,1321
157401,MURRAY STATE UNIVERSITY,1,0,2004,NA,NA,1414,804,610,531,176,355,0.44,0.29,0.38,3420,125,380,1282
157401,Murray State University,1,0,2005,NA,NA,1442,841,601,532,180,352,0.41000000000000003,0.3,0.37,3792,133,385,1310
157401,Murray State University,1,0,2006,NA,NA,1390,822,568,391,123,268,0.32,0.22,0.28,4284,139,396,1222
157401,Murray State University,1,0,2007,NA,NA,1393,835,558,397,128,269,0.32,0.23,0.28,4650,146,395,1222
157401,Murray State University,1,0,2008,NA,NA,1452,875,577,415,120,295,0.33,0.21,0.29,4932,153,398,1232
157401,Murray State University,1,0,2009,NA,NA,1374,837,537,330,101,229,0.27,0.19,0.24,5130,157,406,1127
157401,Murray State University,1,0,2010,NA,NA,1363,830,533,344,104,240,0.28,0.2,0.25,5388,164,401,1152
157447,NORTHERN KENTUCKY UNIVERSITY,1,0,1991,NA,NA,1282,698,584,42,14,28,0.04,0.02,0.03,1410,55,351,1221
157447,NORTHERN KENTUCKY UNIVERSITY,1,0,1992,NA,NA,1359,714,645,49,12,37,0.05,0.02,0.04,1560,61,351,1299
157447,NORTHERN KENTUCKY UNIVERSITY,1,0,1993,NA,NA,1517,890,627,55,11,44,0.04,0.02,0.04,1720,65,360,1450
157447,NORTHERN KENTUCKY UNIVERSITY,1,0,1995,NA,NA,1545,873,672,79,22,57,0.06,0.03,0.05,1960,74,373,1471
157447,NORTHERN KENTUCKY UNIVERSITY,1,0,1996,NA,NA,1487,823,664,71,16,55,0.06,0.02,0.05,2020,76,373,1407
157447,NORTHERN KENTUCKY UNIVERSITY,1,0,1997,NA,NA,1657,949,708,84,21,63,0.06,0.03,0.05,2120,77,378,1569
157447,NORTHERN KENTUCKY UNIVERSITY,1,0,1998,NA,NA,1627,956,671,118,32,86,0.09,0.05,0.07,2248,81,394,1525
157447,NORTHERN KENTUCKY UNIVERSITY,1,0,1999,NA,NA,1696,969,727,35,13,22,0.02,0.02,0.02,2100,90,424,1578
157447,NORTHERN KENTUCKY UNIVERSITY,1,0,2000,NA,NA,1682,974,708,114,37,77,0.07,0.05,0.07,2328,94,456,1551
157447,NORTHERN KENTUCKY UNIVERSITY,1,0,2001,NA,NA,1787,1008,779,149,52,97,0.09,0.07,0.08,2460,101,488,1635
157447,NORTHERN KENTUCKY UNIVERSITY,1,0,2002,NA,NA,1907,1084,823,185,66,119,0.1,0.08,0.1,3216,103,488,1713
157447,NORTHERN KENTUCKY UNIVERSITY,1,0,2003,NA,NA,1962,1108,854,155,35,120,0.1,0.04,0.08,3744,117,498,1785
157447,NORTHERN KENTUCKY UNIVERSITY,1,0,2004,NA,NA,1915,1123,792,151,43,108,0.09,0.05,0.08,4368,123,522,1739
157447,Northern Kentucky University,1,0,2005,NA,NA,1759,1000,759,185,50,135,0.13,0.07,0.11,4968,131,544,1588
157447,Northern Kentucky University,1,0,2006,NA,NA,1908,1069,839,230,83,147,0.13,0.1,0.12,5448,142,575,1668
157447,Northern Kentucky University,1,0,2007,NA,NA,1896,1068,828,253,84,169,0.15,0.1,0.13,5952,155,597,1623
157447,Northern Kentucky University,1,0,2008,NA,NA,2001,1117,884,252,77,175,0.15,0.09,0.13,6528,173,523,1684
157447,Northern Kentucky University,1,0,2009,NA,NA,2187,1219,968,340,121,219,0.17,0.12,0.16,6792,195,532,1837
157447,Northern Kentucky University,1,0,2010,NA,NA,2230,1238,992,321,116,205,0.16,0.12,0.14,7128,194,525,1785
157535,PIKEVILLE COLLEGE,1,0,1991,NA,NA,181,134,47,25,6,19,0.14,0.13,0.14,4200,9,56,177
157535,PIKEVILLE COLLEGE,1,0,1992,NA,NA,198,139,59,17,8,9,0.06,0.14,0.09,4900,9,54,197
157535,PIKEVILLE COLLEGE,1,0,1993,NA,NA,167,117,50,20,7,13,0.11,0.14,0.12,5500,10,58,163
157535,PIKEVILLE COLLEGE,1,0,1995,NA,NA,227,154,73,34,8,26,0.16,0.11,0.15,6000,9,59,220
157535,PIKEVILLE COLLEGE,1,0,1996,NA,NA,211,144,67,34,11,23,0.15,0.16,0.16,6500,11,53,211
157535,PIKEVILLE COLLEGE,1,0,1997,NA,NA,178,110,68,25,8,17,0.15,0.12,0.14,6500,10,57,178
157535,PIKEVILLE COLLEGE,1,0,1998,NA,NA,169,110,59,30,12,18,0.16,0.2,0.18,7500,11,61,169
157535,PIKEVILLE COLLEGE,1,0,1999,NA,NA,206,140,66,41,10,31,0.22,0.15,0.2,7500,13,68,203
157535,PIKEVILLE COLLEGE,1,0,2000,NA,NA,282,137,145,45,7,38,0.27,0.05,0.16,7800,16,74,232
157535,PIKEVILLE COLLEGE,1,0,2001,NA,NA,258,142,116,41,11,30,0.21,0.09,0.16,8200,16,81,218
157535,PIKEVILLE COLLEGE,1,0,2002,NA,NA,226,129,97,40,9,31,0.24,0.09,0.18,9000,19,66,206
157535,PIKEVILLE COLLEGE,1,0,2003,NA,NA,147,67,80,27,10,17,0.25,0.12,0.18,9900,20,62,133
157535,PIKEVILLE COLLEGE,1,0,2004,NA,NA,175,103,72,31,8,23,0.22,0.11,0.18,10500,20,56,167
157535,Pikeville College,1,0,2005,NA,NA,206,98,108,31,8,23,0.23,0.07,0.15,11500,19,55,190
157535,Pikeville College,1,0,2006,NA,NA,220,105,115,26,4,22,0.2,0.03,0.12,12750,20,56,180
157535,Pikeville College,1,0,2007,NA,NA,233,103,130,35,15,20,0.19,0.12,0.15,13750,21,61,200
157535,Pikeville College,1,0,2008,NA,NA,177,83,94,41,13,28,0.33,0.14,0.23,14250,23,59,156
157535,Pikeville College,1,0,2009,NA,NA,185,62,123,38,20,18,0.29,0.16,0.21,14535,23,54,148
157535,Pikeville College,1,0,2010,NA,NA,393,154,239,56,22,34,0.22,0.09,0.14,15250,21,56,335
157951,WESTERN KENTUCKY UNIVERSITY,1,0,1991,NA,NA,2263,1267,996,259,77,182,0.14,0.08,0.11,1440,102,560,2044
157951,WESTERN KENTUCKY UNIVERSITY,1,0,1992,NA,NA,2192,1261,931,271,80,191,0.15,0.09,0.12,1544,109,560,2005
157951,WESTERN KENTUCKY UNIVERSITY,1,0,1993,NA,NA,2201,1222,979,238,80,158,0.12,0.08,0.11,1704,108,553,1990
157951,WESTERN KENTUCKY UNIVERSITY,1,0,1995,NA,NA,2454,1364,1090,496,159,337,0.24,0.15,0.2,1910,117,542,2182
157951,WESTERN KENTUCKY UNIVERSITY,1,0,1996,NA,NA,2257,1234,1023,471,164,307,0.24,0.16,0.21,1970,121,546,1999
157951,WESTERN KENTUCKY UNIVERSITY,1,0,1997,NA,NA,2205,1244,961,445,148,297,0.23,0.15,0.2,2140,128,542,1955
157951,WESTERN KENTUCKY UNIVERSITY,1,0,1998,NA,NA,2353,1347,1006,542,190,352,0.26,0.19,0.23,2260,136,553,2058
157951,WESTERN KENTUCKY UNIVERSITY,1,0,1999,NA,NA,2480,1447,1033,568,204,364,0.25,0.2,0.23,2020,149,562,2201
157951,WESTERN KENTUCKY UNIVERSITY,1,0,2000,NA,NA,2477,1444,1033,634,202,432,0.29,0.2,0.26,2150,175,580,2145
157951,WESTERN KENTUCKY UNIVERSITY,1,0,2001,NA,NA,2640,1563,1077,651,192,459,0.29,0.18,0.25,2290,164,599,2281
157951,WESTERN KENTUCKY UNIVERSITY,1,0,2002,NA,NA,2954,1714,1240,513,136,377,0.22,0.11,0.17,3120,166,614,2533
157951,WESTERN KENTUCKY UNIVERSITY,1,0,2003,NA,NA,3034,1782,1252,541,169,372,0.2,0.13,0.18,3232,178,646,2620
157951,WESTERN KENTUCKY UNIVERSITY,1,0,2004,NA,NA,2918,1647,1271,456,155,301,0.18,0.12,0.16,4596,191,679,2441
157951,Western Kentucky University,1,0,2005,NA,NA,3002,1680,1322,539,189,350,0.2,0.14,0.18,5316,204,686,2549
157951,Western Kentucky University,1,0,2006,NA,NA,3118,1768,1350,649,217,432,0.24,0.16,0.21,5952,224,720,2529
157951,Western Kentucky University,1,0,2007,NA,NA,3013,1716,1297,610,197,413,0.24,0.15,0.2,6416,237,719,2470
157951,Western Kentucky University,1,0,2008,NA,NA,3203,1821,1382,684,247,437,0.24,0.18,0.21,6930,255,719,2545
157951,Western Kentucky University,1,0,2009,NA,NA,3288,1783,1505,700,249,451,0.25,0.17,0.21,7200,270,728,2605
157951,Western Kentucky University,1,0,2010,NA,NA,3279,1865,1414,747,228,519,0.27,0.16,0.23,7560,287,742,2610
158477,CENTENARY COLLEGE OF LOUISIANA,1,0,1991,NA,NA,207,124,83,87,29,58,0.46,0.35,0.42,7220,13,69,175
158477,CENTENARY COLLEGE OF LOUISIANA,1,0,1992,NA,NA,249,146,103,84,38,46,0.31,0.37,0.34,7550,13,69,214
158477,CENTENARY COLLEGE OF LOUISIANA,1,0,1993,NA,NA,211,121,90,80,33,47,0.38,0.37,0.38,8406,14,66,185
158477,CENTENARY COLLEGE OF LOUISIANA,1,0,1995,NA,NA,213,134,79,91,26,65,0.48,0.33,0.43,10122,15,68,188
158477,CENTENARY COLLEGE OF LOUISIANA,1,0,1996,NA,NA,190,103,87,74,29,45,0.43,0.33,0.39,10400,17,65,175
158477,CENTENARY COLLEGE OF LOUISIANA,1,0,1997,NA,NA,226,116,110,88,28,60,0.51,0.25,0.39,11050,15,70,190
158477,CENTENARY COLLEGE OF LOUISIANA,1,0,1998,NA,NA,294,180,114,126,34,92,0.51,0.3,0.43,12100,16,69,257
158477,CENTENARY COLLEGE OF LOUISIANA,1,0,1999,NA,NA,270,162,108,112,34,78,0.48,0.31,0.41,13200,18,71,230
158477,CENTENARY COLLEGE OF LOUISIANA,1,0,2000,NA,NA,229,152,77,99,33,66,0.43,0.43,0.43,14200,20,73,198
158477,CENTENARY COLLEGE OF LOUISIANA,1,0,2001,NA,NA,256,168,88,116,31,85,0.5,0.35,0.45,15400,23,76,224
158477,CENTENARY COLLEGE OF LOUISIANA,1,0,2002,NA,NA,272,163,109,122,42,80,0.49,0.39,0.45,16000,25,73,227
158477,CENTENARY COLLEGE OF LOUISIANA,1,0,2003,NA,NA,197,113,84,101,34,67,0.59,0.4,0.51,16750,26,75,155
158477,CENTENARY COLLEGE OF LOUISIANA,1,0,2004,NA,NA,282,190,92,145,42,103,0.54,0.46,0.51,16750,26,71,245
158477,Centenary College of Louisiana,1,0,2005,NA,NA,232,145,87,104,33,71,0.48,0.38,0.45,17750,27,72,198
158477,Centenary College of Louisiana,1,0,2006,NA,NA,241,136,105,104,45,59,0.43,0.43,0.43,18900,28,73,196
158477,Centenary College of Louisiana,1,0,2007,NA,NA,200,114,86,97,35,62,0.54,0.41,0.48,19850,30,72,160
158477,Centenary College of Louisiana,1,0,2008,NA,NA,246,148,98,104,41,63,0.42,0.42,0.42,20940,30,71,202
158477,Centenary College of Louisiana,1,0,2009,NA,NA,278,162,116,128,49,79,0.48,0.42,0.46,21790,31,70,205
158477,Centenary College of Louisiana,1,0,2010,NA,NA,192,104,88,81,29,52,0.5,0.33,0.42,22880,28,67,131
159009,GRAMBLING STATE UNIVERSITY,1,0,1991,NA,NA,1325,741,584,121,30,91,0.12,0.05,0.09,1802,59,269,6
159009,GRAMBLING STATE UNIVERSITY,1,0,1992,NA,NA,1385,775,610,109,30,79,0.1,0.05,0.08,1788,63,284,13
159009,GRAMBLING STATE UNIVERSITY,1,0,1993,NA,NA,1620,859,761,160,34,126,0.14,0.04,0.1,2088,64,267,2
159009,GRAMBLING STATE UNIVERSITY,1,0,1995,NA,NA,1121,569,552,107,23,84,0.14,0.04,0.1,2088,71,286,2
159009,GRAMBLING STATE UNIVERSITY,1,0,1996,NA,NA,1091,574,517,90,27,63,0.1,0.05,0.08,2112,77,292,4
159009,GRAMBLING STATE UNIVERSITY,1,0,1997,NA,NA,799,408,391,52,25,27,0.06,0.06,0.07,2022,74,311,0
159009,GRAMBLING STATE UNIVERSITY,1,0,1998,NA,NA,771,359,412,71,23,48,0.13,0.06,0.09,2208,70,263,1
159009,GRAMBLING STATE UNIVERSITY,1,0,1999,NA,NA,690,367,323,88,24,64,0.17,0.07,0.13,2301,68,241,3
159009,GRAMBLING STATE UNIVERSITY,1,0,2000,NA,NA,908,513,395,182,46,136,0.26,0.12,0.2,2589,67,242,9
159009,GRAMBLING STATE UNIVERSITY,1,0,2001,NA,NA,884,479,405,94,23,71,0.14,0.06,0.11,1900,71,244,3
159009,GRAMBLING STATE UNIVERSITY,1,0,2002,NA,NA,850,430,420,107,44,63,0.14,0.1,0.13,1980,68,241,2
159009,GRAMBLING STATE UNIVERSITY,1,0,2003,NA,NA,1022,570,452,124,29,95,0.16,0.06,0.12,2352,70,246,12
159009,GRAMBLING STATE UNIVERSITY,1,0,2004,NA,NA,1132,675,457,115,33,82,0.12,0.07,0.1,2280,72,244,10
159009,Grambling State University,1,0,2005,NA,NA,1129,568,561,82,22,60,0.1,0.04,0.07,2232,75,251,7
159009,Grambling State University,1,0,2006,NA,NA,1119,609,510,108,33,75,0.12,0.06,0.1,2232,77,248,4
159009,Grambling State University,1,0,2007,NA,NA,1184,610,574,83,24,59,0.09,0.04,0.07,2232,85,249,8
159009,Grambling State University,1,0,2008,NA,NA,1203,626,577,144,53,91,0.14,0.09,0.12,2414,107,258,7
159009,Grambling State University,1,0,2009,NA,NA,910,548,362,177,65,112,0.2,0.18,0.19,2606,102,242,6
159009,Grambling State University,1,0,2010,NA,NA,706,384,322,183,63,120,0.31,0.2,0.26,3018,101,238,5
159391,LOUISIANA ST UNIV & AGRL & MECH & HEBERT LAWS CTR,1,0,1991,NA,NA,3342,1779,1563,579,201,378,0.21,0.13,0.17,2058,402,1494,2744
159391,LOUISIANA ST UNIV & AGRL & MECH & HEBERT LAWS CTR,1,0,1992,NA,NA,3503,1884,1619,651,219,432,0.22,0.14,0.19,2173,416,1510,2880
159391,LOUISIANA ST UNIV & AGRL & MECH & HEBERT LAWS CTR,1,0,1993,NA,NA,3178,1697,1481,586,182,404,0.23,0.12,0.18,2625,421,1439,2549
159391,LOUISIANA ST UNIV & AGRL & MECH & HEBERT LAWS CTR,1,0,1995,NA,NA,3646,2007,1639,746,257,489,0.24,0.16,0.2,2663,447,1453,2969
159391,LOUISIANA ST UNIV & AGRL & MECH & HEBERT LAWS CTR,1,0,1996,NA,NA,3992,2169,1823,867,264,603,0.27,0.14,0.22,2687,465,1456,3184
159391,LOUISIANA STATE UNIV & AG & MECH & HEBERT LAWS CTR,1,0,1997,NA,NA,4443,2533,1910,959,319,640,0.25,0.17,0.22,2711,481,1460,3504
159391,LOUISIANA STATE UNIV & AG & MECH & HEBERT LAW CTR,1,0,1998,NA,NA,5066,2874,2192,1198,399,799,0.27,0.18,0.24,2871,499,1515,4076
159391,LOUISIANA STATE UNIV & AG & MECH & HEBERT LAWS CTR,1,0,1999,NA,NA,5173,2956,2217,1262,398,864,0.29,0.18,0.24,2301,532,1528,4159
159391,LOUISIANA STATE UNIV & AG & MECH & HEBERT LAWS CTR,1,0,2000,NA,NA,5072,2803,2269,1229,431,798,0.28,0.19,0.24,2551,586,1401,4148
159391,LOUISIANA STATE UNIV & AG & MECH & HEBERT LAWS CTR,1,0,2001,NA,NA,5214,2873,2341,1282,424,858,0.29,0.18,0.25,2551,608,1274,4297
159391,LOUISIANA STATE UNIV & AG & MECH & HEBERT LAWS CTR,1,0,2002,NA,NA,5170,2842,2328,1353,464,889,0.31,0.2,0.26,2635,628,1274,4282
159391,LOUISIANA STATE UNIV & AG & MECH & HEBERT LAWS CTR,1,0,2003,NA,NA,5359,2938,2421,1396,468,928,0.31,0.19,0.26,2739,670,1279,4402
159391,LOUISIANA STATE UNIV & AG & MECH & HEBERT LAWS CTR,1,0,2004,NA,NA,5692,3099,2593,1492,539,953,0.3,0.21,0.26,2855,715,1276,4607
159391,Louisiana State University and Agricultural & Mechanical College,1,0,2005,NA,NA,4966,2653,2313,1440,576,864,0.32,0.25,0.29,2981,780,1277,4075
159391,Louisiana State University and Agricultural & Mechanical College,1,0,2006,NA,NA,4503,2449,2054,1530,584,946,0.38,0.28,0.34,2981,818,1241,3711
159391,Louisiana State University and Agricultural & Mechanical College,1,0,2007,NA,NA,4585,2415,2170,1737,658,1079,0.44,0.3,0.38,2981,859,1267,3741
159391,Louisiana State University and Agricultural & Mechanical College,1,0,2008,NA,NA,5131,2781,2350,1900,699,1201,0.43,0.3,0.37,3215,981,1319,4084
159391,Louisiana State University and Agricultural & Mechanical College,1,0,2009,NA,NA,4776,2516,2260,1823,665,1158,0.46,0.29,0.38,3469,1021,1305,3785
159391,Louisiana State University and Agricultural & Mechanical College,1,0,2010,NA,NA,5477,2904,2573,2145,777,1368,0.47000000000000003,0.3,0.39,3968,983,1238,4257
159647,LOUISIANA TECH UNIVERSITY,0,1,1991,Inf,0,1834,827,1007,278,108,170,0.2,0.11,0.15,1841,72,397,1247
159647,LOUISIANA TECH UNIVERSITY,0,1,1992,Inf,0,1473,703,770,264,86,178,0.25,0.11,0.18,1868,81,407,1174
159647,LOUISIANA TECHNICAL UNIVERSITY,0,1,1993,Inf,0,1411,672,739,258,96,162,0.24,0.13,0.18,2169,81,389,1173
159647,LOUISIANA TECH UNIVERSITY,0,1,1995,Inf,0,1278,598,680,281,103,178,0.29,0.15,0.22,2274,85,381,1040
159647,LOUISIANA TECH UNIVERSITY,0,1,1996,Inf,0,1279,618,661,330,133,197,0.31,0.2,0.26,2352,86,371,1057
159647,LOUISIANA TECH UNIVERSITY,0,1,1997,Inf,0,1428,714,714,361,133,228,0.31,0.19,0.25,2517,90,363,1163
159647,LOUISIANA TECH UNIVERSITY,0,1,1998,Inf,0,1621,794,827,449,178,271,0.34,0.22,0.28,2532,97,366,1342
159647,LOUISIANA TECH UNIVERSITY,0,1,1999,Inf,0,1753,840,913,478,199,279,0.33,0.22,0.27,2379,101,369,1391
159647,LOUISIANA TECH UNIVERSITY,0,1,2000,Inf,0,1795,819,976,480,222,258,0.31,0.23,0.27,2778,107,371,1425
159647,LOUISIANA TECH UNIVERSITY,0,1,2001,Inf,0,1770,850,920,481,211,270,0.31,0.23,0.27,2922,113,373,1391
159647,LOUISIANA TECH UNIVERSITY,0,1,2002,Inf,0,1936,947,989,500,202,298,0.31,0.2,0.26,2919,112,389,1448
159647,LOUISIANA TECH UNIVERSITY,0,1,2003,Inf,0,1948,958,990,485,190,295,0.3,0.19,0.25,3462,126,397,1493
159647,LOUISIANA TECH UNIVERSITY,0,1,2004,Inf,0,1644,730,914,432,189,243,0.33,0.21,0.26,3795,130,394,1151
159647,Louisiana Tech University,0,1,2005,Inf,0,1653,762,891,446,177,269,0.35000000000000003,0.2,0.27,3951,129,378,1304
159647,Louisiana Tech University,0,1,2006,Inf,0,1625,753,872,426,185,241,0.32,0.21,0.26,4383,133,380,1204
159647,Louisiana Tech University,0,1,2007,Inf,0,1522,704,818,432,180,252,0.35000000000000003,0.22,0.28,4458,142,432,1193
159647,Louisiana Tech University,0,1,2008,Inf,0,1503,695,808,428,187,241,0.34,0.23,0.28,4911,167,434,1136
159647,Louisiana Tech University,0,1,2009,Inf,0,1448,622,826,438,209,229,0.36,0.25,0.3,5091,174,398,948
159647,Louisiana Tech University,0,1,2010,Inf,0,1530,679,851,504,220,284,0.41000000000000003,0.26,0.33,3640,162,374,1116
159717,MCNEESE STATE UNIVERSITY,1,0,1991,NA,NA,1253,652,601,83,23,60,0.09,0.04,0.07,1626,42,314,1058
159717,MCNEESE STATE UNIVERSITY,1,0,1992,NA,NA,1272,705,567,64,16,48,0.06,0.03,0.05,1626,44,292,1062
159717,MCNEESE STATE UNIVERSITY,1,0,1993,NA,NA,1307,702,605,66,13,53,0.07,0.02,0.05,1968,46,290,1024
159717,MCNEESE STATE UNIVERSITY,1,0,1995,NA,NA,1376,775,601,71,22,49,0.06,0.04,0.05,1998,50,287,1067
159717,MCNEESE STATE UNIVERSITY,1,0,1996,NA,NA,1357,750,607,105,24,81,0.1,0.04,0.08,1998,51,286,1046
159717,MCNEESE STATE UNIVERSITY,1,0,1997,NA,NA,1447,779,668,116,27,89,0.11,0.04,0.08,1998,53,275,1118
159717,MCNEESE STATE UNIVERSITY,1,0,1998,NA,NA,1433,802,631,141,35,106,0.13,0.06,0.1,2128,51,281,1088
159717,MCNEESE STATE UNIVERSITY,1,0,1999,NA,NA,1275,636,639,127,34,93,0.14,0.05,0.1,1650,52,280,1016
159717,MCNEESE STATE UNIVERSITY,1,0,2000,NA,NA,1320,767,553,110,31,79,0.1,0.06,0.08,1900,57,277,1035
159717,MCNEESE STATE UNIVERSITY,1,0,2001,NA,NA,1350,745,605,151,56,95,0.12,0.09,0.11,1900,60,274,1077
159717,MCNEESE STATE UNIVERSITY,1,0,2002,NA,NA,1358,762,596,179,67,112,0.14,0.11,0.13,1974,62,282,1024
159717,MCNEESE STATE UNIVERSITY,1,0,2003,NA,NA,1506,843,663,176,51,125,0.14,0.08,0.12,2050,65,293,1076
159717,MCNEESE STATE UNIVERSITY,1,0,2004,NA,NA,1603,923,680,196,61,135,0.14,0.09,0.12,2134,69,300,1186
159717,McNeese State University,1,0,2005,NA,NA,1311,743,568,177,52,125,0.16,0.09,0.14,2226,72,305,982
159717,McNeese State University,1,0,2006,NA,NA,1272,741,531,195,60,135,0.18,0.11,0.15,2226,74,302,996
159717,McNeese State University,1,0,2007,NA,NA,1247,717,530,163,55,108,0.15,0.1,0.13,2226,85,315,920
159717,McNeese State University,1,0,2008,NA,NA,1272,742,530,203,62,141,0.19,0.12,0.16,2386,105,322,943
159717,McNeese State University,1,0,2009,NA,NA,1221,728,493,256,83,173,0.23,0.17,0.21,2556,102,307,927
159717,McNeese State University,1,0,2010,NA,NA,1259,756,503,261,84,177,0.23,0.17,0.21,2916,98,316,943
159966,NICHOLLS STATE UNIVERSITY,1,0,1991,NA,NA,1204,698,506,57,13,44,0.06,0.03,0.05,1591,37,274,996
159966,NICHOLLS STATE UNIVERSITY,1,0,1992,NA,NA,1059,613,446,53,10,43,0.07,0.02,0.05,1661,40,279,854
159966,NICHOLLS STATE UNIVERSITY,1,0,1993,NA,NA,969,586,383,33,12,21,0.03,0.03,0.03,1981,40,286,756
159966,NICHOLLS STATE UNIVERSITY,1,0,1995,NA,NA,1170,672,498,76,19,57,0.08,0.04,0.06,2016,43,280,866
159966,NICHOLLS STATE UNIVERSITY,1,0,1996,NA,NA,1008,603,405,54,13,41,0.06,0.03,0.05,2016,43,275,741
159966,NICHOLLS STATE UNIVERSITY,1,0,1997,NA,NA,1075,646,429,81,14,67,0.1,0.03,0.08,2136,45,274,760
159966,NICHOLLS STATE UNIVERSITY,1,0,1998,NA,NA,1351,781,570,117,22,95,0.12,0.04,0.09,2136,47,272,1009
159966,NICHOLLS STATE UNIVERSITY,1,0,1999,NA,NA,1445,860,585,129,30,99,0.11,0.05,0.09,1645,52,267,1109
159966,NICHOLLS STATE UNIVERSITY,1,0,2000,NA,NA,1460,882,578,118,26,92,0.1,0.04,0.08,1895,52,271,1075
159966,NICHOLLS STATE UNIVERSITY,1,0,2001,NA,NA,1408,841,567,121,28,93,0.11,0.05,0.09,1895,53,275,1007
159966,NICHOLLS STATE UNIVERSITY,1,0,2002,NA,NA,1404,821,583,120,27,93,0.11,0.05,0.09,1967,52,268,1000
159966,NICHOLLS STATE UNIVERSITY,1,0,2003,NA,NA,1391,813,578,121,36,85,0.1,0.06,0.09,2045,55,283,955
159966,NICHOLLS STATE UNIVERSITY,1,0,2004,NA,NA,1574,939,635,146,44,102,0.1,0.07,0.09,2135,63,285,1068
159966,Nicholls State University,1,0,2005,NA,NA,1171,703,468,163,62,101,0.14,0.13,0.14,2231,64,289,893
159966,Nicholls State University,1,0,2006,NA,NA,1069,650,419,170,44,126,0.19,0.11,0.16,2231,66,285,788
159966,Nicholls State University,1,0,2007,NA,NA,1156,696,460,196,59,137,0.19,0.13,0.17,2231,70,288,905
159966,Nicholls State University,1,0,2008,NA,NA,1217,712,505,207,60,147,0.2,0.12,0.17,2411,90,297,861
159966,Nicholls State University,1,0,2009,NA,NA,1212,707,505,200,67,133,0.18,0.13,0.17,2603,95,275,880
159966,Nicholls State University,1,0,2010,NA,NA,1048,652,396,201,63,138,0.21,0.16,0.19,3024,89,256,774
160038,NORTHWESTERN STATE UNIVERSITY OF LOUISIANA,1,0,1991,NA,NA,1179,710,469,110,24,86,0.12,0.05,0.09,1771,39,209,850
160038,NORTHWESTERN STATE UNIVERSITY OF LOUISIANA,1,0,1992,NA,NA,1227,737,490,108,30,78,0.1,0.06,0.09,1771,43,253,878
160038,NORTHWESTERN STATE UNIVERSITY OF LOUISIANA,1,0,1993,NA,NA,1380,824,556,112,28,84,0.1,0.05,0.08,2071,48,248,918
160038,NORTHWESTERN STATE UNIVERSITY OF LOUISIANA,1,0,1995,NA,NA,1556,947,609,165,41,124,0.13,0.07,0.11,2067,54,262,1023
160038,NORTHWESTERN STATE UNIVERSITY OF LOUISIANA,1,0,1996,NA,NA,1480,891,589,22,5,17,0.01,0.01,0.01,2067,56,265,942
160038,NORTHWESTERN STATE UNIVERSITY OF LOUISIANA,1,0,1997,NA,NA,1415,878,537,129,35,94,0.1,0.07,0.09,2057,60,277,857
160038,NORTHWESTERN STATE UNIVERSITY OF LOUISIANA,1,0,1998,NA,NA,1364,857,507,157,43,114,0.13,0.08,0.12,2177,60,257,808
160038,NORTHWESTERN STATE UNIVERSITY OF LOUISIANA,1,0,1999,NA,NA,1656,988,668,184,71,113,0.11,0.11,0.11,2030,62,316,1037
160038,NORTHWESTERN STATE UNIVERSITY OF LOUISIANA,1,0,2000,NA,NA,1555,959,596,194,56,138,0.14,0.09,0.12,2086,66,288,979
160038,NORTHWESTERN STATE UNIVERSITY OF LOUISIANA,1,0,2001,NA,NA,1543,951,592,198,43,155,0.16,0.07,0.13,1970,69,261,948
160038,NORTHWESTERN STATE UNIVERSITY OF LOUISIANA,1,0,2002,NA,NA,1875,1093,782,216,80,136,0.12,0.1,0.12,1976,70,274,993
160038,NORTHWESTERN STATE UNIVERSITY OF LOUISIANA,1,0,2003,NA,NA,1826,1117,709,227,71,156,0.13,0.1,0.12,2054,76,287,961
160038,NORTHWESTERN STATE UNIVERSITY OF LOUISIANA,1,0,2004,NA,NA,1793,1084,709,187,55,132,0.12,0.08,0.1,2144,83,311,902
160038,Northwestern State University of Louisiana,1,0,2005,NA,NA,1417,869,548,218,71,147,0.16,0.13,0.15,2240,86,309,791
160038,Northwestern State University of Louisiana,1,0,2006,NA,NA,1324,854,470,214,62,152,0.17,0.13,0.16,2240,84,304,777
160038,Northwestern State University of Louisiana,1,0,2007,NA,NA,1281,812,469,223,69,154,0.18,0.15,0.17,2240,90,321,769
160038,Northwestern State University of Louisiana,1,0,2008,NA,NA,1183,736,447,225,69,156,0.21,0.15,0.19,2412,112,341,664
160038,Northwestern State University of Louisiana,1,0,2009,NA,NA,1235,781,454,231,64,167,0.21,0.14,0.19,2594,114,320,677
160038,Northwestern State University of Louisiana,1,0,2010,NA,NA,1056,678,378,213,60,153,0.22,0.16,0.2,3002,106,275,583
160612,SOUTHEASTERN LOUISIANA UNIVERSITY,1,0,1991,NA,NA,1898,1075,823,53,9,44,0.04,0.01,0.03,1607,50,341,1739
160612,SOUTHEASTERN LOUISIANA UNIVERSITY,1,0,1992,NA,NA,2199,1285,914,86,21,65,0.05,0.02,0.04,1610,55,372,1960
160612,SOUTHEASTERN LOUISIANA UNIVERSITY,1,0,1993,NA,NA,2192,1222,970,77,19,58,0.04,0.02,0.04,1760,64,389,1950
160612,SOUTHEASTERN LOUISIANA UNIVERSITY,1,0,1995,NA,NA,2367,1387,980,94,21,73,0.05,0.02,0.04,2050,75,432,2037
160612,SOUTHEASTERN LOUISIANA UNIVERSITY,1,0,1996,NA,NA,2337,1273,1064,107,33,74,0.05,0.03,0.05,2050,78,438,2014
160612,SOUTHEASTERN LOUISIANA UNIVERSITY,1,0,1997,NA,NA,2487,1371,1116,107,24,83,0.06,0.02,0.04,2050,84,437,2090
160612,SOUTHEASTERN LOUISIANA UNIVERSITY,1,0,1998,NA,NA,2588,1471,1117,156,50,106,0.07,0.04,0.06,2150,90,456,2148
160612,SOUTHEASTERN LOUISIANA UNIVERSITY,1,0,1999,NA,NA,2315,1361,954,170,44,126,0.09,0.05,0.07,2210,92,450,1910
160612,SOUTHEASTERN LOUISIANA UNIVERSITY,1,0,2000,NA,NA,2220,1351,869,176,59,117,0.08,0.07,0.08,2490,100,466,1839
160612,SOUTHEASTERN LOUISIANA UNIVERSITY,1,0,2001,NA,NA,2007,1209,798,199,51,148,0.12,0.06,0.1,2607,104,483,1657
160612,SOUTHEASTERN LOUISIANA UNIVERSITY,1,0,2002,NA,NA,2382,1370,1012,168,49,119,0.08,0.05,0.07,2618,109,479,1879
160612,SOUTHEASTERN LOUISIANA UNIVERSITY,1,0,2003,NA,NA,2539,1451,1088,221,72,149,0.1,0.07,0.09,2951,123,488,1933
160612,SOUTHEASTERN LOUISIANA UNIVERSITY,1,0,2004,NA,NA,2137,1250,887,210,68,142,0.11,0.08,0.1,3191,147,487,1700
160612,Southeastern Louisiana University,1,0,2005,NA,NA,2228,1388,840,252,74,178,0.12,0.09,0.11,3341,140,503,1689
160612,Southeastern Louisiana University,1,0,2006,NA,NA,2665,1604,1061,320,93,227,0.14,0.09,0.12,2216,143,508,1968
160612,Southeastern Louisiana University,1,0,2007,NA,NA,2524,1458,1066,336,102,234,0.16,0.1,0.13,2216,149,528,1895
160612,Southeastern Louisiana University,1,0,2008,NA,NA,2613,1538,1075,358,112,246,0.15,0.1,0.14,2376,186,540,1915
160612,Southeastern Louisiana University,1,0,2009,NA,NA,2508,1497,1011,359,118,241,0.16,0.12,0.14,2546,189,541,1851
160612,Southeastern Louisiana University,1,0,2010,NA,NA,2414,1408,1006,408,133,275,0.19,0.13,0.17,2993,175,477,1853
160621,SOUTHERN UNIVERSITY AND A & M COL AT BATON ROUGE,1,0,1991,NA,NA,1907,985,922,59,10,49,0.04,0.01,0.03,1580,79,471,23
160621,SOUTHERN UNIVERSITY AND A & M COL AT BATON ROUGE,1,0,1992,NA,NA,2033,1066,967,91,20,71,0.06,0.02,0.04,1588,85,433,30
160621,SOUTHERN UNIVERSITY AND A & M COLLEGE-BATON ROUGE,1,0,1993,NA,NA,1658,862,796,80,16,64,0.07,0.02,0.05,2028,89,446,56
160621,SOUTHERN UNIVERSITY AND A & M COLLEGE,1,0,1995,NA,NA,1846,991,855,101,21,80,0.08,0.02,0.05,2028,100,434,9
160621,SOUTHERN UNIVERSITY AND A & M COLLEGE,1,0,1996,NA,NA,1910,1041,869,129,24,105,0.1,0.03,0.07,2028,105,469,10
160621,SOUTHERN UNIVERSITY AND A & M COLLEGE,1,0,1997,NA,NA,1853,997,856,106,28,78,0.07,0.03,0.06,2068,109,451,12
160621,SOUTHERN UNIVERSITY AND A & M COLLEGE,1,0,1998,NA,NA,1715,911,804,110,25,85,0.09,0.03,0.06,2208,114,460,6
160621,SOUTHERN UNIVERSITY AND A & M COLLEGE,1,0,1999,NA,NA,1287,693,594,86,19,67,0.09,0.03,0.07,2286,115,465,4
160621,SOUTHERN UNIVERSITY AND A & M COLLEGE,1,0,2000,NA,NA,1766,996,770,2,2,0,0,0,0,2286,119,439,7
160621,SOUTHERN UNIVERSITY AND A & M COLLEGE,1,0,2001,NA,NA,1206,690,516,75,14,61,0.08,0.03,0.06,2682,121,413,9
160621,SOUTHERN UNIVERSITY AND A & M COLLEGE,1,0,2002,NA,NA,1176,673,503,77,14,63,0.09,0.03,0.07,2702,124,425,7
160621,SOUTHERN UNIVERSITY AND A & M COLLEGE,1,0,2003,NA,NA,1351,782,569,77,16,61,0.07,0.03,0.06,3066,136,436,11
160621,SOUTHERN UNIVERSITY AND A & M COLLEGE,1,0,2004,NA,NA,1575,931,644,115,30,85,0.09,0.05,0.07,3440,143,420,6
160621,Southern University and A & M College,1,0,2005,NA,NA,1434,797,637,290,93,197,0.24,0.15,0.2,3592,156,404,6
160621,Southern University and A & M College,1,0,2006,NA,NA,1136,659,477,132,33,99,0.15,0.07,0.12,3602,153,446,2
160621,Southern University and A & M College,1,0,2007,NA,NA,1178,658,520,95,18,77,0.11,0.03,0.08,3666,161,437,7
160621,Southern University and A & M College,1,0,2008,NA,NA,1034,605,429,62,19,43,0.07,0.04,0.06,3906,185,434,10
160621,Southern University and A & M College,1,0,2009,NA,NA,992,539,453,96,31,65,0.12,0.07,0.1,4100,184,373,18
160621,Southern University and A & M College,1,0,2010,NA,NA,852,488,364,60,18,42,0.08,0.05,0.07,4584,159,379,15
160658,UNIVERSITY OF SOUTHWESTERN LOUISIANA,1,0,1991,NA,NA,2383,1300,1083,88,26,62,0.04,0.02,0.04,1568,98,576,1705
160658,UNIVERSITY OF SOUTHWESTERN LOUISIANA,1,0,1992,NA,NA,2563,1396,1167,77,25,52,0.03,0.02,0.03,1597,106,582,1797
160658,UNIVERSITY OF SOUTHWESTERN LOUISIANA,1,0,1993,NA,NA,2524,1378,1146,110,32,78,0.05,0.03,0.04,1897,114,531,1787
160658,UNIVERSITY OF SOUTHWESTERN LOUISIANA,1,0,1995,NA,NA,2609,1453,1156,110,24,86,0.05,0.02,0.04,1897,119,563,1799
160658,UNIVERSITY OF SOUTHWESTERN LOUISIANA,1,0,1996,NA,NA,2674,1461,1213,161,41,120,0.08,0.03,0.06,1885,122,553,1801
160658,UNIVERSITY OF SOUTHWESTERN LOUISIANA,1,0,1997,NA,NA,2764,1543,1221,169,44,125,0.08,0.04,0.06,1885,126,545,1796
160658,UNIVERSITY OF SOUTHWESTERN LOUISIANA,1,0,1998,NA,NA,2931,1621,1310,249,69,180,0.11,0.05,0.08,2010,134,536,1962
160658,UNIVERSITY OF LOUISIANA AT LAFAYETTE,1,0,1999,NA,NA,2402,1300,1102,298,94,204,0.15,0.09,0.12,2013,139,525,1777
160658,UNIVERSITY OF LOUISIANA AT LAFAYETTE,1,0,2000,NA,NA,2291,1302,989,314,103,211,0.16,0.1,0.14,2277,147,527,1742
160658,UNIVERSITY OF LOUISIANA AT LAFAYETTE,1,0,2001,NA,NA,2301,1306,995,322,93,229,0.17,0.09,0.14,2314,143,530,1775
160658,UNIVERSITY OF LOUISIANA AT LAFAYETTE,1,0,2002,NA,NA,2385,1326,1059,293,77,216,0.16,0.07,0.12,2386,145,532,1817
160658,UNIVERSITY OF LOUISIANA AT LAFAYETTE,1,0,2003,NA,NA,2576,1437,1139,333,86,247,0.17,0.08,0.13,2700,152,536,1976
160658,UNIVERSITY OF LOUISIANA AT LAFAYETTE,1,0,2004,NA,NA,2643,1517,1126,345,101,244,0.16,0.09,0.13,3228,158,534,1974
160658,University of Louisiana at Lafayette,1,0,2005,NA,NA,2730,1538,1192,329,102,227,0.14,0.09,0.12,3324,166,531,2027
160658,University of Louisiana at Lafayette,1,0,2006,NA,NA,2799,1604,1195,362,108,254,0.15,0.09,0.13,3382,173,530,2053
160658,University of Louisiana at Lafayette,1,0,2007,NA,NA,2691,1554,1137,361,111,250,0.16,0.1,0.13,3402,184,576,2026
160658,University of Louisiana at Lafayette,1,0,2008,NA,NA,2566,1435,1131,373,128,245,0.17,0.11,0.15,3574,235,591,1927
160658,University of Louisiana at Lafayette,1,0,2009,NA,NA,2553,1427,1126,373,126,247,0.17,0.11,0.15,4016,238,600,1818
160658,University of Louisiana-Lafayette,1,0,2010,NA,NA,2914,1629,1285,465,141,324,0.19,0.11,0.16,4426,239,596,1997
161004,BOWDOIN COLLEGE,1,0,1991,NA,NA,398,185,213,341,182,159,0.85,0.85,0.86,16070,49,123,335
161004,BOWDOIN COLLEGE,1,0,1992,NA,NA,409,224,185,347,154,193,0.86,0.83,0.85,17035,45,122,350
161004,BOWDOIN COLLEGE,1,0,1993,NA,NA,418,218,200,356,163,193,0.88,0.81,0.85,18300,48,123,347
161004,BOWDOIN COLLEGE,1,0,1995,NA,NA,446,225,221,369,180,189,0.84,0.81,0.83,20555,55,131,328
161004,BOWDOIN COLLEGE,1,0,1996,NA,NA,443,223,220,369,175,194,0.87,0.8,0.83,21750,59,131,374
161004,BOWDOIN COLLEGE,1,0,1997,NA,NA,473,246,227,384,175,209,0.84,0.77,0.81,22460,55,137,314
161004,BOWDOIN COLLEGE,1,0,1998,NA,NA,433,213,220,361,181,180,0.84,0.82,0.83,23895,60,140,352
161004,BOWDOIN COLLEGE,1,0,1999,NA,NA,464,259,205,418,183,235,0.9,0.89,0.9,24435,67,146,389
161004,BOWDOIN COLLEGE,1,0,2000,NA,NA,452,221,231,379,188,191,0.86,0.81,0.84,25345,74,148,347
161004,BOWDOIN COLLEGE,1,0,2001,NA,NA,452,228,224,374,191,183,0.8,0.85,0.83,26700,84,151,344
161004,BOWDOIN COLLEGE,1,0,2002,NA,NA,457,237,220,384,196,188,0.79,0.89,0.84,28070,89,165,321
161004,BOWDOIN COLLEGE,1,0,2003,NA,NA,464,236,228,412,202,210,0.88,0.89,0.89,29470,89,168,333
161004,BOWDOIN COLLEGE,1,0,2004,NA,NA,470,235,235,421,212,209,0.88,0.9,0.9,30944,91,152,312
161004,Bowdoin College,1,0,2005,NA,NA,477,257,220,420,189,231,0.89,0.86,0.88,32650,96,177,327
161004,Bowdoin College,1,0,2006,NA,NA,474,253,221,430,193,237,0.93,0.87,0.91,34280,103,172,334
161004,Bowdoin College,1,0,2007,NA,NA,475,250,225,416,196,220,0.88,0.87,0.88,35990,109,185,314
161004,Bowdoin College,1,0,2008,NA,NA,488,232,256,420,203,217,0.93,0.79,0.86,37790,117,199,312
161004,Bowdoin College,1,0,2009,NA,NA,493,253,240,422,200,222,0.87,0.83,0.86,39605,121,198,320
161004,Bowdoin College,1,0,2010,NA,NA,507,249,258,453,230,223,0.89,0.89,0.89,41150,122,204,320
161226,UNIVERSITY OF MAINE AT FARMINGTON,1,0,1991,NA,NA,457,337,120,157,30,127,0.37,0.25,0.34,2340,21,95,444
161226,UNIVERSITY OF MAINE AT FARMINGTON,1,0,1992,NA,NA,441,302,139,126,31,95,0.31,0.22,0.29,2670,22,105,423
161226,UNIVERSITY OF MAINE AT FARMINGTON,1,0,1993,NA,NA,419,317,102,169,24,145,0.45,0.24,0.4,2910,22,101,408
161226,UNIVERSITY OF MAINE AT FARMINGTON,1,0,1995,NA,NA,473,335,138,153,35,118,0.35000000000000003,0.25,0.32,3220,23,105,451
161226,UNIVERSITY OF MAINE AT FARMINGTON,1,0,1996,NA,NA,477,332,145,147,32,115,0.34,0.22,0.31,3370,24,99,435
161226,UNIVERSITY OF MAINE AT FARMINGTON,1,0,1997,NA,NA,466,308,158,148,28,120,0.38,0.18,0.32,3520,26,96,440
161226,UNIVERSITY OF MAINE AT FARMINGTON,1,0,1998,NA,NA,484,333,151,155,41,114,0.34,0.27,0.32,3686,26,98,435
161226,UNIVERSITY OF MAINE AT FARMINGTON,1,0,1999,NA,NA,470,344,126,197,48,149,0.43,0.38,0.42,3390,28,103,368
161226,UNIVERSITY OF MAINE AT FARMINGTON,1,0,2000,NA,NA,475,329,146,176,40,136,0.41000000000000003,0.27,0.37,3540,30,107,412
161226,UNIVERSITY OF MAINE AT FARMINGTON,1,0,2001,NA,NA,479,323,156,174,45,129,0.39,0.29,0.36,3735,32,111,423
161226,UNIVERSITY OF MAINE AT FARMINGTON,1,0,2002,NA,NA,453,295,158,156,40,116,0.39,0.25,0.34,3990,31,111,437
161226,UNIVERSITY OF MAINE AT FARMINGTON,1,0,2003,NA,NA,482,339,143,221,59,162,0.47000000000000003,0.41,0.46,4290,32,102,454
161226,UNIVERSITY OF MAINE AT FARMINGTON,1,0,2004,NA,NA,510,342,168,196,46,150,0.43,0.27,0.38,4650,34,102,494
161226,University of Maine at Farmington,1,0,2005,NA,NA,559,387,172,229,60,169,0.43,0.35,0.41,5010,35,102,334
161226,University of Maine at Farmington,1,0,2006,NA,NA,511,351,160,209,49,160,0.45,0.31,0.41,5824,37,130,454
161226,University of Maine at Farmington,1,0,2007,NA,NA,479,327,152,181,45,136,0.41000000000000003,0.3,0.38,6528,39,129,432
161226,University of Maine at Farmington,1,0,2008,NA,NA,512,335,177,184,47,137,0.4,0.27,0.36,7296,41,123,431
161226,University of Maine at Farmington,1,0,2009,NA,NA,487,312,175,210,64,146,0.46,0.37,0.43,7712,43,120,427
161226,University of Maine at Farmington,1,0,2010,NA,NA,555,352,203,242,68,174,0.49,0.33,0.44,8032,43,120,488
161235,UNIVERSITY OF MAINE AT FORT KENT,1,0,1991,NA,NA,86,53,33,11,3,8,0.15,0.09,0.13,2250,5,28,65
161235,UNIVERSITY OF MAINE AT FORT KENT,1,0,1992,NA,NA,97,43,54,8,3,5,0.11,0.06,0.08,2580,5,31,95
161235,UNIVERSITY OF MAINE AT FORT KENT,1,0,1993,NA,NA,81,46,35,6,0,6,0.13,0,0.07,2760,5,33,81
161235,UNIVERSITY OF MAINE AT FORT KENT,1,0,1995,NA,NA,74,34,40,6,2,4,0.11,0.05,0.08,2930,6,33,72
161235,UNIVERSITY OF MAINE AT FORT KENT,1,0,1996,NA,NA,84,49,35,9,1,8,0.16,0.03,0.11,2990,5,30,82
161235,UNIVERSITY OF MAINE AT FORT KENT,1,0,1997,NA,NA,77,47,30,5,0,5,0.1,0,0.06,3140,6,33,77
161235,UNIVERSITY OF MAINE AT FORT KENT,1,0,1998,NA,NA,93,40,53,9,1,8,0.2,0.02,0.1,3284,6,30,24
161235,UNIVERSITY OF MAINE AT FORT KENT,1,0,1999,NA,NA,109,64,45,17,3,14,0.21,0.07,0.16,3090,7,30,19
161235,UNIVERSITY OF MAINE AT FORT KENT,1,0,2000,NA,NA,82,38,44,4,1,3,0.07,0.02,0.05,3150,8,32,80
161235,UNIVERSITY OF MAINE AT FORT KENT,1,0,2001,NA,NA,99,49,50,24,8,16,0.32,0.16,0.24,3270,9,34,89
161235,UNIVERSITY OF MAINE AT FORT KENT,1,0,2002,NA,NA,130,61,69,30,15,15,0.24,0.22,0.23,3420,10,35,119
161235,UNIVERSITY OF MAINE AT FORT KENT,1,0,2003,NA,NA,126,62,64,19,4,15,0.24,0.06,0.15,3690,11,30,112
161235,UNIVERSITY OF MAINE AT FORT KENT,1,0,2004,NA,NA,166,85,81,17,2,15,0.17,0.02,0.1,3960,10,33,157
161235,University of Maine at Fort Kent,1,0,2005,NA,NA,129,69,60,22,9,13,0.18,0.15,0.17,4290,11,36,121
161235,University of Maine at Fort Kent,1,0,2006,NA,NA,116,67,49,2,1,1,0.01,0.02,0.02,4650,12,41,106
161235,University of Maine at Fort Kent,1,0,2007,NA,NA,110,60,50,36,18,18,0.3,0.36,0.33,5100,13,41,89
161235,University of Maine at Fort Kent,1,0,2008,NA,NA,111,60,51,27,14,13,0.21,0.27,0.24,5700,14,38,91
161235,University of Maine at Fort Kent,1,0,2009,NA,NA,118,69,49,20,5,15,0.21,0.1,0.17,6030,14,36,101
161235,University of Maine at Fort Kent,1,0,2010,NA,NA,153,94,59,27,6,21,0.22,0.1,0.18,6330,14,35,139
161244,UNIVERSITY OF MAINE AT MACHIAS,1,0,1991,NA,NA,146,91,55,11,4,7,0.07,0.07,0.08,2275,7,41,139
161244,UNIVERSITY OF MAINE AT MACHIAS,1,0,1992,NA,NA,139,98,41,12,3,9,0.09,0.07,0.09,2605,7,42,119
161244,UNIVERSITY OF MAINE AT MACHIAS,1,0,1993,NA,NA,133,84,49,10,6,4,0.04,0.12,0.08,2785,8,39,115
161244,UNIVERSITY OF MAINE AT MACHIAS,1,0,1995,NA,NA,129,73,56,10,5,5,0.06,0.09,0.08,2935,8,36,121
161244,UNIVERSITY OF MAINE AT MACHIAS,1,0,1996,NA,NA,143,86,57,9,3,6,0.06,0.05,0.06,3035,8,37,123
161244,UNIVERSITY OF MAINE AT MACHIAS,1,0,1997,NA,NA,121,63,58,9,3,6,0.09,0.05,0.07,3225,9,41,107
161244,UNIVERSITY OF MAINE AT MACHIAS,1,0,1998,NA,NA,148,95,53,8,2,6,0.06,0.04,0.05,3345,10,38,135
161244,UNIVERSITY OF MAINE AT MACHIAS,1,0,1999,NA,NA,121,83,38,15,4,11,0.13,0.11,0.12,3090,10,33,112
161244,UNIVERSITY OF MAINE AT MACHIAS,1,0,2000,NA,NA,127,85,42,13,4,9,0.1,0.1,0.1,3150,9,34,116
161244,UNIVERSITY OF MAINE AT MACHIAS,1,0,2001,NA,NA,155,105,50,32,6,26,0.24,0.12,0.21,3270,10,36,130
161244,UNIVERSITY OF MAINE AT MACHIAS,1,0,2002,NA,NA,132,81,51,19,9,10,0.12,0.18,0.14,3420,10,35,124
161244,UNIVERSITY OF MAINE AT MACHIAS,1,0,2003,NA,NA,142,92,50,17,1,16,0.17,0.02,0.12,3636,10,30,120
161244,UNIVERSITY OF MAINE AT MACHIAS,1,0,2004,NA,NA,80,54,26,14,3,11,0.2,0.12,0.17,3960,11,29,71
161244,University of Maine at Machias,1,0,2005,NA,NA,106,71,35,17,5,12,0.16,0.14,0.16,4290,10,30,92
161244,University of Maine at Machias,1,0,2006,NA,NA,99,59,40,10,6,4,0.06,0.15,0.1,4650,11,30,96
161244,University of Maine at Machias,1,0,2007,NA,NA,110,72,38,15,6,9,0.12,0.16,0.14,5100,11,33,100
161244,University of Maine at Machias,1,0,2008,NA,NA,105,62,43,23,8,15,0.24,0.19,0.22,5700,12,33,91
161244,University of Maine at Machias,1,0,2009,NA,NA,101,67,34,16,4,12,0.17,0.12,0.16,6030,12,31,83
161244,University of Maine at Machias,1,0,2010,NA,NA,105,61,44,18,6,12,0.19,0.14,0.17,6330,12,31,83
161253,UNIVERSITY OF MAINE AT ORONO,1,0,1991,NA,NA,1589,710,879,324,140,184,0.25,0.16,0.2,2718,169,468,1513
161253,UNIVERSITY OF MAINE,1,0,1992,NA,NA,1413,630,783,293,128,165,0.26,0.16,0.21,3086,169,446,1317
161253,UNIVERSITY OF MAINE,1,0,1993,NA,NA,1211,522,689,320,131,189,0.36,0.19,0.26,3406,171,452,1144
161253,UNIVERSITY OF MAINE,1,0,1995,NA,NA,1118,526,592,322,148,174,0.33,0.25,0.29,3925,181,397,1054
161253,UNIVERSITY OF MAINE,1,0,1996,NA,NA,1264,549,715,340,156,184,0.33,0.22,0.27,4139,180,380,1186
161253,UNIVERSITY OF MAINE,1,0,1997,NA,NA,1091,513,578,327,144,183,0.35000000000000003,0.25,0.3,4339,185,370,1008
161253,UNIVERSITY OF MAINE,1,0,1998,NA,NA,1342,671,671,418,165,253,0.37,0.25,0.31,4551,186,347,1248
161253,UNIVERSITY OF MAINE,1,0,1999,NA,NA,1521,718,803,430,176,254,0.35000000000000003,0.22,0.28,3960,203,361,1411
161253,UNIVERSITY OF MAINE,1,0,2000,NA,NA,1589,781,808,536,222,314,0.4,0.27,0.34,4050,221,376,1507
161253,UNIVERSITY OF MAINE,1,0,2001,NA,NA,1545,737,808,495,214,281,0.38,0.26,0.32,5116,236,392,1436
161253,UNIVERSITY OF MAINE,1,0,2002,NA,NA,1651,808,843,554,246,308,0.38,0.29,0.34,4380,247,393,1552
161253,UNIVERSITY OF MAINE,1,0,2003,NA,NA,1599,812,787,538,235,303,0.37,0.3,0.34,4710,260,380,1399
161253,UNIVERSITY OF MAINE,1,0,2004,NA,NA,1607,777,830,550,236,314,0.4,0.28,0.34,5040,271,369,1414
161253,University of Maine,1,0,2005,NA,NA,1703,842,861,615,262,353,0.41000000000000003,0.3,0.36,5520,280,372,1513
161253,University of Maine,1,0,2006,NA,NA,1807,875,932,648,296,352,0.4,0.32,0.36,5970,289,398,1692
161253,University of Maine,1,0,2007,NA,NA,1816,863,953,648,301,347,0.4,0.32,0.36,6540,293,632,1583
161253,University of Maine,1,0,2008,NA,NA,1931,947,984,717,320,397,0.41000000000000003,0.33,0.37,7170,316,635,1634
161253,University of Maine,1,0,2009,NA,NA,1654,756,898,550,288,262,0.34,0.32,0.33,7590,326,602,1399
161253,University of Maine,1,0,2010,NA,NA,1713,828,885,622,283,339,0.4,0.32,0.36,8010,326,589,1447
161554,UNIVERSITY OF SOUTHERN MAINE,1,0,1991,NA,NA,763,419,344,68,23,45,0.1,0.07,0.09,2454,73,306,737
161554,UNIVERSITY OF SOUTHERN MAINE,1,0,1992,NA,NA,682,365,317,51,17,34,0.09,0.05,0.07,2814,77,298,659
161554,UNIVERSITY OF SOUTHERN MAINE,1,0,1993,NA,NA,732,390,342,48,18,30,0.07,0.05,0.07,3054,79,291,699
161554,UNIVERSITY OF SOUTHERN MAINE,1,0,1995,NA,NA,620,358,262,66,23,43,0.12,0.09,0.11,3500,88,305,606
161554,UNIVERSITY OF SOUTHERN MAINE,1,0,1996,NA,NA,683,383,300,56,17,39,0.1,0.06,0.08,3710,94,315,664
161554,UNIVERSITY OF SOUTHERN MAINE,1,0,1997,NA,NA,760,450,310,90,31,59,0.13,0.1,0.12,3938,98,313,732
161554,UNIVERSITY OF SOUTHERN MAINE,1,0,1998,NA,NA,789,463,326,66,18,48,0.1,0.06,0.08,4102,103,307,765
161554,UNIVERSITY OF SOUTHERN MAINE,1,0,1999,NA,NA,815,477,338,96,24,72,0.15,0.07,0.12,3630,111,293,777
161554,UNIVERSITY OF SOUTHERN MAINE,1,0,2000,NA,NA,855,489,366,81,21,60,0.12,0.06,0.09,3720,118,324,825
161554,UNIVERSITY OF SOUTHERN MAINE,1,0,2001,NA,NA,922,538,384,93,26,67,0.12,0.07,0.1,3855,130,356,897
161554,UNIVERSITY OF SOUTHERN MAINE,1,0,2002,NA,NA,895,519,376,118,39,79,0.15,0.1,0.13,4020,136,352,863
161554,UNIVERSITY OF SOUTHERN MAINE,1,0,2003,NA,NA,851,496,355,106,24,82,0.16,0.07,0.12,4320,151,339,816
161554,UNIVERSITY OF SOUTHERN MAINE,1,0,2004,NA,NA,871,524,347,146,39,107,0.2,0.11,0.17,4620,161,334,793
161554,University of Southern Maine,1,0,2005,NA,NA,911,518,393,88,31,57,0.11,0.08,0.1,4980,162,344,622
161554,University of Southern Maine,1,0,2006,NA,NA,888,511,377,84,25,59,0.11,0.07,0.09,5400,170,385,830
161554,University of Southern Maine,1,0,2007,NA,NA,900,499,401,87,32,55,0.11,0.08,0.1,5940,181,384,738
161554,University of Southern Maine,1,0,2008,NA,NA,991,531,460,126,53,73,0.13,0.12,0.13,6540,185,372,811
161554,University of Southern Maine,1,0,2009,NA,NA,825,447,378,107,27,80,0.17,0.07,0.13,6930,183,345,685
161554,University of Southern Maine,1,0,2010,NA,NA,763,394,369,104,43,61,0.15,0.12,0.14,7260,181,355,632
162007,BOWIE STATE UNIVERSITY,1,0,1991,NA,NA,310,189,121,37,7,30,0.15,0.06,0.12,2254,31,117,20
162007,BOWIE STATE UNIVERSITY,1,0,1992,NA,NA,329,199,130,35,6,29,0.14,0.05,0.11,2514,31,126,15
162007,BOWIE STATE UNIVERSITY,1,0,1993,NA,NA,257,152,105,30,9,21,0.13,0.09,0.12,2736,32,127,6
162007,BOWIE STATE UNIVERSITY,1,0,1995,NA,NA,435,260,175,62,11,51,0.19,0.06,0.14,3019,37,146,22
162007,BOWIE STATE UNIVERSITY,1,0,1996,NA,NA,301,169,132,41,9,32,0.18,0.07,0.14,3103,40,139,21
162007,BOWIE STATE UNIVERSITY,1,0,1997,NA,NA,357,190,167,44,8,36,0.18,0.05,0.12,3357,40,137,18
162007,BOWIE STATE UNIVERSITY,1,0,1998,NA,NA,418,225,193,49,7,42,0.18,0.04,0.12,3467,43,159,23
162007,BOWIE STATE UNIVERSITY,1,0,1999,NA,NA,343,189,154,45,12,33,0.17,0.08,0.13,2828,45,155,23
162007,BOWIE STATE UNIVERSITY,1,0,2000,NA,NA,361,195,166,47,13,34,0.17,0.08,0.13,2940,49,152,10
162007,BOWIE STATE UNIVERSITY,1,0,2001,NA,NA,594,356,238,89,21,68,0.19,0.09,0.15,2941,54,149,12
162007,BOWIE STATE UNIVERSITY,1,0,2002,NA,NA,566,352,214,102,24,78,0.22,0.11,0.18,3102,53,145,15
162007,BOWIE STATE UNIVERSITY,1,0,2003,NA,NA,762,479,283,98,18,80,0.16,0.06,0.13,3551,64,164,18
162007,BOWIE STATE UNIVERSITY,1,0,2004,NA,NA,627,408,219,94,16,78,0.19,0.07,0.15,4047,66,191,18
162007,Bowie State University,1,0,2005,NA,NA,923,567,356,203,53,150,0.26,0.15,0.22,4286,65,192,21
162007,Bowie State University,1,0,2006,NA,NA,765,475,290,83,20,63,0.13,0.07,0.11,4286,69,206,6
162007,Bowie State University,1,0,2007,NA,NA,820,506,314,106,19,87,0.17,0.06,0.13,4286,72,215,10
162007,Bowie State University,1,0,2008,NA,NA,664,393,271,52,12,40,0.1,0.04,0.08,4286,77,219,11
162007,Bowie State University,1,0,2009,NA,NA,635,401,234,71,18,53,0.13,0.08,0.11,4286,80,230,8
162007,Bowie State University,1,0,2010,NA,NA,608,353,255,73,17,56,0.15,0.07,0.12,4415,83,229,9
162210,COLUMBIA UNION COLLEGE,1,0,1991,NA,NA,78,45,33,19,6,13,0.28,0.18,0.24,8200,13,50,39
162210,COLUMBIA UNION COLLEGE,1,0,1992,NA,NA,69,46,23,12,1,11,0.23,0.04,0.17,9180,14,45,24
162210,COLUMBIA UNION COLLEGE,1,0,1993,NA,NA,94,52,42,17,7,10,0.19,0.17,0.18,9500,13,42,27
162210,COLUMBIA UNION COLLEGE,1,0,1995,NA,NA,137,84,53,24,9,15,0.17,0.17,0.18,10775,13,57,82
162210,COLUMBIA UNION COLLEGE,1,0,1996,NA,NA,154,79,75,20,6,14,0.17,0.08,0.13,11240,15,50,52
162210,COLUMBIA UNION COLLEGE,1,0,1997,NA,NA,164,99,65,34,11,23,0.23,0.17,0.21,11790,16,45,67
162210,COLUMBIA UNION COLLEGE,1,0,1998,NA,NA,140,67,73,17,7,10,0.14,0.1,0.12,12275,16,51,64
162210,COLUMBIA UNION COLLEGE,1,0,1999,NA,NA,175,115,60,25,6,19,0.16,0.1,0.14,12200,18,43,63
162210,COLUMBIA UNION COLLEGE,1,0,2000,NA,NA,158,89,69,22,4,18,0.2,0.06,0.14,12810,18,46,41
162210,COLUMBIA UNION COLLEGE,1,0,2001,NA,NA,153,95,58,26,3,23,0.24,0.05,0.17,13450,23,49,52
162210,COLUMBIA UNION COLLEGE,1,0,2002,NA,NA,176,104,72,17,2,15,0.14,0.03,0.1,13998,24,55,36
162210,COLUMBIA UNION COLLEGE,1,0,2003,NA,NA,187,120,67,24,6,18,0.15,0.09,0.13,14698,27,54,30
162210,COLUMBIA UNION COLLEGE,1,0,2004,NA,NA,208,130,78,26,4,22,0.16,0.05,0.12,15433,29,52,37
162210,Columbia Union College,1,0,2005,NA,NA,172,113,59,23,9,14,0.12,0.15,0.13,16514,29,54,23
162210,Columbia Union College,1,0,2006,NA,NA,144,84,60,18,5,13,0.15,0.08,0.12,17339,23,50,23
162210,Columbia Union College,1,0,2007,NA,NA,126,83,43,22,5,17,0.2,0.12,0.17,18200,22,51,17
162210,Columbia Union College,1,0,2008,NA,NA,98,61,37,16,4,12,0.19,0.11,0.16,18200,23,48,9
162210,Washington Adventist University,1,0,2009,NA,NA,144,83,61,21,7,14,0.16,0.11,0.15,18200,23,44,16
162210,Washington Adventist University,1,0,2010,NA,NA,123,83,40,21,2,19,0.22,0.05,0.17,18900,25,48,19
162283,COPPIN STATE COLLEGE,1,0,1991,NA,NA,311,195,116,29,6,23,0.11,0.05,0.09,2281,23,105,19
162283,COPPIN STATE COLLEGE,1,0,1992,NA,NA,350,183,167,14,1,13,0.07,0.01,0.04,2533,22,101,12
162283,COPPIN STATE COLLEGE,1,0,1993,NA,NA,500,264,236,26,6,20,0.07,0.03,0.05,2605,25,104,33
162283,COPPIN STATE COLLEGE,1,0,1995,NA,NA,439,303,136,31,8,23,0.07,0.06,0.07,2749,28,106,1
162283,COPPIN STATE COLLEGE,1,0,1996,NA,NA,513,357,156,33,11,22,0.06,0.07,0.06,2867,29,110,8
162283,COPPIN STATE COLLEGE,1,0,1997,NA,NA,382,268,114,17,3,14,0.05,0.03,0.04,3012,33,110,7
162283,COPPIN STATE COLLEGE,1,0,1998,NA,NA,457,337,120,32,10,22,0.06,0.08,0.07,3164,34,114,7
162283,COPPIN STATE COLLEGE,1,0,1999,NA,NA,441,306,135,39,12,27,0.08,0.09,0.09,3261,36,113,2
162283,COPPIN STATE COLLEGE,1,0,2000,NA,NA,417,289,128,20,4,16,0.05,0.03,0.05,2503,38,110,1
162283,COPPIN STATE COLLEGE,1,0,2001,NA,NA,540,384,156,36,4,32,0.08,0.03,0.07,2856,42,107,4
162283,COPPIN STATE COLLEGE,1,0,2002,NA,NA,578,430,148,30,3,27,0.06,0.02,0.05,2877,48,115,1
162283,COPPIN STATE COLLEGE,1,0,2003,NA,NA,571,432,139,29,9,20,0.04,0.06,0.05,3142,47,125,4
162283,COPPIN STATE UNIVERSITY,1,0,2004,NA,NA,588,446,142,27,5,22,0.04,0.04,0.05,3330,47,130,2
162283,Coppin State University,1,0,2005,NA,NA,661,502,159,24,4,20,0.03,0.03,0.04,4530,58,131,0
162283,Coppin State University,1,0,2006,NA,NA,494,390,104,28,3,25,0.06,0.03,0.06,3527,54,133,2
162283,Coppin State University,1,0,2007,NA,NA,555,421,134,23,9,14,0.03,0.07,0.04,3527,68,143,0
162283,Coppin State University,1,0,2008,NA,NA,570,428,142,28,6,22,0.05,0.04,0.05,3527,64,162,0
162283,Coppin State University,1,0,2009,NA,NA,541,392,149,29,2,27,0.06,0.01,0.05,3527,73,158,1
162283,Coppin State University,1,0,2010,NA,NA,511,357,154,29,7,22,0.06,0.05,0.06,3633,76,155,9
162584,FROSTBURG STATE UNIVERSITY,1,0,1991,NA,NA,762,381,381,187,67,120,0.31,0.18,0.25,2247,43,245,654
162584,FROSTBURG STATE UNIVERSITY,1,0,1992,NA,NA,839,454,385,236,68,168,0.37,0.18,0.28,2396,43,233,735
162584,FROSTBURG STATE UNIVERSITY,1,0,1993,NA,NA,910,433,477,210,87,123,0.28,0.18,0.23,2666,42,228,779
162584,FROSTBURG STATE UNIVERSITY,1,0,1995,NA,NA,909,433,476,194,68,126,0.29,0.14,0.21,3072,49,238,783
162584,FROSTBURG STATE UNIVERSITY,1,0,1996,NA,NA,975,482,493,195,70,125,0.25,0.14,0.2,3290,50,237,793
162584,FROSTBURG STATE UNIVERSITY,1,0,1997,NA,NA,865,444,421,210,71,139,0.31,0.17,0.24,3544,53,239,720
162584,FROSTBURG STATE UNIVERSITY,1,0,1998,NA,NA,932,486,446,181,66,115,0.23,0.15,0.19,3776,55,237,721
162584,FROSTBURG STATE UNIVERSITY,1,0,1999,NA,NA,932,508,424,165,52,113,0.22,0.12,0.18,3216,59,236,714
162584,FROSTBURG STATE UNIVERSITY,1,0,2000,NA,NA,1028,499,529,199,64,135,0.27,0.12,0.19,3342,62,242,796
162584,FROSTBURG STATE UNIVERSITY,1,0,2001,NA,NA,923,471,452,204,65,139,0.29,0.14,0.22,3444,69,249,740
162584,FROSTBURG STATE UNIVERSITY,1,0,2002,NA,NA,999,492,507,220,67,153,0.31,0.13,0.22,3632,67,243,800
162584,FROSTBURG STATE UNIVERSITY,1,0,2003,NA,NA,988,450,538,216,85,131,0.29,0.16,0.22,4316,70,236,781
162584,FROSTBURG STATE UNIVERSITY,1,0,2004,NA,NA,955,427,528,207,78,129,0.3,0.15,0.22,4720,70,227,739
162584,Frostburg State University,1,0,2005,NA,NA,928,448,480,181,60,121,0.27,0.12,0.2,5000,71,231,654
162584,Frostburg State University,1,0,2006,NA,NA,1011,459,552,175,65,110,0.23,0.12,0.17,5000,76,235,702
162584,Frostburg State University,1,0,2007,NA,NA,1057,520,537,233,92,141,0.27,0.17,0.22,5000,80,233,680
162584,Frostburg State University,1,0,2008,NA,NA,1030,478,552,201,86,115,0.24,0.16,0.2,5000,83,242,653
162584,Frostburg State University,1,0,2009,NA,NA,1028,505,523,217,67,150,0.29,0.13,0.21,5000,88,240,606
162584,Frostburg State University,1,0,2010,NA,NA,1028,472,556,223,93,130,0.27,0.17,0.22,5150,88,243,649
162654,GOUCHER COLLEGE,1,0,1991,NA,NA,203,142,61,121,31,90,0.63,0.51,0.6,12685,22,74,167
162654,GOUCHER COLLEGE,1,0,1992,NA,NA,223,155,68,131,27,104,0.67,0.4,0.59,13446,23,77,184
162654,GOUCHER COLLEGE,1,0,1993,NA,NA,242,168,74,138,34,104,0.61,0.46,0.57,14300,25,75,177
162654,GOUCHER COLLEGE,1,0,1995,NA,NA,277,193,84,154,41,113,0.58,0.49,0.56,16630,32,74,196
162654,GOUCHER COLLEGE,1,0,1996,NA,NA,268,188,80,165,38,127,0.67,0.48,0.62,17635,35,76,194
162654,GOUCHER COLLEGE,1,0,1997,NA,NA,335,255,80,212,49,163,0.63,0.61,0.63,18525,27,78,250
162654,GOUCHER COLLEGE,1,0,1998,NA,NA,302,213,89,169,36,133,0.62,0.4,0.56,19565,30,78,233
162654,GOUCHER COLLEGE,1,0,1999,NA,NA,322,224,98,176,54,122,0.54,0.55,0.55,20200,31,78,222
162654,GOUCHER COLLEGE,1,0,2000,NA,NA,365,258,107,227,57,170,0.65,0.53,0.62,21000,35,78,218
162654,GOUCHER COLLEGE,1,0,2001,NA,NA,341,247,94,197,45,152,0.61,0.48,0.58,22000,39,78,203
162654,GOUCHER COLLEGE,1,0,2002,NA,NA,365,265,100,208,48,160,0.6,0.48,0.57,22950,41,96,211
162654,GOUCHER COLLEGE,1,0,2003,NA,NA,342,207,135,207,60,147,0.71,0.44,0.61,24150,43,98,246
162654,GOUCHER COLLEGE,1,0,2004,NA,NA,401,270,131,241,62,179,0.66,0.47,0.6,25570,44,104,282
162654,Goucher College,1,0,2005,NA,NA,340,217,123,210,68,142,0.65,0.55,0.62,27100,47,113,241
162654,Goucher College,1,0,2006,NA,NA,450,303,147,255,70,185,0.61,0.48,0.57,28900,53,130,324
162654,Goucher College,1,0,2007,NA,NA,399,277,122,236,67,169,0.61,0.55,0.59,30636,55,127,299
162654,Goucher College,1,0,2008,NA,NA,360,262,98,205,54,151,0.5700000000000001,0.55,0.57,32168,58,130,225
162654,Goucher College,1,0,2009,NA,NA,398,276,122,227,53,174,0.63,0.43,0.57,33294,61,130,255
162654,Goucher College,1,0,2010,NA,NA,388,259,129,185,50,135,0.52,0.39,0.48,34626,61,131,271
162760,HOOD COLLEGE,1,0,1991,NA,NA,145,143,2,70,1,69,0.48,0.5,0.48,12208,22,74,85
162760,HOOD COLLEGE,1,0,1992,NA,NA,150,143,7,91,4,87,0.6,0.57,0.61,12208,22,74,92
162760,HOOD COLLEGE,1,0,1993,NA,NA,163,161,2,102,0,102,0.63,0,0.63,13258,21,76,108
162760,HOOD COLLEGE,1,0,1995,NA,NA,177,172,5,103,2,101,0.58,0.4,0.58,14930,23,77,117
162760,HOOD COLLEGE,1,0,1996,NA,NA,129,128,1,73,0,73,0.5700000000000001,0,0.57,15522,24,77,74
162760,HOOD COLLEGE,1,0,1997,NA,NA,162,158,4,109,3,106,0.67,0.75,0.67,16418,28,75,105
162760,HOOD COLLEGE,1,0,1998,NA,NA,149,144,5,97,2,95,0.65,0.4,0.65,17010,25,69,80
162760,HOOD COLLEGE,1,0,1999,NA,NA,156,152,4,100,1,99,0.65,0.25,0.64,17275,27,73,85
162760,HOOD COLLEGE,1,0,2000,NA,NA,131,128,3,90,3,87,0.67,1,0.69,18295,27,73,85
162760,HOOD COLLEGE,1,0,2001,NA,NA,112,110,2,76,2,74,0.67,1,0.68,18795,27,73,83
162760,HOOD COLLEGE,1,0,2002,NA,NA,179,172,7,108,3,105,0.61,0.43,0.6,19360,26,78,114
162760,HOOD COLLEGE,1,0,2003,NA,NA,181,143,38,110,20,90,0.62,0.53,0.61,19940,30,76,113
162760,HOOD COLLEGE,1,0,2004,NA,NA,242,189,53,160,31,129,0.68,0.58,0.66,20940,31,76,183
162760,Hood College,1,0,2005,NA,NA,236,156,80,142,44,98,0.62,0.55,0.6,22000,32,81,169
162760,Hood College,1,0,2006,NA,NA,278,185,93,137,38,99,0.53,0.41,0.49,23320,33,81,201
162760,Hood College,1,0,2007,NA,NA,295,193,102,163,48,115,0.59,0.47,0.55,24720,34,81,211
162760,Hood College,1,0,2008,NA,NA,308,200,108,179,57,122,0.61,0.53,0.58,26200,36,80,220
162760,Hood College,1,0,2009,NA,NA,251,168,83,136,46,90,0.53,0.55,0.54,27770,38,80,164
162760,Hood College,1,0,2010,NA,NA,327,210,117,165,52,113,0.53,0.44,0.5,29440,37,83,217
162928,JOHNS HOPKINS UNIVERSITY,1,0,1991,NA,NA,846,304,542,707,444,263,0.86,0.82,0.84,16400,1172,743,582
162928,JOHNS HOPKINS UNIVERSITY,1,0,1992,NA,NA,847,325,522,685,402,283,0.87,0.77,0.81,17420,1250,759,586
162928,JOHNS HOPKINS UNIVERSITY,1,0,1993,NA,NA,64,32,32,37,16,21,0.65,0.5,0.58,17900,1310,767,43
162928,JOHNS HOPKINS UNIVERSITY,1,0,1995,NA,NA,873,332,541,683,401,282,0.84,0.74,0.78,19750,1442,848,584
162928,JOHNS HOPKINS UNIVERSITY,1,0,1996,NA,NA,1018,408,610,826,483,343,0.84,0.79,0.81,20740,1494,860,646
162928,JOHNS HOPKINS UNIVERSITY,1,0,1997,NA,NA,941,411,530,749,411,338,0.8200000000000001,0.78,0.8,21700,1542,867,620
162928,JOHNS HOPKINS UNIVERSITY,1,0,1998,NA,NA,1077,467,610,864,469,395,0.84,0.77,0.8,22680,1634,966,719
162928,JOHNS HOPKINS UNIVERSITY,1,0,1999,NA,NA,1098,441,657,868,503,365,0.8200000000000001,0.77,0.79,23660,1695,998,760
162928,JOHNS HOPKINS UNIVERSITY,1,0,2000,NA,NA,1067,456,611,876,483,393,0.86,0.79,0.82,24930,1794,1032,684
162928,JOHNS HOPKINS UNIVERSITY,1,0,2001,NA,NA,1077,435,642,884,510,374,0.85,0.79,0.82,26210,1964,1066,729
162928,JOHNS HOPKINS UNIVERSITY,1,0,2002,NA,NA,1203,539,664,960,501,459,0.85,0.75,0.8,27390,2231,1089,766
162928,JOHNS HOPKINS UNIVERSITY,1,0,2003,NA,NA,1122,499,623,919,488,431,0.86,0.78,0.82,28730,2485,1094,706
162928,JOHNS HOPKINS UNIVERSITY,1,0,2004,NA,NA,1127,525,602,928,480,448,0.85,0.8,0.82,30140,2712,1144,661
162928,Johns Hopkins University,1,0,2005,NA,NA,1228,587,641,1036,523,513,0.87,0.82,0.84,31620,2900,1171,774
162928,Johns Hopkins University,1,0,2006,NA,NA,1304,643,661,1127,563,564,0.87,0.85,0.86,33900,3082,1123,786
162928,Johns Hopkins University,1,0,2007,NA,NA,1260,607,653,1095,545,550,0.9,0.83,0.87,35900,3310,1127,675
162928,Johns Hopkins University,1,0,2008,NA,NA,1315,612,703,1140,587,553,0.9,0.83,0.87,37700,3485,1203,693
162928,Johns Hopkins University,1,0,2009,NA,NA,1427,663,764,1240,643,597,0.9,0.84,0.87,39150,3789,1060,703
162928,Johns Hopkins University,1,0,2010,NA,NA,1322,646,676,1150,577,573,0.88,0.85,0.87,40680,4019,936,744
163046,LOYOLA COLLEGE,1,0,1991,NA,NA,700,400,300,475,171,304,0.76,0.57,0.68,10490,69,213,617
163046,LOYOLA COLLEGE,1,0,1992,NA,NA,792,452,340,565,229,336,0.74,0.67,0.71,11270,71,220,690
163046,LOYOLA COLLEGE,1,0,1993,NA,NA,739,436,303,515,181,334,0.76,0.6,0.7,12165,75,222,672
163046,LOYOLA COLLEGE,1,0,1995,NA,NA,798,450,348,581,240,341,0.75,0.69,0.73,14260,85,221,687
163046,LOYOLA COLLEGE,1,0,1996,NA,NA,812,443,369,592,245,347,0.78,0.66,0.73,15460,89,218,707
163046,LOYOLA COLLEGE,1,0,1997,NA,NA,833,478,355,650,258,392,0.8200000000000001,0.73,0.78,16560,80,225,734
163046,LOYOLA COLLEGE,1,0,1998,NA,NA,854,485,369,668,276,392,0.8,0.75,0.78,18460,81,232,741
163046,LOYOLA COLLEGE,1,0,1999,NA,NA,941,530,411,734,292,442,0.8300000000000001,0.71,0.78,19660,96,235,853
163046,LOYOLA COLLEGE,1,0,2000,NA,NA,909,520,389,699,277,422,0.81,0.71,0.77,21230,92,250,818
163046,LOYOLA COLLEGE,1,0,2001,NA,NA,880,517,363,679,252,427,0.8200000000000001,0.69,0.77,21462,94,265,796
163046,LOYOLA COLLEGE,1,0,2002,NA,NA,901,527,374,733,295,438,0.8300000000000001,0.79,0.81,23200,106,272,781
163046,LOYOLA COLLEGE IN MARYLAND,1,0,2003,NA,NA,915,545,370,704,277,427,0.78,0.75,0.77,25140,120,284,796
163046,LOYOLA COLLEGE IN MARYLAND,1,0,2004,NA,NA,951,579,372,726,277,449,0.77,0.74,0.76,26803,120,294,825
163046,Loyola College in Maryland,1,0,2005,NA,NA,898,526,372,711,291,420,0.79,0.78,0.79,28683,128,303,757
163046,Loyola College in Maryland,1,0,2006,NA,NA,946,596,350,749,263,486,0.81,0.75,0.79,30615,138,305,818
163046,Loyola College in Maryland,1,0,2007,NA,NA,979,545,434,777,320,457,0.8300000000000001,0.74,0.79,32838,147,324,823
163046,Loyola College in Maryland,1,0,2008,NA,NA,1066,637,429,825,307,518,0.81,0.72,0.77,35055,153,334,896
163046,Loyola University Maryland,1,0,2009,NA,NA,968,592,376,740,275,465,0.78,0.73,0.76,36510,166,292,831
163046,Loyola University-Baltimore,1,0,2010,NA,NA,1019,630,389,818,311,507,0.8,0.8,0.8,37950,166,328,838
163268,UNIVERSITY OF MARYLAND BALTIMORE COUNTY CAMPUS,1,0,1991,NA,NA,910,467,443,185,71,114,0.24,0.16,0.2,2672,104,364,558
163268,UNIVERSITY OF MARYLAND BALTIMORE COUNTY CAMPUS,1,0,1992,NA,NA,884,437,447,200,79,121,0.27,0.18,0.23,2856,101,349,599
163268,UNIVERSITY OF MARYLAND BALTIMORE COUNTY,1,0,1993,NA,NA,929,419,510,215,97,118,0.28,0.19,0.23,3338,110,353,646
163268,UNIVERSITY OF MARYLAND-BALTIMORE COUNTY,1,0,1995,NA,NA,968,485,483,295,115,180,0.37,0.24,0.3,3852,131,359,601
163268,UNIVERSITY OF MARYLAND-BALTIMORE COUNTY,1,0,1996,NA,NA,1005,505,500,280,106,174,0.34,0.21,0.28,4136,141,381,638
163268,UNIVERSITY OF MARYLAND-BALTIMORE COUNTY,1,0,1997,NA,NA,1135,605,530,343,133,210,0.34,0.25,0.3,4570,156,384,658
163268,UNIVERSITY OF MARYLAND-BALTIMORE COUNTY,1,0,1998,NA,NA,1246,609,637,347,138,209,0.34,0.22,0.28,4846,167,401,746
163268,UNIVERSITY OF MARYLAND-BALTIMORE COUNTY,1,0,1999,NA,NA,1396,638,758,417,188,229,0.35000000000000003,0.25,0.3,4046,185,410,855
163268,UNIVERSITY OF MARYLAND-BALTIMORE COUNTY,1,0,2000,NA,NA,1307,601,706,362,150,212,0.35000000000000003,0.21,0.28,4206,207,428,794
163268,UNIVERSITY OF MARYLAND-BALTIMORE COUNTY,1,0,2001,NA,NA,1332,603,729,461,204,257,0.42,0.28,0.35,4374,240,446,827
163268,UNIVERSITY OF MARYLAND-BALTIMORE COUNTY,1,0,2002,NA,NA,1356,572,784,437,210,227,0.39,0.27,0.32,4614,249,469,856
163268,UNIVERSITY OF MARYLAND-BALTIMORE COUNTY,1,0,2003,NA,NA,1487,657,830,506,215,291,0.44,0.26,0.34,5570,257,464,881
163268,UNIVERSITY OF MARYLAND-BALTIMORE COUNTY,1,0,2004,NA,NA,1403,560,843,472,249,223,0.39,0.3,0.34,6120,257,456,864
163268,University of Maryland-Baltimore County,1,0,2005,NA,NA,1414,584,830,466,237,229,0.39,0.29,0.33,6484,271,458,818
163268,University of Maryland-Baltimore County,1,0,2006,NA,NA,1419,626,793,523,233,290,0.46,0.29,0.37,6484,277,482,756
163268,University of Maryland-Baltimore County,1,0,2007,NA,NA,1423,655,768,523,230,293,0.44,0.3,0.37,6484,293,473,740
163268,University of Maryland-Baltimore County,1,0,2008,NA,NA,1555,650,905,531,237,294,0.45,0.26,0.34,6484,306,483,774
163268,University of Maryland-Baltimore County,1,0,2009,NA,NA,1522,656,866,574,257,317,0.48,0.3,0.38,6484,326,480,797
163268,University of Maryland-Baltimore County,1,0,2010,NA,NA,1484,599,885,558,275,283,0.47000000000000003,0.31,0.38,6679,325,481,735
163286,UNIVERSITY OF MARYLAND COLLEGE PARK CAMPUS,1,0,1991,NA,NA,3069,1406,1663,928,361,567,0.4,0.22,0.3,2429,611,1298,2003
163286,UNIVERSITY OF MARYLAND COLLEGE PARK CAMPUS,1,0,1992,NA,NA,3032,1470,1562,966,379,587,0.39,0.24,0.32,2778,521,1276,2002
163286,UNIVERSITY OF MARYLAND COLLEGE PARK CAMPUS,1,0,1993,NA,NA,3153,1461,1692,1051,447,604,0.41000000000000003,0.26,0.33,3179,556,1285,1920
163286,UNIVERSITY OF MARYLAND COLLEGE PARK CAMPUS,1,0,1995,NA,NA,3577,1722,1855,1343,539,804,0.46,0.29,0.38,3794,634,1484,2188
163286,UNIVERSITY OF MARYLAND COLLEGE PARK CAMPUS,1,0,1996,NA,NA,3539,1720,1819,1449,585,864,0.5,0.32,0.41,4169,673,1496,2198
163286,UNIVERSITY OF MARYLAND-COLLEGE PARK,1,0,1997,NA,NA,3950,1873,2077,1699,731,968,0.51,0.35,0.43,4460,726,1519,2449
163286,UNIVERSITY OF MARYLAND-COLLEGE PARK,1,0,1998,NA,NA,4039,2007,2032,1858,801,1057,0.52,0.39,0.46,4699,767,1363,2528
163286,UNIVERSITY OF MARYLAND-COLLEGE PARK,1,0,1999,NA,NA,3871,1796,2075,1943,884,1059,0.58,0.43,0.5,4050,846,1389,2447
163286,UNIVERSITY OF MARYLAND-COLLEGE PARK,1,0,2000,NA,NA,3929,1896,2033,2141,933,1208,0.63,0.46,0.54,4172,908,1467,2463
163286,UNIVERSITY OF MARYLAND-COLLEGE PARK,1,0,2001,NA,NA,4341,2063,2278,2535,1169,1366,0.66,0.51,0.58,4334,1017,1546,2755
163286,UNIVERSITY OF MARYLAND-COLLEGE PARK,1,0,2002,NA,NA,3886,1961,1925,2452,1128,1324,0.67,0.59,0.63,4572,1120,1589,2493
163286,UNIVERSITY OF MARYLAND-COLLEGE PARK,1,0,2003,NA,NA,4045,2031,2014,2539,1158,1381,0.68,0.57,0.63,5568,1079,1539,2444
163286,UNIVERSITY OF MARYLAND-COLLEGE PARK,1,0,2004,NA,NA,4174,2055,2119,2607,1173,1434,0.6900000000000001,0.55,0.62,6200,1094,1527,2435
163286,University of Maryland-College Park,1,0,2005,NA,NA,4192,2081,2111,2769,1273,1496,0.71,0.6,0.66,6566,1159,1523,2421
163286,University of Maryland-College Park,1,0,2006,NA,NA,3944,1896,2048,2493,1179,1314,0.6900000000000001,0.58,0.63,6566,1234,1580,2189
163286,University of Maryland-College Park,1,0,2007,NA,NA,4229,2028,2201,2772,1300,1472,0.72,0.59,0.66,6566,1250,1597,2566
163286,University of Maryland-College Park,1,0,2008,NA,NA,3907,1824,2083,2610,1298,1312,0.71,0.62,0.67,6566,1371,1642,2287
163286,University of Maryland-College Park,1,0,2009,NA,NA,4199,1953,2246,2912,1448,1464,0.74,0.64,0.69,6566,1405,1618,2630
163286,University of Maryland-College Park,1,0,2010,NA,NA,3930,1856,2074,2700,1314,1386,0.74,0.63,0.69,6763,1418,1613,2175
163453,MORGAN STATE UNIVERSITY,1,0,1991,NA,NA,919,552,367,139,29,110,0.19,0.08,0.15,2198,57,223,6
163453,MORGAN STATE UNIVERSITY,1,0,1992,NA,NA,967,572,395,168,37,131,0.22,0.09,0.17,2438,60,230,7
163453,MORGAN STATE UNIVERSITY,1,0,1993,NA,NA,944,567,377,138,26,112,0.19,0.07,0.15,2526,63,235,12
163453,MORGAN STATE UNIVERSITY,1,0,1995,NA,NA,959,580,379,166,30,136,0.23,0.08,0.17,2832,79,240,9
163453,MORGAN STATE UNIVERSITY,1,0,1996,NA,NA,917,546,371,162,27,135,0.24,0.07,0.18,3126,84,220,5
163453,MORGAN STATE UNIVERSITY,1,0,1997,NA,NA,1016,588,428,176,30,146,0.24,0.07,0.17,3412,93,243,7
163453,MORGAN STATE UNIVERSITY,1,0,1998,NA,NA,1136,674,462,166,42,124,0.18,0.09,0.15,3706,95,195,6
163453,MORGAN STATE UNIVERSITY,1,0,1999,NA,NA,1152,661,491,208,41,167,0.25,0.08,0.18,2906,102,198,6
163453,MORGAN STATE UNIVERSITY,1,0,2000,NA,NA,1107,689,418,204,60,144,0.2,0.14,0.18,3030,122,279,4
163453,MORGAN STATE UNIVERSITY,1,0,2001,NA,NA,1125,663,462,172,39,133,0.2,0.08,0.15,3150,126,360,2
163453,MORGAN STATE UNIVERSITY,1,0,2002,NA,NA,1247,741,506,139,26,113,0.15,0.05,0.11,4698,142,296,6
163453,MORGAN STATE UNIVERSITY,1,0,2003,NA,NA,1220,699,521,138,34,104,0.14,0.07,0.11,5078,138,299,5
163453,MORGAN STATE UNIVERSITY,1,0,2004,NA,NA,1336,750,586,153,32,121,0.16,0.05,0.11,4000,133,265,10
163453,Morgan State University,1,0,2005,NA,NA,764,408,356,89,22,67,0.16,0.06,0.12,4280,144,323,8
163453,Morgan State University,1,0,2006,NA,NA,1368,773,595,165,46,119,0.15,0.08,0.12,4280,150,319,13
163453,Morgan State University,1,0,2007,NA,NA,1286,698,588,143,42,101,0.14,0.07,0.11,4280,166,425,10
163453,Morgan State University,1,0,2008,NA,NA,1430,808,622,169,46,123,0.15,0.07,0.12,4280,174,436,14
163453,Morgan State University,1,0,2009,NA,NA,1261,715,546,121,35,86,0.12,0.06,0.1,4280,177,437,11
163453,Morgan State University,1,0,2010,NA,NA,1208,663,545,115,32,83,0.12,0.06,0.1,4408,179,464,5
163462,MOUNT SAINT MARYS COLLEGE,1,0,1991,NA,NA,320,170,150,195,85,110,0.64,0.57,0.61,9875,26,90,289
163462,MOUNT SAINT MARYS COLLEGE,1,0,1992,NA,NA,346,190,156,209,89,120,0.63,0.57,0.6,10675,27,86,310
163462,MOUNT SAINT MARYS COLLEGE,1,0,1993,NA,NA,325,166,159,218,99,119,0.71,0.62,0.67,11725,29,85,287
163462,MOUNT SAINT MARYS COLLEGE,1,0,1995,NA,NA,315,169,146,205,95,110,0.65,0.65,0.65,14120,34,94,272
163462,MOUNT SAINT MARYS COLLEGE,1,0,1996,NA,NA,367,207,160,214,80,134,0.64,0.5,0.58,14885,36,97,307
163462,MOUNT SAINT MARYS COLLEGE,1,0,1997,NA,NA,325,179,146,221,95,126,0.7000000000000001,0.65,0.68,15650,31,100,277
163462,MOUNT SAINT MARYS COLLEGE,1,0,1998,NA,NA,410,213,197,249,113,136,0.63,0.57,0.61,16100,31,97,345
163462,MOUNT SAINT MARYS COLLEGE,1,0,1999,NA,NA,369,221,148,238,94,144,0.65,0.64,0.64,16520,30,97,319
163462,MOUNT SAINT MARYS COLLEGE,1,0,2000,NA,NA,383,223,160,255,109,146,0.65,0.68,0.67,17200,30,101,326
163462,MOUNT SAINT MARYS COLLEGE,1,0,2001,NA,NA,355,197,158,230,105,125,0.63,0.66,0.65,18480,32,105,316
163462,MOUNT SAINT MARYS COLLEGE,1,0,2002,NA,NA,399,211,188,233,97,136,0.64,0.52,0.58,19700,34,103,346
163462,MOUNT SAINT MARYS COLLEGE,1,0,2003,NA,NA,395,237,158,279,110,169,0.71,0.7,0.71,20800,38,103,347
163462,MOUNT ST MARY'S UNIVERSITY,1,0,2004,NA,NA,391,243,148,270,99,171,0.7000000000000001,0.67,0.69,21430,42,103,323
163462,Mount St Mary's University,1,0,2005,NA,NA,437,267,170,315,127,188,0.7000000000000001,0.75,0.72,22500,43,105,363
163462,Mount St Mary's University,1,0,2006,NA,NA,426,244,182,265,97,168,0.68,0.53,0.62,23630,45,112,347
163462,Mount St Mary's University,1,0,2007,NA,NA,448,256,192,275,114,161,0.62,0.59,0.61,25290,48,116,363
163462,Mount St Mary's University,1,0,2008,NA,NA,410,218,192,236,99,137,0.62,0.52,0.58,26960,53,117,325
163462,Mount St. Mary's University,1,0,2009,NA,NA,464,268,196,298,126,172,0.64,0.64,0.64,28420,55,114,353
163462,Mount St Mary's University,1,0,2010,NA,NA,424,241,183,275,101,174,0.72,0.55,0.65,29650,58,111,307
163851,SALISBURY STATE UNIVERSITY,1,0,1991,NA,NA,711,387,324,293,99,194,0.5,0.31,0.41,2544,43,238,658
163851,SALISBURY STATE UNIVERSITY,1,0,1992,NA,NA,634,372,262,264,78,186,0.5,0.3,0.42,2754,43,236,569
163851,SALISBURY STATE UNIVERSITY,1,0,1993,NA,NA,726,405,321,297,92,205,0.5,0.29,0.41,3026,49,240,653
163851,SALISBURY STATE UNIVERSITY,1,0,1995,NA,NA,642,412,230,322,101,221,0.53,0.44,0.5,3440,56,245,591
163851,SALISBURY STATE UNIVERSITY,1,0,1996,NA,NA,689,393,296,311,98,213,0.54,0.33,0.45,3608,60,254,611
163851,SALISBURY STATE UNIVERSITY,1,0,1997,NA,NA,886,515,371,418,133,285,0.55,0.36,0.47,3842,61,254,818
163851,SALISBURY STATE UNIVERSITY,1,0,1998,NA,NA,935,534,401,438,139,299,0.55,0.35,0.47,4002,66,263,778
163851,SALISBURY STATE UNIVERSITY,1,0,1999,NA,NA,877,537,340,458,149,309,0.5700000000000001,0.44,0.52,2856,65,261,765
163851,SALISBURY STATE UNIVERSITY,1,0,2000,NA,NA,939,546,393,488,163,325,0.59,0.41,0.52,3092,74,276,827
163851,SALISBURY UNIVERSITY,1,0,2001,NA,NA,945,542,403,429,135,294,0.54,0.33,0.45,3216,83,291,749
163851,SALISBURY UNIVERSITY,1,0,2002,NA,NA,908,529,379,417,121,296,0.55,0.32,0.46,3394,85,298,722
163851,SALISBURY UNIVERSITY,1,0,2003,NA,NA,947,531,416,433,142,291,0.54,0.34,0.46,4134,88,299,714
163851,SALISBURY UNIVERSITY,1,0,2004,NA,NA,981,536,445,457,148,309,0.5700000000000001,0.33,0.47,4546,85,314,797
163851,Salisbury University,1,0,2005,NA,NA,952,525,427,442,146,296,0.56,0.34,0.46,4814,90,323,786
163851,Salisbury University,1,0,2006,NA,NA,1028,588,440,502,171,331,0.56,0.39,0.49,4814,95,337,822
163851,Salisbury University,1,0,2007,NA,NA,1142,646,496,533,172,361,0.55,0.35,0.47,4814,103,363,926
163851,Salisbury University,1,0,2008,NA,NA,1198,694,504,533,151,382,0.55,0.3,0.44,4814,109,379,994
163851,Salisbury University,1,0,2009,NA,NA,1273,738,535,577,169,408,0.55,0.32,0.45,4814,120,380,1032
163851,Salisbury University,1,0,2010,NA,NA,1248,770,478,595,176,419,0.54,0.37,0.48,4960,119,388,949
163912,SAINT MARYS COLLEGE OF MARYLAND,1,0,1991,NA,NA,227,132,95,147,51,96,0.72,0.54,0.65,3210,22,96,178
163912,SAINT MARYS COLLEGE OF MARYLAND,1,0,1992,NA,NA,234,133,101,129,53,76,0.5700000000000001,0.52,0.55,3880,20,96,185
163912,SAINT MARYS COLLEGE OF MARYLAND,1,0,1993,NA,NA,284,153,131,166,68,98,0.64,0.52,0.58,4400,21,97,225
163912,SAINT MARYS COLLEGE OF MARYLAND,1,0,1995,NA,NA,352,201,151,207,81,126,0.62,0.54,0.59,5435,25,104,289
163912,SAINT MARYS COLLEGE OF MARYLAND,1,0,1996,NA,NA,312,180,132,221,93,128,0.71,0.7,0.71,6005,27,108,253
163912,SAINT MARYS COLLEGE OF MARYLAND,1,0,1997,NA,NA,345,194,151,232,92,140,0.72,0.61,0.67,6575,29,109,286
163912,SAINT MARYS COLLEGE OF MARYLAND,1,0,1998,NA,NA,331,181,150,211,77,134,0.74,0.51,0.64,6875,31,111,264
163912,ST MARY'S COLLEGE OF MARYLAND,1,0,1999,NA,NA,276,157,119,176,70,106,0.67,0.59,0.64,6100,32,116,221
163912,ST MARY'S COLLEGE OF MARYLAND,1,0,2000,NA,NA,375,220,155,262,94,168,0.76,0.61,0.7,6285,35,121,318
163912,ST MARY'S COLLEGE OF MARYLAND,1,0,2001,NA,NA,457,287,170,344,114,230,0.8,0.67,0.75,6474,38,127,372
163912,ST MARY'S COLLEGE OF MARYLAND,1,0,2002,NA,NA,425,243,182,286,113,173,0.71,0.62,0.67,6925,41,130,338
163912,ST MARY'S COLLEGE OF MARYLAND,1,0,2003,NA,NA,421,249,172,300,106,194,0.77,0.62,0.71,7550,42,126,322
163912,ST MARY'S COLLEGE OF MARYLAND,1,0,2004,NA,NA,431,233,198,303,122,181,0.77,0.62,0.7,8092,43,128,338
163912,St Mary's College of Maryland,1,0,2005,NA,NA,488,295,193,341,130,211,0.71,0.67,0.7,9063,48,137,369
163912,St Mary's College of Maryland,1,0,2006,NA,NA,428,249,179,309,118,191,0.76,0.66,0.72,9498,51,145,320
163912,St Mary's College of Maryland,1,0,2007,NA,NA,464,256,208,331,134,197,0.76,0.64,0.71,9973,56,152,360
163912,St Mary's College of Maryland,1,0,2008,NA,NA,458,279,179,332,119,213,0.76,0.66,0.72,10472,60,154,361
163912,St. Mary's College of Maryland,1,0,2009,NA,NA,486,273,213,327,121,206,0.75,0.57,0.67,10995,62,143,384
163912,St Mary's College of Maryland,1,0,2010,NA,NA,443,277,166,289,96,193,0.6900000000000001,0.58,0.65,11325,62,144,333
164076,TOWSON STATE UNIVERSITY,1,0,1991,NA,NA,1237,735,502,335,78,257,0.34,0.16,0.27,2458,107,483,1014
164076,TOWSON STATE UNIVERSITY,1,0,1992,NA,NA,1336,824,512,365,99,266,0.32,0.19,0.27,2828,112,481,1131
164076,TOWSON STATE UNIVERSITY,1,0,1993,NA,NA,1215,721,494,348,90,258,0.35000000000000003,0.18,0.29,3122,113,471,990
164076,TOWSON STATE UNIVERSITY,1,0,1995,NA,NA,1488,934,554,468,121,347,0.37,0.22,0.31,3530,124,465,1237
164076,TOWSON STATE UNIVERSITY,1,0,1996,NA,NA,1851,1127,724,513,127,386,0.34,0.18,0.28,3822,130,454,1550
164076,TOWSON UNIVERSITY,1,0,1997,NA,NA,1808,1079,729,557,166,391,0.36,0.23,0.31,4120,147,450,1480
164076,TOWSON UNIVERSITY,1,0,1998,NA,NA,1923,1175,748,573,183,390,0.33,0.24,0.3,4336,164,458,1570
164076,TOWSON UNIVERSITY,1,0,1999,NA,NA,2103,1277,826,610,170,440,0.34,0.21,0.29,3332,181,521,1692
164076,TOWSON UNIVERSITY,1,0,2000,NA,NA,1981,1198,783,630,190,440,0.36,0.24,0.32,3466,199,546,1613
164076,TOWSON UNIVERSITY,1,0,2001,NA,NA,1910,1245,665,681,169,512,0.41000000000000003,0.25,0.36,3605,218,571,1505
164076,TOWSON UNIVERSITY,1,0,2002,NA,NA,2198,1385,813,815,229,586,0.42,0.28,0.37,3804,205,585,1765
164076,TOWSON UNIVERSITY,1,0,2003,NA,NA,1756,1192,564,763,181,582,0.48,0.32,0.43,4528,216,611,1262
164076,TOWSON UNIVERSITY,1,0,2004,NA,NA,2082,1376,706,835,229,606,0.44,0.32,0.4,4890,212,622,1485
164076,Towson University,1,0,2005,NA,NA,2314,1455,859,910,270,640,0.43,0.31,0.39,5180,227,663,1688
164076,Towson University,1,0,2006,NA,NA,2688,1697,991,1047,307,740,0.43,0.31,0.39,5180,238,691,1905
164076,Towson University,1,0,2007,NA,NA,2649,1670,979,1069,314,755,0.45,0.32,0.4,5180,262,728,2027
164076,Towson University,1,0,2008,NA,NA,2825,1786,1039,1210,385,825,0.46,0.37,0.43,5180,284,788,2052
164076,Towson University,1,0,2009,NA,NA,2395,1564,831,1076,275,801,0.51,0.33,0.45,5180,303,822,1693
164076,Towson University,1,0,2010,NA,NA,2427,1593,834,1125,310,815,0.51,0.37,0.46,5336,305,830,1786
164173,VILLA JULIE COLLEGE,1,0,1991,NA,NA,269,233,36,44,6,38,0.16,0.17,0.16,5770,9,43,211
164173,VILLA JULIE COLLEGE,1,0,1992,NA,NA,200,154,46,44,7,37,0.24,0.15,0.22,6320,10,40,172
164173,VILLA JULIE COLLEGE,1,0,1993,NA,NA,218,171,47,53,10,43,0.25,0.21,0.24,6880,11,42,164
164173,VILLA JULIE COLLEGE,1,0,1995,NA,NA,253,180,73,94,26,68,0.37,0.36,0.37,8200,13,65,210
164173,VILLA JULIE COLLEGE,1,0,1996,NA,NA,286,205,81,89,20,69,0.33,0.25,0.31,8610,14,67,214
164173,VILLA JULIE COLLEGE,1,0,1997,NA,NA,367,259,108,122,21,101,0.39,0.19,0.33,9240,16,64,312
164173,VILLA JULIE COLLEGE,1,0,1998,NA,NA,443,305,138,163,46,117,0.38,0.33,0.37,9976,18,68,394
164173,VILLA JULIE COLLEGE,1,0,1999,NA,NA,421,288,133,211,60,151,0.52,0.45,0.5,10250,18,72,373
164173,VILLA JULIE COLLEGE,1,0,2000,NA,NA,425,313,112,220,51,169,0.53,0.46,0.52,10750,20,75,345
164173,VILLA JULIE COLLEGE,1,0,2001,NA,NA,512,374,138,246,56,190,0.5,0.41,0.48,11300,22,79,412
164173,VILLA JULIE COLLEGE,1,0,2002,NA,NA,487,365,122,281,63,218,0.59,0.52,0.58,11978,25,80,406
164173,VILLA JULIE COLLEGE,1,0,2003,NA,NA,539,384,155,247,63,184,0.47000000000000003,0.41,0.46,12816,28,85,422
164173,VILLA JULIE COLLEGE,1,0,2004,NA,NA,561,378,183,252,81,171,0.45,0.44,0.45,13715,31,91,428
164173,Villa Julie College,1,0,2005,NA,NA,537,373,164,236,61,175,0.46,0.37,0.44,14674,38,93,395
164173,Villa Julie College,1,0,2006,NA,NA,643,454,189,315,85,230,0.5,0.45,0.49,15700,45,105,455
164173,Villa Julie College,1,0,2007,NA,NA,604,436,168,254,61,193,0.44,0.36,0.42,16800,53,112,444
164173,Stevenson University,1,0,2008,NA,NA,626,436,190,301,81,220,0.5,0.43,0.48,17976,59,111,473
164173,Stevenson University,1,0,2009,NA,NA,522,346,176,220,62,158,0.45,0.35,0.42,19234,63,110,338
164173,Stevenson University,1,0,2010,NA,NA,877,535,342,331,98,233,0.43,0.29,0.38,20580,66,111,481
164216,WASHINGTON COLLEGE,1,0,1991,NA,NA,182,99,83,105,40,65,0.65,0.48,0.58,12312,19,58,161
164216,WASHINGTON COLLEGE,1,0,1992,NA,NA,276,145,131,160,70,90,0.62,0.53,0.58,13226,20,62,237
164216,WASHINGTON COLLEGE,1,0,1993,NA,NA,213,123,90,132,46,86,0.6900000000000001,0.51,0.62,13952,22,66,178
164216,WASHINGTON COLLEGE,1,0,1995,NA,NA,241,134,107,144,60,84,0.62,0.56,0.6,16440,23,64,197
164216,WASHINGTON COLLEGE,1,0,1996,NA,NA,312,198,114,203,67,136,0.68,0.59,0.65,16800,25,63,261
164216,WASHINGTON COLLEGE,1,0,1997,NA,NA,290,162,128,182,79,103,0.63,0.62,0.63,17800,21,65,244
164216,WASHINGTON COLLEGE,1,0,1998,NA,NA,278,174,104,163,53,110,0.63,0.51,0.59,18750,23,68,234
164216,WASHINGTON COLLEGE,1,0,1999,NA,NA,282,175,107,175,54,121,0.6900000000000001,0.5,0.62,19750,24,72,235
164216,WASHINGTON COLLEGE,1,0,2000,NA,NA,374,236,138,255,80,175,0.74,0.58,0.68,20750,26,75,328
164216,WASHINGTON COLLEGE,1,0,2001,NA,NA,338,204,134,234,89,145,0.71,0.66,0.69,21750,29,79,263
164216,WASHINGTON COLLEGE,1,0,2002,NA,NA,368,243,125,276,88,188,0.77,0.7,0.75,22740,31,80,309
164216,WASHINGTON COLLEGE,1,0,2003,NA,NA,361,228,133,272,93,179,0.78,0.7,0.75,24240,34,76,308
164216,WASHINGTON COLLEGE,1,0,2004,NA,NA,304,185,119,205,71,134,0.72,0.6,0.67,25990,36,79,262
164216,Washington College,1,0,2005,NA,NA,345,201,144,247,90,157,0.78,0.62,0.72,28230,38,79,297
164216,Washington College,1,0,2006,NA,NA,312,179,133,202,80,122,0.68,0.6,0.65,29640,43,82,266
164216,Washington College,1,0,2007,NA,NA,324,197,127,210,69,141,0.71,0.54,0.65,31570,45,93,270
164216,Washington College,1,0,2008,NA,NA,415,248,167,291,108,183,0.73,0.65,0.7,33385,49,95,354
164216,Washington College,1,0,2009,NA,NA,378,215,163,269,111,158,0.73,0.68,0.71,34690,48,90,329
164216,Washington College,1,0,2010,NA,NA,421,238,183,293,109,184,0.77,0.6,0.7,36078,55,91,353
164270,WESTERN MARYLAND COLLEGE,1,0,1991,NA,NA,278,132,146,160,71,89,0.67,0.49,0.58,12505,26,85,234
164270,WESTERN MARYLAND COLLEGE,1,0,1992,NA,NA,300,160,140,164,62,102,0.63,0.44,0.55,13130,27,84,270
164270,WESTERN MARYLAND COLLEGE,1,0,1993,NA,NA,258,132,126,145,62,83,0.62,0.49,0.56,13750,27,79,225
164270,WESTERN MARYLAND COLLEGE,1,0,1995,NA,NA,316,163,153,206,80,126,0.77,0.52,0.65,15300,30,77,294
164270,WESTERN MARYLAND COLLEGE,1,0,1996,NA,NA,385,199,186,236,100,136,0.68,0.54,0.61,16125,33,82,340
164270,WESTERN MARYLAND COLLEGE,1,0,1997,NA,NA,427,241,186,274,98,176,0.73,0.53,0.64,16850,29,89,363
164270,WESTERN MARYLAND COLLEGE,1,0,1998,NA,NA,331,173,158,210,86,124,0.71,0.54,0.63,17730,31,83,274
164270,WESTERN MARYLAND COLLEGE,1,0,1999,NA,NA,412,204,208,261,107,154,0.75,0.51,0.63,18650,32,84,338
164270,WESTERN MARYLAND COLLEGE,1,0,2000,NA,NA,442,247,195,293,109,184,0.74,0.56,0.66,19600,36,88,376
164270,WESTERN MARYLAND COLLEGE,1,0,2001,NA,NA,368,209,159,244,88,156,0.74,0.55,0.66,20550,39,93,293
164270,MCDANIEL COLLEGE,1,0,2002,NA,NA,440,253,187,307,124,183,0.72,0.66,0.7,21760,40,92,342
164270,MCDANIEL COLLEGE,1,0,2003,NA,NA,451,249,202,274,94,180,0.72,0.47,0.61,22860,43,133,383
164270,MCDANIEL COLLEGE,1,0,2004,NA,NA,357,196,161,237,100,137,0.6900000000000001,0.62,0.66,24500,44,128,296
164270,McDaniel College,1,0,2005,NA,NA,447,246,201,314,136,178,0.72,0.68,0.7,25710,46,123,379
164270,McDaniel College,1,0,2006,NA,NA,476,260,216,324,126,198,0.76,0.58,0.68,26980,50,121,404
164270,McDaniel College,1,0,2007,NA,NA,439,226,213,279,118,161,0.71,0.55,0.64,28640,54,130,378
164270,McDaniel College,1,0,2008,NA,NA,426,223,203,263,117,146,0.65,0.58,0.62,30780,57,135,345
164270,McDaniel College,1,0,2009,NA,NA,420,195,225,266,124,142,0.72,0.55,0.63,32000,60,127,329
164270,McDaniel College,1,0,2010,NA,NA,408,213,195,250,93,157,0.73,0.48,0.61,33280,60,128,319
164447,AMERICAN INTERNATIONAL COLLEGE,1,0,1991,NA,NA,250,110,140,84,43,41,0.37,0.31,0.34,8117,14,67,196
164447,AMERICAN INTERNATIONAL COLLEGE,1,0,1992,NA,NA,225,95,130,71,38,33,0.34,0.29,0.32,8298,16,69,164
164447,AMERICAN INTERNATIONAL COLLEGE,1,0,1993,NA,NA,240,110,130,68,32,36,0.32,0.25,0.28,8690,17,72,165
164447,AMERICAN INTERNATIONAL COLLEGE,1,0,1995,NA,NA,260,104,156,84,37,47,0.45,0.24,0.32,9714,20,74,176
164447,AMERICAN INTERNATIONAL COLLEGE,1,0,1996,NA,NA,253,133,120,79,30,49,0.36,0.25,0.31,10276,22,76,165
164447,AMERICAN INTERNATIONAL COLLEGE,1,0,1997,NA,NA,253,133,120,79,30,49,0.36,0.25,0.31,11244,16,81,165
164447,AMERICAN INTERNATIONAL COLLEGE,1,0,1998,NA,NA,226,96,130,57,22,35,0.36,0.17,0.25,11800,18,83,149
164447,AMERICAN INTERNATIONAL COLLEGE,1,0,1999,NA,NA,240,92,148,77,33,44,0.47000000000000003,0.22,0.32,12338,19,83,106
164447,AMERICAN INTERNATIONAL COLLEGE,1,0,2000,NA,NA,239,123,116,112,63,49,0.39,0.54,0.47,13600,20,81,115
164447,AMERICAN INTERNATIONAL COLLEGE,1,0,2001,NA,NA,197,98,99,91,34,57,0.58,0.34,0.46,14800,21,80,105
164447,AMERICAN INTERNATIONAL COLLEGE,1,0,2002,NA,NA,256,117,139,55,21,34,0.29,0.15,0.21,15700,22,79,116
164447,AMERICAN INTERNATIONAL COLLEGE,1,0,2003,NA,NA,327,174,153,105,45,60,0.34,0.29,0.32,16700,27,78,172
164447,AMERICAN INTERNATIONAL COLLEGE,1,0,2004,NA,NA,321,167,154,83,35,48,0.28,0.23,0.26,18000,24,75,174
164447,American International College,1,0,2005,NA,NA,328,160,168,65,32,33,0.2,0.19,0.2,19800,28,77,177
164447,American International College,1,0,2006,NA,NA,282,148,134,81,29,52,0.35000000000000003,0.22,0.29,20990,27,79,130
164447,American International College,1,0,2007,NA,NA,390,202,188,111,55,56,0.27,0.29,0.28,22500,31,76,167
164447,American International College,1,0,2008,NA,NA,371,185,186,102,46,56,0.3,0.25,0.27,24100,35,80,145
164447,American International College,1,0,2009,NA,NA,354,165,189,88,40,48,0.29,0.21,0.25,25550,44,88,112
164447,American International College,1,0,2010,NA,NA,367,168,199,107,47,60,0.35000000000000003,0.24,0.29,26700,45,81,143
164492,ANNA MARIA COLLEGE,1,0,1991,NA,NA,116,87,29,54,9,45,0.51,0.31,0.47,9880,7,32,100
164492,ANNA MARIA COLLEGE,1,0,1992,NA,NA,80,48,32,35,16,19,0.39,0.5,0.44,10380,7,32,71
164492,ANNA MARIA COLLEGE,1,0,1993,NA,NA,94,62,32,50,17,33,0.53,0.53,0.53,10800,8,33,86
164492,ANNA MARIA COLLEGE,1,0,1995,NA,NA,69,43,26,28,7,21,0.48,0.27,0.41,11780,9,31,55
164492,ANNA MARIA COLLEGE,1,0,1996,NA,NA,112,69,43,53,24,29,0.42,0.56,0.47,11780,10,31,105
164492,ANNA MARIA COLLEGE,1,0,1997,NA,NA,135,90,45,54,19,35,0.38,0.42,0.4,12240,11,34,119
164492,ANNA MARIA COLLEGE,1,0,1998,NA,NA,153,116,37,70,19,51,0.43,0.51,0.46,12690,9,25,123
164492,ANNA MARIA COLLEGE,1,0,1999,NA,NA,134,90,44,64,23,41,0.45,0.52,0.48,12200,10,36,110
164492,ANNA MARIA COLLEGE,1,0,2000,NA,NA,149,110,39,81,18,63,0.5700000000000001,0.46,0.54,13495,9,35,128
164492,ANNA MARIA COLLEGE,1,0,2001,NA,NA,140,97,43,69,24,45,0.46,0.56,0.49,15250,10,34,119
164492,ANNA MARIA COLLEGE,1,0,2002,NA,NA,159,108,51,82,29,53,0.49,0.57,0.52,16410,10,37,142
164492,ANNA MARIA COLLEGE,1,0,2003,NA,NA,154,102,52,76,19,57,0.55,0.37,0.49,17495,11,39,131
164492,ANNA MARIA COLLEGE,1,0,2004,NA,NA,189,107,82,69,32,37,0.34,0.39,0.37,18545,10,34,152
164492,Anna Maria College,1,0,2005,NA,NA,156,79,77,58,27,31,0.39,0.35,0.37,19900,11,38,127
164492,Anna Maria College,1,0,2006,NA,NA,181,105,76,71,24,47,0.44,0.32,0.39,21094,12,40,145
164492,Anna Maria College,1,0,2007,NA,NA,258,137,121,112,45,67,0.48,0.37,0.43,22360,14,47,195
164492,Anna Maria College,1,0,2008,NA,NA,245,135,110,81,38,43,0.31,0.35,0.33,23500,18,50,190
164492,Anna Maria College,1,0,2009,NA,NA,373,172,201,95,46,49,0.28,0.23,0.25,24192,20,52,245
164492,Anna Maria College,1,0,2010,NA,NA,287,140,147,95,43,52,0.37,0.29,0.33,25632,21,49,165
164562,ASSUMPTION COLLEGE,1,0,1991,NA,NA,447,286,161,298,110,188,0.65,0.68,0.67,9835,26,108,440
164562,ASSUMPTION COLLEGE,1,0,1992,NA,NA,446,287,159,304,102,202,0.7000000000000001,0.64,0.68,10320,28,111,428
164562,ASSUMPTION COLLEGE,1,0,1993,NA,NA,491,302,189,299,108,191,0.63,0.57,0.61,11595,30,107,478
164562,ASSUMPTION COLLEGE,1,0,1995,NA,NA,446,262,184,295,119,176,0.67,0.65,0.66,12825,33,108,354
164562,ASSUMPTION COLLEGE,1,0,1996,NA,NA,431,266,165,296,112,184,0.6900000000000001,0.68,0.69,13845,35,109,391
164562,ASSUMPTION COLLEGE,1,0,1997,NA,NA,582,365,217,386,137,249,0.68,0.63,0.66,14845,37,116,515
164562,ASSUMPTION COLLEGE,1,0,1998,NA,NA,522,334,188,402,138,264,0.79,0.73,0.77,15905,31,113,474
164562,ASSUMPTION COLLEGE,1,0,1999,NA,NA,592,361,231,404,150,254,0.7000000000000001,0.65,0.68,17320,32,111,482
164562,ASSUMPTION COLLEGE,1,0,2000,NA,NA,593,367,226,409,114,295,0.8,0.5,0.69,17950,35,119,518
164562,ASSUMPTION COLLEGE,1,0,2001,NA,NA,604,369,235,402,148,254,0.68,0.63,0.67,18800,39,127,418
164562,ASSUMPTION COLLEGE,1,0,2002,NA,NA,618,381,237,451,168,283,0.74,0.71,0.73,19835,43,144,534
164562,ASSUMPTION COLLEGE,1,0,2003,NA,NA,640,408,232,409,140,269,0.65,0.6,0.64,21000,46,130,535
164562,ASSUMPTION COLLEGE,1,0,2004,NA,NA,633,364,269,447,170,277,0.76,0.63,0.71,22260,48,134,536
164562,Assumption College,1,0,2005,NA,NA,565,328,237,369,132,237,0.72,0.56,0.65,23930,50,135,426
164562,Assumption College,1,0,2006,NA,NA,675,397,278,484,183,301,0.75,0.66,0.72,25985,53,148,533
164562,Assumption College,1,0,2007,NA,NA,594,331,263,417,176,241,0.72,0.67,0.7,27320,57,153,460
164562,Assumption College,1,0,2008,NA,NA,606,357,249,402,151,251,0.7000000000000001,0.61,0.66,28686,61,157,439
164562,Assumption College,1,0,2009,NA,NA,515,294,221,363,135,228,0.77,0.61,0.7,29806,63,155,379
164562,Assumption College,1,0,2010,NA,NA,590,369,221,423,141,282,0.76,0.64,0.72,30940,62,156,449
165015,BRANDEIS UNIVERSITY,1,0,1991,NA,NA,745,392,353,546,247,299,0.76,0.7,0.73,16475,127,340,585
165015,BRANDEIS UNIVERSITY,1,0,1992,NA,NA,757,413,344,556,250,306,0.74,0.73,0.73,17726,132,328,597
165015,BRANDEIS UNIVERSITY,1,0,1993,NA,NA,704,379,325,531,238,293,0.77,0.73,0.75,18955,140,299,547
165015,BRANDEIS UNIVERSITY,1,0,1995,NA,NA,874,483,391,702,306,396,0.81,0.78,0.8,20935,157,317,697
165015,BRANDEIS UNIVERSITY,1,0,1996,NA,NA,761,393,368,608,275,333,0.84,0.75,0.8,21917,166,308,617
165015,BRANDEIS UNIVERSITY,1,0,1997,NA,NA,794,470,324,633,250,383,0.81,0.77,0.8,22360,139,309,628
165015,BRANDEIS UNIVERSITY,1,0,1998,NA,NA,850,477,373,715,293,422,0.88,0.79,0.84,23360,148,309,662
165015,BRANDEIS UNIVERSITY,1,0,1999,NA,NA,793,446,347,663,275,388,0.87,0.79,0.84,24421,158,316,569
165015,BRANDEIS UNIVERSITY,1,0,2000,NA,NA,858,475,383,714,301,413,0.86,0.79,0.83,25392,165,321,568
165015,BRANDEIS UNIVERSITY,1,0,2001,NA,NA,735,416,319,629,261,368,0.88,0.82,0.86,26281,175,326,499
165015,BRANDEIS UNIVERSITY,1,0,2002,NA,NA,837,456,381,708,316,392,0.85,0.83,0.85,27345,180,339,591
165015,BRANDEIS UNIVERSITY,1,0,2003,NA,NA,824,486,338,692,285,407,0.8300000000000001,0.84,0.84,28999,193,336,541
165015,BRANDEIS UNIVERSITY,1,0,2004,NA,NA,761,417,344,655,287,368,0.88,0.83,0.86,30160,201,333,496
165015,Brandeis University,1,0,2005,NA,NA,737,397,340,647,287,360,0.9,0.84,0.88,31532,217,343,453
165015,Brandeis University,1,0,2006,NA,NA,764,416,348,656,291,365,0.87,0.84,0.86,32951,233,352,407
165015,Brandeis University,1,0,2007,NA,NA,701,391,310,604,264,340,0.86,0.85,0.86,34566,246,351,377
165015,Brandeis University,1,0,2008,NA,NA,754,426,328,643,274,369,0.86,0.84,0.85,36122,269,360,341
165015,Brandeis University,1,0,2009,NA,NA,775,434,341,621,255,366,0.84,0.75,0.8,37530,314,358,331
165015,Brandeis University,1,0,2010,NA,NA,686,370,316,569,247,322,0.87,0.78,0.83,38994,277,363,354
165024,BRIDGEWATER STATE COLLEGE,1,0,1991,NA,NA,982,568,414,265,67,198,0.34,0.16,0.27,2882,36,306,910
165024,BRIDGEWATER STATE COLLEGE,1,0,1992,NA,NA,963,567,396,213,54,159,0.28,0.14,0.22,2952,38,244,857
165024,BRIDGEWATER STATE COLLEGE,1,0,1993,NA,NA,1045,590,455,196,68,128,0.21,0.15,0.19,3373,44,255,927
165024,BRIDGEWATER STATE COLLEGE,1,0,1995,NA,NA,1087,620,467,211,57,154,0.24,0.12,0.19,3462,67,258,928
165024,BRIDGEWATER STATE COLLEGE,1,0,1996,NA,NA,1155,697,458,222,52,170,0.24,0.11,0.19,3392,62,260,972
165024,BRIDGEWATER STATE COLLEGE,1,0,1997,NA,NA,1147,672,475,206,46,160,0.23,0.1,0.18,3324,64,262,964
165024,BRIDGEWATER STATE COLLEGE,1,0,1998,NA,NA,1128,695,433,260,75,185,0.26,0.17,0.23,3134,67,259,967
165024,BRIDGEWATER STATE COLLEGE,1,0,1999,NA,NA,1079,657,422,208,43,165,0.25,0.1,0.19,1032,70,249,897
165024,BRIDGEWATER STATE COLLEGE,1,0,2000,NA,NA,1244,760,484,290,87,203,0.26,0.18,0.23,1030,77,255,1030
165024,BRIDGEWATER STATE COLLEGE,1,0,2001,NA,NA,1139,695,444,255,59,196,0.28,0.13,0.22,910,80,262,961
165024,BRIDGEWATER STATE COLLEGE,1,0,2002,NA,NA,1272,769,503,277,72,205,0.26,0.14,0.22,910,76,252,1031
165024,BRIDGEWATER STATE COLLEGE,1,0,2003,NA,NA,1285,745,540,320,93,227,0.3,0.17,0.25,910,76,258,1078
165024,BRIDGEWATER STATE COLLEGE,1,0,2004,NA,NA,1266,713,553,306,99,207,0.29,0.18,0.24,910,88,262,1040
165024,Bridgewater State College,1,0,2005,NA,NA,1314,746,568,339,113,226,0.3,0.2,0.26,910,95,273,1066
165024,Bridgewater State College,1,0,2006,NA,NA,1321,737,584,368,135,233,0.31,0.23,0.28,910,104,292,1099
165024,Bridgewater State College,1,0,2007,NA,NA,1551,935,616,445,139,306,0.32,0.23,0.29,910,115,299,1272
165024,Bridgewater State College,1,0,2008,NA,NA,1464,915,549,412,134,278,0.3,0.24,0.28,910,134,306,1239
165024,Bridgewater State College,1,0,2009,NA,NA,1453,866,587,420,162,258,0.29,0.28,0.29,910,127,304,1194
165024,Bridgewater State University,1,0,2010,NA,NA,1431,812,619,458,174,284,0.34,0.28,0.32,910,138,309,1208
165334,CLARK UNIVERSITY,1,0,1991,NA,NA,561,307,254,344,137,207,0.67,0.54,0.61,15380,57,161,322
165334,CLARK UNIVERSITY,1,0,1992,NA,NA,527,317,210,280,106,174,0.54,0.5,0.53,16200,59,159,344
165334,CLARK UNIVERSITY,1,0,1993,NA,NA,443,257,186,251,102,149,0.5700000000000001,0.55,0.57,17000,59,160,273
165334,CLARK UNIVERSITY,1,0,1995,NA,NA,505,318,187,311,103,208,0.65,0.55,0.62,19140,65,153,299
165334,CLARK UNIVERSITY,1,0,1996,NA,NA,527,301,226,336,128,208,0.6900000000000001,0.57,0.64,20040,66,158,350
165334,CLARK UNIVERSITY,1,0,1997,NA,NA,520,313,207,313,110,203,0.64,0.53,0.6,20940,0,156,351
165334,CLARK UNIVERSITY,1,0,1998,NA,NA,501,305,196,323,119,204,0.66,0.61,0.64,21740,54,151,321
165334,CLARK UNIVERSITY,1,0,1999,NA,NA,486,304,182,308,112,196,0.64,0.62,0.63,22400,57,150,315
165334,CLARK UNIVERSITY,1,0,2000,NA,NA,497,292,205,315,120,195,0.66,0.59,0.63,23300,58,157,329
165334,CLARK UNIVERSITY,1,0,2001,NA,NA,511,330,181,354,123,231,0.7000000000000001,0.68,0.69,24400,61,164,342
165334,CLARK UNIVERSITY,1,0,2002,NA,NA,576,357,219,387,148,239,0.66,0.68,0.67,25600,64,166,379
165334,CLARK UNIVERSITY,1,0,2003,NA,NA,537,324,213,391,150,241,0.74,0.7,0.73,26700,69,167,342
165334,CLARK UNIVERSITY,1,0,2004,NA,NA,523,328,195,383,137,246,0.75,0.7,0.73,28000,70,171,327
165334,Clark University,1,0,2005,NA,NA,557,338,219,422,161,261,0.77,0.74,0.76,29300,74,167,383
165334,Clark University,1,0,2006,NA,NA,563,345,218,425,159,266,0.77,0.73,0.75,31200,80,174,399
165334,Clark University,1,0,2007,NA,NA,572,361,211,432,157,275,0.76,0.74,0.76,32600,82,178,402
165334,Clark University,1,0,2008,NA,NA,586,348,238,424,162,262,0.75,0.68,0.72,33900,90,189,408
165334,Clark University,1,0,2009,NA,NA,548,356,192,422,144,278,0.78,0.75,0.77,34900,91,202,401
165334,Clark University,1,0,2010,NA,NA,575,328,247,411,172,239,0.72,0.7,0.71,36100,91,194,404
165662,EMERSON COLLEGE,1,0,1991,NA,NA,399,269,130,217,89,128,0.47000000000000003,0.68,0.54,13273,38,91,345
165662,EMERSON COLLEGE,1,0,1992,NA,NA,408,276,132,198,70,128,0.46,0.53,0.49,13817,40,92,348
165662,EMERSON COLLEGE,1,0,1993,NA,NA,427,263,164,256,100,156,0.59,0.61,0.6,14743,43,92,369
165662,EMERSON COLLEGE,1,0,1995,NA,NA,526,313,213,310,121,189,0.6,0.57,0.59,16259,52,93,405
165662,EMERSON COLLEGE,1,0,1996,NA,NA,547,318,229,358,161,197,0.61,0.7,0.65,17085,56,94,423
165662,EMERSON COLLEGE,1,0,1997,NA,NA,547,333,214,343,130,213,0.63,0.61,0.63,18242,47,103,447
165662,EMERSON COLLEGE,1,0,1998,NA,NA,612,368,244,377,150,227,0.61,0.61,0.62,19028,52,106,517
165662,EMERSON COLLEGE,1,0,1999,NA,NA,653,361,292,433,192,241,0.66,0.66,0.66,18816,54,109,495
165662,EMERSON COLLEGE,1,0,2000,NA,NA,641,396,245,461,179,282,0.71,0.73,0.72,19520,57,112,550
165662,EMERSON COLLEGE,1,0,2001,NA,NA,643,406,237,440,163,277,0.68,0.69,0.68,20224,60,116,490
165662,EMERSON COLLEGE,1,0,2002,NA,NA,656,419,237,473,179,294,0.7000000000000001,0.76,0.72,21120,63,122,513
165662,EMERSON COLLEGE,1,0,2003,NA,NA,706,413,293,525,229,296,0.71,0.78,0.74,22144,66,128,554
165662,EMERSON COLLEGE,1,0,2004,NA,NA,700,402,298,533,242,291,0.72,0.81,0.76,22976,76,138,523
165662,Emerson College,1,0,2005,NA,NA,715,417,298,571,243,328,0.78,0.82,0.8,24064,84,143,557
165662,Emerson College,1,0,2006,NA,NA,728,409,319,578,254,324,0.79,0.8,0.79,25248,87,149,540
165662,Emerson College,1,0,2007,NA,NA,842,477,365,671,274,397,0.8300000000000001,0.75,0.8,26880,91,159,651
165662,Emerson College,1,0,2008,NA,NA,772,466,306,598,243,355,0.76,0.79,0.77,28352,105,163,429
165662,Emerson College,1,0,2009,NA,NA,764,486,278,593,215,378,0.77,0.77,0.78,29408,110,177,376
165662,Emerson College,1,0,2010,NA,NA,824,529,295,634,219,415,0.78,0.74,0.77,30752,111,183,499
165671,EMMANUEL COLLEGE,1,0,1991,NA,NA,138,138,0,51,0,51,0.36,NA,0.37,10070,13,45,90
165671,EMMANUEL COLLEGE,1,0,1992,NA,NA,149,149,0,52,0,52,0.34,NA,0.35,10966,13,52,96
165671,EMMANUEL COLLEGE,1,0,1993,NA,NA,133,133,0,59,0,59,0.44,NA,0.44,11973,15,44,84
165671,EMMANUEL COLLEGE,1,0,1995,NA,NA,100,100,0,43,0,43,0.43,NA,0.43,14055,18,49,65
165671,EMMANUEL COLLEGE,1,0,1996,NA,NA,86,86,0,45,0,45,0.52,NA,0.52,14523,18,48,42
165671,EMMANUEL COLLEGE,1,0,1997,NA,NA,112,112,0,59,0,59,0.52,NA,0.53,15094,17,48,50
165671,EMMANUEL COLLEGE,1,0,1998,NA,NA,151,151,0,80,0,80,0.52,NA,0.53,15786,17,47,85
165671,EMMANUEL COLLEGE,1,0,1999,NA,NA,133,133,0,60,0,60,0.45,NA,0.45,15488,17,47,85
165671,EMMANUEL COLLEGE,1,0,2000,NA,NA,165,165,0,82,0,82,0.49,NA,0.5,16112,18,47,87
165671,EMMANUEL COLLEGE,1,0,2001,NA,NA,277,189,88,128,32,96,0.5,0.36,0.46,16800,21,48,136
165671,EMMANUEL COLLEGE,1,0,2002,NA,NA,322,258,64,179,31,148,0.5700000000000001,0.48,0.56,17800,21,51,215
165671,EMMANUEL COLLEGE,1,0,2003,NA,NA,406,299,107,222,47,175,0.58,0.44,0.55,18900,25,53,270
165671,EMMANUEL COLLEGE,1,0,2004,NA,NA,455,332,123,237,58,179,0.53,0.47,0.52,20100,27,57,288
165671,Emmanuel College,1,0,2005,NA,NA,438,327,111,237,63,174,0.53,0.57,0.54,21900,33,66,318
165671,Emmanuel College,1,0,2006,NA,NA,467,344,123,233,55,178,0.51,0.45,0.5,23800,38,76,368
165671,Emmanuel College,1,0,2007,NA,NA,582,436,146,299,74,225,0.51,0.51,0.51,26100,43,86,421
165671,Emmanuel College,1,0,2008,NA,NA,480,346,134,268,73,195,0.56,0.54,0.56,28200,50,92,344
165671,Emmanuel College,1,0,2009,NA,NA,423,308,115,235,60,175,0.56,0.52,0.56,29200,50,82,322
165671,Emmanuel College,1,0,2010,NA,NA,528,386,142,318,81,237,0.61,0.57,0.6,30600,51,91,326
165820,FITCHBURG STATE COLLEGE,1,0,1991,NA,NA,759,462,297,183,55,128,0.27,0.19,0.24,3134,25,223,706
165820,FITCHBURG STATE COLLEGE,1,0,1992,NA,NA,538,297,241,128,32,96,0.32,0.13,0.24,3206,28,225,463
165820,FITCHBURG STATE COLLEGE,1,0,1993,NA,NA,550,304,246,97,18,79,0.25,0.07,0.18,3234,29,224,499
165820,FITCHBURG STATE COLLEGE,1,0,1995,NA,NA,574,329,245,106,20,86,0.26,0.08,0.18,3316,37,213,468
165820,FITCHBURG STATE COLLEGE,1,0,1996,NA,NA,436,265,171,95,19,76,0.28,0.11,0.22,3246,43,208,360
165820,FITCHBURG STATE COLLEGE,1,0,1997,NA,NA,488,270,218,104,29,75,0.27,0.13,0.21,3346,44,203,310
165820,FITCHBURG STATE COLLEGE,1,0,1998,NA,NA,503,281,222,81,24,57,0.2,0.11,0.16,3198,47,204,369
165820,FITCHBURG STATE COLLEGE,1,0,1999,NA,NA,345,202,143,73,23,50,0.24,0.16,0.21,1090,47,200,295
165820,FITCHBURG STATE COLLEGE,1,0,2000,NA,NA,448,275,173,119,30,89,0.32,0.17,0.27,1030,49,200,383
165820,FITCHBURG STATE COLLEGE,1,0,2001,NA,NA,405,220,185,91,29,62,0.28,0.16,0.22,970,53,201,352
165820,FITCHBURG STATE COLLEGE,1,0,2002,NA,NA,496,292,204,119,41,78,0.26,0.2,0.24,970,50,184,432
165820,FITCHBURG STATE COLLEGE,1,0,2003,NA,NA,585,320,265,144,50,94,0.29,0.19,0.25,970,50,168,516
165820,FITCHBURG STATE COLLEGE,1,0,2004,NA,NA,713,386,327,153,52,101,0.26,0.16,0.21,970,49,166,592
165820,Fitchburg State College,1,0,2005,NA,NA,599,297,302,125,54,71,0.23,0.18,0.21,970,54,166,525
165820,Fitchburg State College,1,0,2006,NA,NA,728,383,345,172,63,109,0.28,0.18,0.24,970,57,174,611
165820,Fitchburg State College,1,0,2007,NA,NA,698,366,332,142,56,86,0.23,0.17,0.2,970,63,176,570
165820,Fitchburg State College,1,0,2008,NA,NA,763,421,342,227,76,151,0.35000000000000003,0.22,0.3,970,68,184,646
165820,Fitchburg State College,1,0,2009,NA,NA,781,410,371,217,89,128,0.31,0.24,0.28,970,67,180,682
165820,Fitchburg State University,1,0,2010,NA,NA,721,413,308,246,86,160,0.38,0.28,0.34,970,68,176,491
165866,FRAMINGHAM STATE COLLEGE,1,0,1991,NA,NA,385,251,134,114,22,92,0.36,0.16,0.3,2889,21,166,347
165866,FRAMINGHAM STATE COLLEGE,1,0,1992,NA,NA,577,382,195,154,35,119,0.31,0.18,0.27,2995,21,169,515
165866,FRAMINGHAM STATE COLLEGE,1,0,1993,NA,NA,517,339,178,117,21,96,0.28,0.12,0.23,3154,24,176,450
165866,FRAMINGHAM STATE COLLEGE,1,0,1995,NA,NA,600,404,196,122,28,94,0.23,0.14,0.2,3308,28,171,500
165866,FRAMINGHAM STATE COLLEGE,1,0,1996,NA,NA,644,429,215,127,26,101,0.23,0.12,0.2,3238,37,168,570
165866,FRAMINGHAM STATE COLLEGE,1,0,1997,NA,NA,590,397,193,120,25,95,0.23,0.13,0.2,3160,39,168,512
165866,FRAMINGHAM STATE COLLEGE,1,0,1998,NA,NA,601,381,220,136,27,109,0.28,0.12,0.23,3070,40,161,514
165866,FRAMINGHAM STATE COLLEGE,1,0,1999,NA,NA,559,402,157,130,27,103,0.25,0.17,0.23,1090,42,164,469
165866,FRAMINGHAM STATE COLLEGE,1,0,2000,NA,NA,612,434,178,153,30,123,0.28,0.17,0.25,1030,45,162,506
165866,FRAMINGHAM STATE COLLEGE,1,0,2001,NA,NA,645,455,190,145,28,117,0.25,0.15,0.22,970,48,161,557
165866,FRAMINGHAM STATE COLLEGE,1,0,2002,NA,NA,716,500,216,193,38,155,0.31,0.18,0.27,970,46,166,622
165866,FRAMINGHAM STATE COLLEGE,1,0,2003,NA,NA,617,441,176,202,45,157,0.35000000000000003,0.26,0.33,970,44,161,526
165866,FRAMINGHAM STATE COLLEGE,1,0,2004,NA,NA,642,434,208,187,49,138,0.31,0.24,0.29,970,45,158,546
165866,Framingham State College,1,0,2005,NA,NA,666,461,205,210,44,166,0.36,0.21,0.32,970,50,167,563
165866,Framingham State College,1,0,2006,NA,NA,714,496,218,242,57,185,0.37,0.26,0.34,970,53,164,583
165866,Framingham State College,1,0,2007,NA,NA,633,420,213,212,52,160,0.38,0.24,0.33,970,61,165,517
165866,Framingham State College,1,0,2008,NA,NA,644,450,194,213,49,164,0.36,0.25,0.33,970,68,166,551
165866,Framingham State College,1,0,2009,NA,NA,719,520,199,261,59,202,0.38,0.3,0.36,970,63,164,609
165866,Framingham State University,1,0,2010,NA,NA,719,481,238,245,59,186,0.38,0.25,0.34,970,70,163,565
165936,GORDON COLLEGE,1,0,1991,NA,NA,282,171,111,122,41,81,0.47000000000000003,0.37,0.43,11400,20,71,236
165936,GORDON COLLEGE,1,0,1992,NA,NA,292,193,99,140,39,101,0.52,0.39,0.48,12090,22,70,253
165936,GORDON COLLEGE,1,0,1993,NA,NA,298,186,112,98,27,71,0.38,0.24,0.33,12720,23,71,270
165936,GORDON COLLEGE,1,0,1995,NA,NA,330,226,104,152,43,109,0.48,0.41,0.46,13950,26,72,303
165936,GORDON COLLEGE,1,0,1996,NA,NA,326,210,116,152,41,111,0.52,0.35,0.47,14690,27,72,301
165936,GORDON COLLEGE,1,0,1997,NA,NA,406,279,127,206,68,138,0.49,0.54,0.51,15150,23,75,381
165936,GORDON COLLEGE,1,0,1998,NA,NA,417,289,128,214,65,149,0.51,0.51,0.51,15760,24,79,391
165936,GORDON COLLEGE,1,0,1999,NA,NA,382,243,139,205,61,144,0.59,0.44,0.54,15740,27,83,356
165936,GORDON COLLEGE,1,0,2000,NA,NA,411,274,137,233,71,162,0.59,0.52,0.57,16550,29,85,389
165936,GORDON COLLEGE,1,0,2001,NA,NA,441,313,128,246,63,183,0.58,0.49,0.56,17378,31,87,407
165936,GORDON COLLEGE,1,0,2002,NA,NA,400,266,134,248,77,171,0.64,0.57,0.62,18230,35,93,353
165936,GORDON COLLEGE,1,0,2003,NA,NA,427,274,153,260,86,174,0.63,0.56,0.61,19334,39,91,382
165936,GORDON COLLEGE,1,0,2004,NA,NA,401,264,137,235,75,160,0.6,0.55,0.59,20494,41,94,343
165936,Gordon College,1,0,2005,NA,NA,414,259,155,254,79,175,0.67,0.51,0.61,21930,43,95,368
165936,Gordon College,1,0,2006,NA,NA,380,250,130,225,71,154,0.61,0.55,0.59,23224,46,97,340
165936,Gordon College,1,0,2007,NA,NA,454,286,168,264,95,169,0.59,0.57,0.58,24652,47,99,392
165936,Gordon College,1,0,2008,NA,NA,419,260,159,256,91,165,0.63,0.57,0.61,26132,51,98,354
165936,Gordon College,1,0,2009,NA,NA,381,237,144,233,71,162,0.68,0.49,0.61,27152,52,94,313
165936,Gordon College,1,0,2010,NA,NA,348,212,136,212,80,132,0.62,0.59,0.61,28210,51,97,276
166027,HARVARD UNIVERSITY,1,0,1991,NA,NA,1601,669,932,1347,759,588,0.87,0.81,0.84,15410,1184,1533,925
166027,HARVARD UNIVERSITY,1,0,1992,NA,NA,1603,686,917,1380,782,598,0.87,0.85,0.86,16454,1262,1498,667
166027,HARVARD UNIVERSITY,1,0,1993,NA,NA,1601,715,886,1358,743,615,0.86,0.84,0.85,17470,1327,1362,669
166027,HARVARD UNIVERSITY,1,0,1995,NA,NA,1606,738,868,1343,705,638,0.86,0.81,0.84,19472,1469,1115,779
166027,HARVARD UNIVERSITY,1,0,1996,NA,NA,1611,721,890,1390,754,636,0.88,0.85,0.86,20424,1520,1129,685
166027,HARVARD UNIVERSITY,1,0,1997,NA,NA,1642,782,860,1436,744,692,0.88,0.87,0.87,21266,1531,1156,629
166027,HARVARD UNIVERSITY,1,0,1998,NA,NA,1650,772,878,1423,748,675,0.87,0.85,0.86,22028,1629,1247,711
166027,HARVARD UNIVERSITY,1,0,1999,NA,NA,1647,775,872,1429,757,672,0.86,0.87,0.87,22054,1784,1272,770
166027,HARVARD UNIVERSITY,1,0,2000,NA,NA,1638,755,883,1431,757,674,0.89,0.86,0.87,22694,1902,1318,731
166027,HARVARD UNIVERSITY,1,0,2001,NA,NA,1637,786,851,1448,742,706,0.89,0.87,0.88,23457,2063,1365,749
166027,HARVARD UNIVERSITY,1,0,2002,NA,NA,1619,783,836,1422,710,712,0.9,0.85,0.88,24630,2286,1387,838
166027,HARVARD UNIVERSITY,1,0,2003,NA,NA,1633,782,851,1433,726,707,0.9,0.85,0.88,26066,2432,1349,803
166027,HARVARD UNIVERSITY,1,0,2004,NA,NA,1638,823,815,1427,688,739,0.89,0.84,0.87,27448,2560,1352,757
166027,Harvard University,1,0,2005,NA,NA,1637,819,818,1421,698,723,0.88,0.85,0.87,28752,2757,1550,776
166027,Harvard University,1,0,2006,NA,NA,1679,878,801,1448,664,784,0.89,0.83,0.86,30275,2999,1560,739
166027,Harvard University,1,0,2007,NA,NA,1657,839,818,1434,695,739,0.88,0.85,0.87,31456,3170,1607,694
166027,Harvard University,1,0,2008,NA,NA,1656,836,820,1420,677,743,0.88,0.83,0.86,32557,3464,1644,741
166027,Harvard University,1,0,2009,NA,NA,1662,837,825,1425,673,752,0.89,0.82,0.86,33696,3756,1661,742
166027,Harvard University,1,0,2010,NA,NA,1663,827,836,1434,708,726,0.87,0.85,0.86,34976,3729,1739,767
166124,COLLEGE OF THE HOLY CROSS,1,0,1991,NA,NA,728,344,384,631,329,302,0.87,0.86,0.87,15530,65,179,653
166124,COLLEGE OF THE HOLY CROSS,1,0,1992,NA,NA,765,428,337,698,308,390,0.91,0.91,0.91,16300,71,186,724
166124,COLLEGE OF THE HOLY CROSS,1,0,1993,NA,NA,658,350,308,598,277,321,0.91,0.9,0.91,17200,75,186,625
166124,COLLEGE OF THE HOLY CROSS,1,0,1995,NA,NA,710,384,326,618,287,331,0.86,0.88,0.87,18900,85,186,612
166124,COLLEGE OF THE HOLY CROSS,1,0,1996,NA,NA,688,349,339,611,287,324,0.92,0.85,0.89,19700,89,190,567
166124,COLLEGE OF THE HOLY CROSS,1,0,1997,NA,NA,726,409,317,635,270,365,0.89,0.85,0.87,21080,71,188,584
166124,COLLEGE OF THE HOLY CROSS,1,0,1998,NA,NA,723,354,369,623,305,318,0.89,0.83,0.86,22005,74,191,561
166124,COLLEGE OF THE HOLY CROSS,1,0,1999,NA,NA,722,383,339,645,298,347,0.9,0.88,0.89,22500,81,195,566
166124,COLLEGE OF THE HOLY CROSS,1,0,2000,NA,NA,706,376,330,626,284,342,0.9,0.86,0.89,23400,88,191,551
166124,COLLEGE OF THE HOLY CROSS,1,0,2001,NA,NA,691,366,325,609,274,335,0.91,0.84,0.88,24600,92,188,533
166124,COLLEGE OF THE HOLY CROSS,1,0,2002,NA,NA,669,348,321,644,300,344,0.98,0.93,0.96,26000,98,197,508
166124,COLLEGE OF THE HOLY CROSS,1,0,2003,NA,NA,698,378,320,607,270,337,0.89,0.84,0.87,27560,104,226,546
166124,COLLEGE OF THE HOLY CROSS,1,0,2004,NA,NA,703,389,314,635,274,361,0.92,0.87,0.9,29220,108,236,524
166124,College of the Holy Cross,1,0,2005,NA,NA,723,399,324,645,281,364,0.91,0.87,0.89,30960,113,234,505
166124,College of the Holy Cross,1,0,2006,NA,NA,751,415,336,675,293,382,0.92,0.87,0.9,32820,120,232,538
166124,College of the Holy Cross,1,0,2007,NA,NA,718,398,320,639,272,367,0.92,0.85,0.89,34630,126,236,460
166124,College of the Holy Cross,1,0,2008,NA,NA,737,420,317,664,285,379,0.9,0.9,0.9,36710,133,257,448
166124,College of the Holy Cross,1,0,2009,NA,NA,746,379,367,666,320,346,0.91,0.87,0.89,38180,142,241,539
166124,College of the Holy Cross,1,0,2010,NA,NA,727,379,348,645,298,347,0.91,0.86,0.89,39330,140,249,464
166513,UNIVERSITY OF MASSACHUSETTS AT LOWELL,1,0,1991,NA,NA,1075,386,689,276,146,130,0.33,0.21,0.26,4337,89,471,902
166513,UNIVERSITY OF MASSACHUSETTS AT LOWELL,1,0,1992,NA,NA,964,340,624,239,134,105,0.3,0.21,0.25,4513,112,462,806
166513,UNIVERSITY OF MASSACHUSETTS-LOWELL,1,0,1993,NA,NA,1033,392,641,217,108,109,0.27,0.17,0.21,4602,118,476,886
166513,UNIVERSITY OF MASSACHUSETTS-LOWELL,1,0,1995,NA,NA,1102,422,680,195,90,105,0.24,0.13,0.18,4606,127,434,874
166513,UNIVERSITY OF MASSACHUSETTS-LOWELL,1,0,1996,NA,NA,1022,428,594,228,96,132,0.3,0.16,0.22,4512,132,406,811
166513,UNIVERSITY OF MASSACHUSETTS-LOWELL,1,0,1997,NA,NA,989,367,622,232,104,128,0.34,0.17,0.23,4422,131,416,768
166513,UNIVERSITY OF MASSACHUSETTS-LOWELL,1,0,1998,NA,NA,997,366,631,235,116,119,0.32,0.18,0.24,4337,142,415,792
166513,UNIVERSITY OF MASSACHUSETTS-LOWELL,1,0,1999,NA,NA,935,368,567,230,91,139,0.37,0.16,0.25,1454,144,411,587
166513,UNIVERSITY OF MASSACHUSETTS-LOWELL,1,0,2000,NA,NA,996,373,623,299,140,159,0.42,0.22,0.3,1454,153,405,670
166513,UNIVERSITY OF MASSACHUSETTS-LOWELL,1,0,2001,NA,NA,967,349,618,269,128,141,0.4,0.21,0.28,1454,165,399,568
166513,UNIVERSITY OF MASSACHUSETTS-LOWELL,1,0,2002,NA,NA,1013,371,642,289,138,151,0.4,0.21,0.29,1454,155,359,716
166513,UNIVERSITY OF MASSACHUSETTS-LOWELL,1,0,2003,NA,NA,1008,393,615,291,145,146,0.37,0.24,0.29,1454,156,361,842
166513,UNIVERSITY OF MASSACHUSETTS-LOWELL,1,0,2004,NA,NA,996,333,663,286,134,152,0.45,0.2,0.29,1454,162,361,791
166513,University of Massachusetts-Lowell,1,0,2005,NA,NA,1062,390,672,318,160,158,0.4,0.24,0.3,1454,194,383,840
166513,University of Massachusetts-Lowell,1,0,2006,NA,NA,1208,451,757,355,190,165,0.36,0.25,0.29,1454,208,405,908
166513,University of Massachusetts-Lowell,1,0,2007,NA,NA,1220,424,796,346,179,167,0.39,0.22,0.28,1454,220,406,971
166513,University of Massachusetts-Lowell,1,0,2008,NA,NA,1514,540,974,411,213,198,0.36,0.22,0.27,1454,231,414,1139
166513,University of Massachusetts-Lowell,1,0,2009,NA,NA,1499,548,951,465,243,222,0.4,0.26,0.31,1454,231,402,1102
166513,University of Massachusetts-Lowell,1,0,2010,NA,NA,1601,575,1026,514,272,242,0.42,0.27,0.32,1454,249,434,1196
166629,UNIVERSITY OF MASSACHUSETTS AT AMHERST,1,0,1991,NA,NA,3435,1665,1770,1271,511,760,0.45,0.29,0.37,4863,405,1138,2863
166629,UNIVERSITY OF MASSACHUSETTS AT AMHERST,1,0,1992,NA,NA,3993,1940,2053,1329,538,791,0.4,0.26,0.33,5062,395,1152,3239
166629,UNIVERSITY OF MASSACHUSETTS-AMHERST,1,0,1993,NA,NA,3926,1908,2018,1436,577,859,0.45,0.29,0.37,5467,442,1172,3187
166629,UNIVERSITY OF MASSACHUSETTS-AMHERST,1,0,1995,NA,NA,3959,1946,2013,1429,583,846,0.43,0.29,0.36,5514,487,1146,3166
166629,UNIVERSITY OF MASSACHUSETTS-AMHERST,1,0,1996,NA,NA,4073,1964,2109,1577,660,917,0.46,0.31,0.39,5413,501,1164,2951
166629,UNIVERSITY OF MASSACHUSETTS-AMHERST,1,0,1997,NA,NA,3831,2012,1819,1635,614,1021,0.5,0.34,0.43,5329,543,1154,2729
166629,UNIVERSITY OF MASSACHUSETTS-AMHERST,1,0,1998,NA,NA,3953,2021,1932,1651,625,1026,0.5,0.32,0.42,5229,574,1140,2840
166629,UNIVERSITY OF MASSACHUSETTS-AMHERST,1,0,1999,NA,NA,4144,2199,1945,1824,701,1123,0.51,0.36,0.44,1714,569,1161,3065
166629,UNIVERSITY OF MASSACHUSETTS-AMHERST,1,0,2000,NA,NA,3803,2086,1717,1768,667,1101,0.52,0.39,0.46,1714,598,1156,2933
166629,UNIVERSITY OF MASSACHUSETTS-AMHERST,1,0,2001,NA,NA,4289,2298,1991,2046,783,1263,0.54,0.39,0.48,1714,615,1151,3316
166629,UNIVERSITY OF MASSACHUSETTS-AMHERST,1,0,2002,NA,NA,3411,1799,1612,1682,707,975,0.54,0.44,0.49,1714,578,1063,2678
166629,UNIVERSITY OF MASSACHUSETTS-AMHERST,1,0,2003,NA,NA,4149,2060,2089,1958,850,1108,0.53,0.41,0.47,1714,573,1078,3237
166629,UNIVERSITY OF MASSACHUSETTS-AMHERST,1,0,2004,NA,NA,4311,2126,2185,2196,968,1228,0.5700000000000001,0.44,0.51,1714,602,1100,3325
166629,University of Massachusetts-Amherst,1,0,2005,NA,NA,4510,2316,2194,2268,970,1298,0.56,0.44,0.5,1714,691,1148,3541
166629,University of Massachusetts-Amherst,1,0,2006,NA,NA,4265,2174,2091,2259,1002,1257,0.5700000000000001,0.48,0.53,1714,730,1168,3116
166629,University of Massachusetts Amherst,1,0,2007,NA,NA,4374,2321,2053,2504,1060,1444,0.62,0.52,0.57,1714,763,1175,3165
166629,University of Massachusetts Amherst,1,0,2008,NA,NA,4256,2200,2056,2594,1140,1454,0.66,0.55,0.61,1714,799,1180,2869
166629,University of Massachusetts Amherst,1,0,2009,NA,NA,4215,2175,2040,2703,1192,1511,0.6900000000000001,0.58,0.64,1714,807,1180,2653
166629,University of Massachusetts Amherst,1,0,2010,NA,NA,4543,2296,2247,2986,1336,1650,0.71,0.59,0.66,1714,820,1173,2958
166638,UNIVERSITY OF MASSACHUSETTS AT BOSTON,1,0,1991,NA,NA,529,270,259,68,27,41,0.15,0.1,0.13,3937,108,445,296
166638,UNIVERSITY OF MASSACHUSETTS AT BOSTON,1,0,1992,NA,NA,534,256,278,48,18,30,0.11,0.06,0.09,4094,108,457,280
166638,UNIVERSITY OF MASSACHUSETTS-BOSTON,1,0,1993,NA,NA,546,253,293,44,15,29,0.11,0.05,0.08,4253,126,473,275
166638,UNIVERSITY OF MASSACHUSETTS-BOSTON,1,0,1995,NA,NA,502,222,280,38,17,21,0.09,0.06,0.08,4405,135,464,229
166638,UNIVERSITY OF MASSACHUSETTS-BOSTON,1,0,1996,NA,NA,538,274,264,55,14,41,0.14,0.05,0.1,4348,141,449,260
166638,UNIVERSITY OF MASSACHUSETTS-BOSTON,1,0,1997,NA,NA,533,284,249,65,25,40,0.14,0.1,0.12,4290,147,452,232
166638,UNIVERSITY OF MASSACHUSETTS-BOSTON,1,0,1998,NA,NA,579,307,272,69,29,40,0.13,0.11,0.12,4197,153,448,256
166638,UNIVERSITY OF MASSACHUSETTS-BOSTON,1,0,1999,NA,NA,671,368,303,102,33,69,0.18,0.11,0.15,1714,158,456,287
166638,UNIVERSITY OF MASSACHUSETTS-BOSTON,1,0,2000,NA,NA,593,326,267,91,14,77,0.23,0.05,0.15,1714,169,462,271
166638,UNIVERSITY OF MASSACHUSETTS-BOSTON,1,0,2001,NA,NA,676,359,317,67,22,45,0.12,0.07,0.1,1714,184,468,277
166638,UNIVERSITY OF MASSACHUSETTS-BOSTON,1,0,2002,NA,NA,534,307,227,64,16,48,0.15,0.07,0.12,1714,188,427,218
166638,UNIVERSITY OF MASSACHUSETTS-BOSTON,1,0,2003,NA,NA,602,353,249,60,21,39,0.11,0.08,0.1,1714,192,433,260
166638,UNIVERSITY OF MASSACHUSETTS-BOSTON,1,0,2004,NA,NA,543,323,220,61,12,49,0.15,0.05,0.11,1714,200,435,216
166638,University of Massachusetts-Boston,1,0,2005,NA,NA,723,419,304,100,34,66,0.15,0.11,0.14,1714,227,445,328
166638,University of Massachusetts-Boston,1,0,2006,NA,NA,846,484,362,109,29,80,0.16,0.08,0.13,1714,244,435,388
166638,University of Massachusetts-Boston,1,0,2007,NA,NA,950,558,392,144,42,102,0.18,0.11,0.15,1714,257,444,419
166638,University of Massachusetts-Boston,1,0,2008,NA,NA,972,570,402,154,60,94,0.16,0.15,0.16,1714,267,462,441
166638,University of Massachusetts-Boston,1,0,2009,NA,NA,934,545,389,154,53,101,0.18,0.14,0.16,1714,269,499,429
166638,University of Massachusetts-Boston,1,0,2010,NA,NA,1067,595,472,194,55,139,0.23,0.12,0.18,1714,277,525,459
166683,MASSACHUSETTS INSTITUTE OF TECHNOLOGY,1,0,1991,NA,NA,1048,367,681,825,516,309,0.84,0.76,0.79,16900,1089,986,511
166683,MASSACHUSETTS INSTITUTE OF TECHNOLOGY,1,0,1992,NA,NA,1137,398,739,919,583,336,0.84,0.79,0.81,18000,1092,989,549
166683,MASSACHUSETTS INSTITUTE OF TECHNOLOGY,1,0,1993,NA,NA,1074,366,708,874,546,328,0.89,0.77,0.81,19000,1132,989,492
166683,MASSACHUSETTS INSTITUTE OF TECHNOLOGY,1,0,1995,NA,NA,1115,468,647,921,517,404,0.86,0.8,0.83,21000,1167,981,546
166683,MASSACHUSETTS INSTITUTE OF TECHNOLOGY,1,0,1996,NA,NA,1065,446,619,875,498,377,0.84,0.8,0.82,22000,1223,906,359
166683,MASSACHUSETTS INSTITUTE OF TECHNOLOGY,1,0,1997,NA,NA,1066,405,661,861,521,340,0.8300000000000001,0.79,0.81,23100,1186,942,370
166683,MASSACHUSETTS INSTITUTE OF TECHNOLOGY,1,0,1998,NA,NA,1042,446,596,840,466,374,0.8300000000000001,0.78,0.81,24050,0,958,364
166683,MASSACHUSETTS INSTITUTE OF TECHNOLOGY,1,0,1999,NA,NA,1049,448,601,863,473,390,0.87,0.79,0.82,25000,1287,951,369
166683,MASSACHUSETTS INSTITUTE OF TECHNOLOGY,1,0,2000,NA,NA,1010,425,585,825,468,357,0.84,0.8,0.82,26050,1289,964,347
166683,MASSACHUSETTS INSTITUTE OF TECHNOLOGY,1,0,2001,NA,NA,1027,426,601,857,479,378,0.88,0.8,0.83,26960,1385,977,383
166683,MASSACHUSETTS INSTITUTE OF TECHNOLOGY,1,0,2002,NA,NA,977,420,557,806,446,360,0.85,0.8,0.82,28030,1535,1044,340
166683,MASSACHUSETTS INSTITUTE OF TECHNOLOGY,1,0,2003,NA,NA,1018,459,559,842,450,392,0.85,0.81,0.83,29400,1686,1043,368
166683,MASSACHUSETTS INSTITUTE OF TECHNOLOGY,1,0,2004,NA,NA,1076,457,619,909,507,402,0.87,0.82,0.84,30600,1839,1055,388
166683,Massachusetts Institute of Technology,1,0,2005,NA,NA,995,465,530,847,436,411,0.88,0.82,0.85,32100,2035,1117,393
166683,Massachusetts Institute of Technology,1,0,2006,NA,NA,1001,447,554,837,457,380,0.85,0.82,0.84,33400,2181,1202,373
166683,Massachusetts Institute of Technology,1,0,2007,NA,NA,1068,492,576,892,463,429,0.87,0.8,0.84,34750,2207,1200,412
166683,Massachusetts Institute of Technology,1,0,2008,NA,NA,1046,487,559,849,441,408,0.8300000000000001,0.79,0.81,36140,2301,1215,359
166683,Massachusetts Institute of Technology,1,0,2009,NA,NA,1066,477,589,874,462,412,0.86,0.78,0.82,37510,2461,1200,390
166683,Massachusetts Institute of Technology,1,0,2010,NA,NA,1063,479,584,898,478,420,0.87,0.82,0.84,38940,2382,1189,416
167288,NORTH ADAMS STATE COLLEGE,1,0,1991,NA,NA,423,211,212,81,26,55,0.26,0.12,0.19,3218,16,98,397
167288,NORTH ADAMS STATE COLLEGE,1,0,1992,NA,NA,203,105,98,49,18,31,0.29,0.18,0.24,3345,18,90,187
167288,NORTH ADAMS STATE COLLEGE,1,0,1993,NA,NA,228,107,121,39,11,28,0.26,0.09,0.17,3493,17,91,205
167288,NORTH ADAMS STATE COLLEGE,1,0,1995,NA,NA,290,171,119,80,15,65,0.38,0.13,0.28,3555,19,95,272
167288,NORTH ADAMS STATE COLLEGE,1,0,1996,NA,NA,311,176,135,101,35,66,0.37,0.26,0.32,3485,22,88,283
167288,MASSACHUSETTS COLLEGE OF LIBERAL ARTS,1,0,1997,NA,NA,274,152,122,89,30,59,0.38,0.25,0.32,3437,24,90,241
167288,MASSACHUSETTS COLLEGE OF LIBERAL ARTS,1,0,1998,NA,NA,209,131,78,66,17,49,0.37,0.22,0.32,3377,25,84,172
167288,MASSACHUSETTS COLLEGE OF LIBERAL ARTS,1,0,1999,NA,NA,220,135,85,78,27,51,0.37,0.32,0.35,1090,25,84,181
167288,MASSACHUSETTS COLLEGE OF LIBERAL ARTS,1,0,2000,NA,NA,224,126,98,80,32,48,0.38,0.33,0.36,1090,26,85,202
167288,MASSACHUSETTS COLLEGE OF LIBERAL ARTS,1,0,2001,NA,NA,268,171,97,85,26,59,0.34,0.27,0.32,1030,27,86,232
167288,MASSACHUSETTS COLLEGE OF LIBERAL ARTS,1,0,2002,NA,NA,265,159,106,106,38,68,0.42,0.36,0.4,1030,27,80,240
167288,MASSACHUSETTS COLLEGE OF LIBERAL ARTS,1,0,2003,NA,NA,244,149,95,91,28,63,0.42,0.29,0.37,1030,26,80,221
167288,MASSACHUSETTS COLLEGE OF LIBERAL ARTS,1,0,2004,NA,NA,263,161,102,99,28,71,0.44,0.27,0.38,1030,27,76,231
167288,Massachusetts College of Liberal Arts,1,0,2005,NA,NA,271,177,94,104,36,68,0.38,0.38,0.38,1030,30,85,238
167288,Massachusetts College of Liberal Arts,1,0,2006,NA,NA,299,175,124,94,33,61,0.34,0.27,0.31,1030,33,87,246
167288,Massachusetts College of Liberal Arts,1,0,2007,NA,NA,334,207,127,128,37,91,0.43,0.29,0.38,1030,36,84,285
167288,Massachusetts College of Liberal Arts,1,0,2008,NA,NA,325,193,132,109,38,71,0.36,0.29,0.34,1030,38,90,265
167288,Massachusetts College of Liberal Arts,1,0,2009,NA,NA,347,229,118,119,40,79,0.34,0.34,0.34,1030,37,84,265
167288,Massachusetts College of Liberal Arts,1,0,2010,NA,NA,351,225,126,133,41,92,0.4,0.33,0.38,1030,38,89,249
167987,UNIVERSITY OF MASSACHUSETTS AT DARTMOUTH,1,0,1991,NA,NA,989,515,474,285,109,176,0.34,0.23,0.29,3053,62,313,878
167987,UNIVERSITY OF MASSACHUSETTS DARTMOUTH,1,0,1992,NA,NA,869,453,416,223,75,148,0.32,0.18,0.26,3163,61,315,800
167987,UNIVERSITY OF MASSACHUSETTS-DARTMOUTH,1,0,1993,NA,NA,985,489,496,234,87,147,0.3,0.18,0.24,3568,63,330,853
167987,UNIVERSITY OF MASSACHUSETTS-DARTMOUTH,1,0,1995,NA,NA,886,420,466,253,90,163,0.38,0.19,0.29,4122,80,333,709
167987,UNIVERSITY OF MASSACHUSETTS-DARTMOUTH,1,0,1996,NA,NA,825,429,396,240,71,169,0.39,0.18,0.29,4151,85,326,619
167987,UNIVERSITY OF MASSACHUSETTS-DARTMOUTH,1,0,1997,NA,NA,835,440,395,217,72,145,0.32,0.18,0.26,4254,85,317,638
167987,UNIVERSITY OF MASSACHUSETTS-DARTMOUTH,1,0,1998,NA,NA,1086,535,551,284,102,182,0.34,0.19,0.26,4171,94,334,853
167987,UNIVERSITY OF MASSACHUSETTS-DARTMOUTH,1,0,1999,NA,NA,1131,556,575,316,126,190,0.34,0.22,0.28,1417,101,340,891
167987,UNIVERSITY OF MASSACHUSETTS-DARTMOUTH,1,0,2000,NA,NA,1300,642,658,363,142,221,0.34,0.22,0.28,1417,108,347,1040
167987,UNIVERSITY OF MASSACHUSETTS-DARTMOUTH,1,0,2001,NA,NA,1148,575,573,310,125,185,0.32,0.22,0.27,1417,129,355,924
167987,UNIVERSITY OF MASSACHUSETTS-DARTMOUTH,1,0,2002,NA,NA,1699,825,874,452,191,261,0.31,0.22,0.27,1417,131,321,1351
167987,UNIVERSITY OF MASSACHUSETTS-DARTMOUTH,1,0,2003,NA,NA,1510,764,746,489,187,302,0.39,0.25,0.32,1417,122,329,1215
167987,UNIVERSITY OF MASSACHUSETTS-DARTMOUTH,1,0,2004,NA,NA,1456,715,741,416,147,269,0.37,0.2,0.29,1417,137,340,1173
167987,University of Massachusetts-Dartmouth,1,0,2005,NA,NA,1703,816,887,505,212,293,0.35000000000000003,0.24,0.3,1417,160,355,1394
167987,University of Massachusetts-Dartmouth,1,0,2006,NA,NA,1763,866,897,559,248,311,0.35000000000000003,0.28,0.32,1417,173,359,1460
167987,University of Massachusetts-Dartmouth,1,0,2007,NA,NA,1901,859,1042,575,262,313,0.36,0.25,0.3,1417,192,365,1590
167987,University of Massachusetts-Dartmouth,1,0,2008,NA,NA,1768,837,931,485,210,275,0.32,0.23,0.27,1417,204,368,1447
167987,University of Massachusetts-Dartmouth,1,0,2009,NA,NA,1780,822,958,494,212,282,0.34,0.22,0.28,1417,195,369,1400
167987,University of Massachusetts-Dartmouth,1,0,2010,NA,NA,1667,765,902,471,208,263,0.34,0.23,0.28,1417,200,375,1085
167996,STONEHILL COLLEGE,1,0,1991,NA,NA,518,279,239,359,160,199,0.71,0.67,0.69,10240,25,109,494
167996,STONEHILL COLLEGE,1,0,1992,NA,NA,514,314,200,387,135,252,0.8,0.68,0.75,10820,35,112,494
167996,STONEHILL COLLEGE,1,0,1993,NA,NA,585,331,254,411,159,252,0.76,0.63,0.7,11420,35,116,552
167996,STONEHILL COLLEGE,1,0,1995,NA,NA,547,328,219,443,166,277,0.84,0.76,0.81,13284,40,118,499
167996,STONEHILL COLLEGE,1,0,1996,NA,NA,551,310,241,419,169,250,0.8,0.7,0.76,14170,37,118,509
167996,STONEHILL COLLEGE,1,0,1997,NA,NA,530,287,243,429,185,244,0.85,0.76,0.81,14856,44,119,486
167996,STONEHILL COLLEGE,1,0,1998,NA,NA,531,313,218,421,168,253,0.8,0.77,0.79,15730,37,122,495
167996,STONEHILL COLLEGE,1,0,1999,NA,NA,572,333,239,458,185,273,0.81,0.77,0.8,15736,40,123,522
167996,STONEHILL COLLEGE,1,0,2000,NA,NA,629,363,266,517,210,307,0.84,0.79,0.82,16680,42,125,582
167996,STONEHILL COLLEGE,1,0,2001,NA,NA,586,328,258,479,203,276,0.84,0.79,0.82,17680,45,127,522
167996,STONEHILL COLLEGE,1,0,2002,NA,NA,566,342,224,448,160,288,0.84,0.71,0.79,19094,47,125,517
167996,STONEHILL COLLEGE,1,0,2003,NA,NA,565,307,258,451,193,258,0.84,0.75,0.8,20432,52,130,496
167996,STONEHILL COLLEGE,1,0,2004,NA,NA,614,384,230,494,171,323,0.84,0.74,0.8,22068,56,133,554
167996,Stonehill College,1,0,2005,NA,NA,616,354,262,478,190,288,0.81,0.73,0.78,24160,59,136,557
167996,Stonehill College,1,0,2006,NA,NA,594,363,231,469,173,296,0.81,0.75,0.79,26345,64,135,542
167996,Stonehill College,1,0,2007,NA,NA,659,409,250,539,199,340,0.8300000000000001,0.8,0.82,28065,66,145,615
167996,Stonehill College,1,0,2008,NA,NA,634,384,250,503,185,318,0.8200000000000001,0.74,0.79,30150,72,148,570
167996,Stonehill College,1,0,2009,NA,NA,683,397,286,564,219,345,0.86,0.77,0.83,31210,76,152,611
167996,Stonehill College,1,0,2010,NA,NA,727,469,258,556,180,376,0.8,0.7,0.76,32620,79,155,629
168005,SUFFOLK UNIVERSITY,1,0,1991,NA,NA,421,214,207,137,55,82,0.38,0.27,0.33,8535,50,214,299
168005,SUFFOLK UNIVERSITY,1,0,1992,NA,NA,382,190,192,113,43,70,0.36,0.22,0.3,9150,54,226,274
168005,SUFFOLK UNIVERSITY,1,0,1993,NA,NA,357,185,172,114,43,71,0.38,0.25,0.32,9940,60,232,207
168005,SUFFOLK UNIVERSITY,1,0,1995,NA,NA,386,214,172,110,39,71,0.33,0.23,0.28,11450,71,233,231
168005,SUFFOLK UNIVERSITY,1,0,1996,NA,NA,507,288,219,140,46,94,0.32,0.21,0.28,12200,75,246,314
168005,SUFFOLK UNIVERSITY,1,0,1997,NA,NA,525,299,226,198,70,128,0.42,0.31,0.38,12900,73,249,340
168005,SUFFOLK UNIVERSITY,1,0,1998,NA,NA,620,355,265,208,75,133,0.37,0.28,0.34,13740,79,258,385
168005,SUFFOLK UNIVERSITY,1,0,1999,NA,NA,672,381,291,240,72,168,0.44,0.25,0.36,14580,87,264,423
168005,SUFFOLK UNIVERSITY,1,0,2000,NA,NA,645,371,274,243,87,156,0.42,0.32,0.38,15538,98,277,417
168005,SUFFOLK UNIVERSITY,1,0,2001,NA,NA,710,393,317,285,116,169,0.43,0.37,0.4,16536,107,290,433
168005,SUFFOLK UNIVERSITY,1,0,2002,NA,NA,787,481,306,307,88,219,0.45,0.29,0.39,17610,118,295,497
168005,SUFFOLK UNIVERSITY,1,0,2003,NA,NA,914,542,372,320,117,203,0.37,0.31,0.35,18670,126,317,614
168005,SUFFOLK UNIVERSITY,1,0,2004,NA,NA,1014,589,425,350,123,227,0.38,0.29,0.35,19790,141,321,643
168005,Suffolk University,1,0,2005,NA,NA,1127,682,445,416,143,273,0.4,0.32,0.37,21140,173,339,768
168005,Suffolk University,1,0,2006,NA,NA,1286,735,551,520,197,323,0.43,0.36,0.4,22610,175,355,861
168005,Suffolk University,1,0,2007,NA,NA,1308,752,556,531,218,313,0.41000000000000003,0.39,0.41,24190,191,388,821
168005,Suffolk University,1,0,2008,NA,NA,1557,920,637,607,215,392,0.42,0.34,0.39,25850,215,400,884
168005,Suffolk University,1,0,2009,NA,NA,1257,736,521,510,182,328,0.44,0.35,0.41,27100,226,396,588
168005,Suffolk University,1,0,2010,NA,NA,1307,739,568,582,221,361,0.48,0.39,0.45,28414,230,387,727
168148,TUFTS UNIVERSITY,1,0,1991,NA,NA,1155,640,515,870,378,492,0.76,0.73,0.75,16755,252,418,729
168148,TUFTS UNIVERSITY,1,0,1992,NA,NA,1211,638,573,921,426,495,0.77,0.74,0.76,17897,266,421,782
168148,TUFTS UNIVERSITY,1,0,1993,NA,NA,1193,632,561,923,422,501,0.79,0.75,0.77,18793,283,427,750
168148,TUFTS UNIVERSITY,1,0,1995,NA,NA,1147,594,553,944,439,505,0.85,0.79,0.82,21086,318,517,650
168148,TUFTS UNIVERSITY,1,0,1996,NA,NA,1179,597,582,950,452,498,0.8300000000000001,0.78,0.81,21957,333,526,639
168148,TUFTS UNIVERSITY,1,0,1997,NA,NA,1270,659,611,1063,498,565,0.85,0.82,0.84,22811,304,479,695
168148,TUFTS UNIVERSITY,1,0,1998,NA,NA,1236,668,568,1040,466,574,0.85,0.82,0.84,23709,322,480,684
168148,TUFTS UNIVERSITY,1,0,1999,NA,NA,1345,741,604,1134,497,637,0.85,0.82,0.84,24126,345,529,758
168148,TUFTS UNIVERSITY,1,0,2000,NA,NA,1181,637,544,1022,464,558,0.87,0.85,0.87,25062,359,533,618
168148,TUFTS UNIVERSITY,1,0,2001,NA,NA,1163,640,523,970,426,544,0.85,0.81,0.83,26213,389,538,601
168148,TUFTS UNIVERSITY,1,0,2002,NA,NA,1276,736,540,1094,455,639,0.86,0.84,0.86,27450,411,564,676
168148,TUFTS UNIVERSITY,1,0,2003,NA,NA,1281,664,617,1087,507,580,0.87,0.82,0.85,28896,448,579,696
168148,TUFTS UNIVERSITY,1,0,2004,NA,NA,1273,635,638,1101,537,564,0.88,0.84,0.86,30377,477,584,748
168148,Tufts University,1,0,2005,NA,NA,1364,682,682,1159,559,600,0.87,0.82,0.85,31828,503,615,806
168148,Tufts University,1,0,2006,NA,NA,1280,648,632,1120,543,577,0.89,0.86,0.88,33906,538,626,779
168148,Tufts University,1,0,2007,NA,NA,1370,703,667,1194,570,624,0.88,0.85,0.87,35842,579,629,791
168148,Tufts University,1,0,2008,NA,NA,1298,702,596,1141,511,630,0.89,0.86,0.88,37952,614,623,758
168148,Tufts University,1,0,2009,NA,NA,1302,669,633,1141,542,599,0.89,0.86,0.88,39432,656,636,789
168148,Tufts University,1,0,2010,NA,NA,1313,649,664,1138,560,578,0.89,0.84,0.87,40664,670,658,772
168254,WESTERN NEW ENGLAND COLLEGE,1,0,1991,NA,NA,428,166,262,165,81,84,0.5,0.31,0.39,7962,37,144,404
168254,WESTERN NEW ENGLAND COLLEGE,1,0,1992,NA,NA,431,182,249,145,82,63,0.34,0.33,0.34,8426,37,135,395
168254,WESTERN NEW ENGLAND COLLEGE,1,0,1993,NA,NA,392,149,243,120,64,56,0.37,0.26,0.31,9314,37,137,356
168254,WESTERN NEW ENGLAND COLLEGE,1,0,1995,NA,NA,580,222,358,223,116,107,0.48,0.32,0.38,10310,38,138,484
168254,WESTERN NEW ENGLAND COLLEGE,1,0,1996,NA,NA,478,174,304,173,104,69,0.39,0.34,0.36,10810,43,134,391
168254,WESTERN NEW ENGLAND COLLEGE,1,0,1997,NA,NA,526,220,306,210,98,112,0.5,0.32,0.4,11448,40,134,418
168254,WESTERN NEW ENGLAND COLLEGE,1,0,1998,NA,NA,535,238,297,231,119,112,0.47000000000000003,0.4,0.43,12130,42,136,456
168254,WESTERN NEW ENGLAND COLLEGE,1,0,1999,NA,NA,618,271,347,268,145,123,0.45,0.42,0.43,11954,46,139,568
168254,WESTERN NEW ENGLAND COLLEGE,1,0,2000,NA,NA,560,262,298,268,140,128,0.48,0.47,0.48,14354,48,146,498
168254,WESTERN NEW ENGLAND COLLEGE,1,0,2001,NA,NA,654,287,367,346,176,170,0.59,0.48,0.53,14567,51,154,562
168254,WESTERN NEW ENGLAND COLLEGE,1,0,2002,NA,NA,682,301,381,298,151,147,0.48,0.4,0.44,16144,55,154,586
168254,WESTERN NEW ENGLAND COLLEGE,1,0,2003,NA,NA,672,279,393,275,148,127,0.45,0.38,0.41,19460,58,157,583
168254,WESTERN NEW ENGLAND COLLEGE,1,0,2004,NA,NA,798,302,496,353,197,156,0.51,0.4,0.44,20570,65,159,700
168254,Western New England College,1,0,2005,NA,NA,662,244,418,341,188,153,0.62,0.45,0.52,21600,68,164,575
168254,Western New England College,1,0,2006,NA,NA,719,259,460,367,211,156,0.6,0.46,0.51,22982,74,169,645
168254,Western New England College,1,0,2007,NA,NA,713,293,420,372,193,179,0.61,0.46,0.52,24224,75,177,628
168254,Western New England College,1,0,2008,NA,NA,735,281,454,370,206,164,0.58,0.45,0.5,25556,79,180,642
168254,Western New England College,1,0,2009,NA,NA,683,257,426,322,187,135,0.52,0.44,0.47,26822,83,188,558
168254,Western New England University,1,0,2010,NA,NA,736,303,433,373,213,160,0.52,0.49,0.51,27762,86,194,589
168281,WHEATON COLLEGE,1,0,1991,NA,NA,319,210,109,222,62,160,0.76,0.57,0.7,15650,30,89,269
168281,WHEATON COLLEGE,1,0,1992,NA,NA,412,274,138,265,87,178,0.64,0.63,0.64,16650,33,93,349
168281,WHEATON COLLEGE,1,0,1993,NA,NA,417,300,117,263,71,192,0.64,0.61,0.63,17670,35,91,341
168281,WHEATON COLLEGE,1,0,1995,NA,NA,359,249,110,241,72,169,0.67,0.65,0.67,19020,38,93,312
168281,WHEATON COLLEGE,1,0,1996,NA,NA,445,315,130,295,82,213,0.67,0.63,0.66,19740,40,92,369
168281,WHEATON COLLEGE,1,0,1997,NA,NA,438,277,161,298,97,201,0.72,0.6,0.68,20820,34,93,364
168281,WHEATON COLLEGE,1,0,1998,NA,NA,435,294,141,291,79,212,0.72,0.56,0.67,21840,38,93,347
168281,WHEATON COLLEGE,1,0,1999,NA,NA,427,281,146,298,85,213,0.75,0.58,0.7,22950,40,96,351
168281,WHEATON COLLEGE,1,0,2000,NA,NA,450,286,164,318,104,214,0.74,0.63,0.71,24225,42,108,378
168281,WHEATON COLLEGE,1,0,2001,NA,NA,494,328,166,364,114,250,0.76,0.69,0.74,25565,47,120,397
168281,WHEATON COLLEGE,1,0,2002,NA,NA,411,255,156,316,106,210,0.8200000000000001,0.68,0.77,27105,52,122,335
168281,WHEATON COLLEGE,1,0,2003,NA,NA,445,286,159,324,104,220,0.76,0.65,0.73,28675,53,121,338
168281,WHEATON COLLEGE,1,0,2004,NA,NA,443,280,163,310,114,196,0.7000000000000001,0.7,0.7,30355,57,126,343
168281,Wheaton College,1,0,2005,NA,NA,467,301,166,341,119,222,0.73,0.72,0.73,32115,60,129,371
168281,Wheaton College,1,0,2006,NA,NA,410,239,171,317,125,192,0.8,0.73,0.77,34365,64,127,332
168281,Wheaton College,1,0,2007,NA,NA,418,262,156,297,98,199,0.75,0.63,0.71,36430,66,141,301
168281,Wheaton College,1,0,2008,NA,NA,420,259,161,313,116,197,0.76,0.72,0.75,38585,71,144,319
168281,Wheaton College,1,0,2009,NA,NA,423,261,162,322,118,204,0.78,0.73,0.76,39565,72,145,296
168281,Wheaton College,1,0,2010,NA,NA,450,306,144,342,103,239,0.78,0.72,0.76,40790,71,148,301
168342,WILLIAMS COLLEGE,1,0,1991,NA,NA,517,246,271,467,238,229,0.93,0.88,0.9,16785,72,218,365
168342,WILLIAMS COLLEGE,1,0,1992,NA,NA,518,258,260,454,225,229,0.88,0.87,0.88,17840,72,213,377
168342,WILLIAMS COLLEGE,1,0,1993,NA,NA,527,269,258,467,222,245,0.91,0.86,0.89,18795,75,213,376
168342,WILLIAMS COLLEGE,1,0,1995,NA,NA,524,243,281,453,237,216,0.88,0.84,0.86,20790,80,211,383
168342,WILLIAMS COLLEGE,1,0,1996,NA,NA,553,276,277,507,248,259,0.93,0.9,0.92,21910,92,215,410
168342,WILLIAMS COLLEGE,1,0,1997,NA,NA,544,266,278,499,253,246,0.92,0.91,0.92,23050,83,212,386
168342,WILLIAMS COLLEGE,1,0,1998,NA,NA,537,265,272,492,252,240,0.9,0.93,0.92,23860,87,217,386
168342,WILLIAMS COLLEGE,1,0,1999,NA,NA,544,264,280,487,244,243,0.92,0.87,0.9,24619,94,219,384
168342,WILLIAMS COLLEGE,1,0,2000,NA,NA,528,260,268,483,240,243,0.93,0.9,0.91,24619,99,220,387
168342,WILLIAMS COLLEGE,1,0,2001,NA,NA,520,257,263,475,236,239,0.93,0.9,0.91,25352,113,221,372
168342,WILLIAMS COLLEGE,1,0,2002,NA,NA,539,291,248,492,226,266,0.91,0.91,0.91,26326,116,271,360
168342,WILLIAMS COLLEGE,1,0,2003,NA,NA,533,272,261,497,245,252,0.92,0.94,0.93,27890,126,247,344
168342,WILLIAMS COLLEGE,1,0,2004,NA,NA,532,272,260,484,234,250,0.91,0.9,0.91,29786,135,247,349
168342,Williams College,1,0,2005,NA,NA,536,280,256,477,226,251,0.89,0.88,0.89,31548,144,275,343
168342,Williams College,1,0,2006,NA,NA,533,280,253,484,223,261,0.93,0.88,0.91,33478,157,285,342
168342,Williams College,1,0,2007,NA,NA,539,258,281,483,248,235,0.91,0.88,0.9,35438,166,270,336
168342,Williams College,1,0,2008,NA,NA,538,284,254,476,222,254,0.89,0.87,0.88,37400,181,278,316
168342,Williams College,1,0,2009,NA,NA,545,293,252,481,216,265,0.9,0.86,0.88,39250,203,275,330
168342,Williams College,1,0,2010,NA,NA,548,288,260,471,215,256,0.88,0.83,0.86,41190,175,275,324
168546,ALBION COLLEGE,1,0,1991,NA,NA,548,266,282,349,179,170,0.63,0.63,0.64,11064,30,111,504
168546,ALBION COLLEGE,1,0,1992,NA,NA,508,242,266,330,173,157,0.64,0.65,0.65,12294,32,112,470
168546,ALBION COLLEGE,1,0,1993,NA,NA,488,251,237,270,145,125,0.49,0.61,0.55,13676,36,109,411
168546,ALBION COLLEGE,1,0,1995,NA,NA,473,238,235,334,150,184,0.77,0.64,0.71,15478,41,104,400
168546,ALBION COLLEGE,1,0,1996,NA,NA,433,227,206,278,120,158,0.6900000000000001,0.58,0.64,16160,40,105,358
168546,ALBION COLLEGE,1,0,1997,NA,NA,474,260,214,301,114,187,0.71,0.53,0.64,16806,30,106,391
168546,ALBION COLLEGE,1,0,1998,NA,NA,448,248,200,298,126,172,0.6900000000000001,0.63,0.67,17712,32,110,380
168546,ALBION COLLEGE,1,0,1999,NA,NA,411,219,192,275,110,165,0.75,0.57,0.67,18234,33,107,345
168546,ALBION COLLEGE,1,0,2000,NA,NA,405,253,152,270,86,184,0.72,0.57,0.67,18690,35,114,328
168546,ALBION COLLEGE,1,0,2001,NA,NA,450,226,224,267,115,152,0.67,0.51,0.59,19390,41,121,390
168546,ALBION COLLEGE,1,0,2002,NA,NA,525,293,232,330,129,201,0.68,0.56,0.63,20458,42,123,472
168546,ALBION COLLEGE,1,0,2003,NA,NA,486,263,223,306,118,188,0.71,0.53,0.63,21692,43,118,443
168546,ALBION COLLEGE,1,0,2004,NA,NA,559,310,249,358,149,209,0.67,0.6,0.64,22650,43,131,490
168546,Albion College,1,0,2005,NA,NA,571,315,256,372,160,212,0.67,0.62,0.65,24012,46,141,512
168546,Albion College,1,0,2006,NA,NA,480,260,220,297,118,179,0.68,0.54,0.62,25668,48,135,413
168546,Albion College,1,0,2007,NA,NA,500,258,242,322,144,178,0.68,0.6,0.64,27054,49,135,444
168546,Albion College,1,0,2008,NA,NA,485,242,243,297,137,160,0.66,0.56,0.61,28380,51,143,423
168546,Albion College,1,0,2009,NA,NA,434,218,216,241,106,135,0.61,0.49,0.56,29488,55,125,345
168546,Albion College,1,0,2010,NA,NA,383,196,187,235,102,133,0.67,0.55,0.61,30650,52,114,322
168786,AQUINAS COLLEGE,1,0,1991,NA,NA,231,134,97,65,26,39,0.29,0.27,0.28,8960,21,83,197
168786,AQUINAS COLLEGE,1,0,1992,NA,NA,233,162,71,50,14,36,0.22,0.2,0.21,9722,20,87,191
168786,AQUINAS COLLEGE,1,0,1993,NA,NA,219,152,67,67,14,53,0.34,0.21,0.31,10402,22,90,195
168786,AQUINAS COLLEGE,1,0,1995,NA,NA,241,139,102,69,28,41,0.29,0.27,0.29,11852,22,79,222
168786,AQUINAS COLLEGE,1,0,1996,NA,NA,283,177,106,92,28,64,0.36,0.26,0.33,12534,23,76,251
168786,AQUINAS COLLEGE,1,0,1997,NA,NA,329,204,125,79,30,49,0.24,0.24,0.24,12910,19,72,310
168786,AQUINAS COLLEGE,1,0,1998,NA,NA,346,213,133,75,23,52,0.24,0.17,0.22,13168,20,82,317
168786,AQUINAS COLLEGE,1,0,1999,NA,NA,347,227,120,93,32,61,0.26,0.27,0.27,13366,23,82,318
168786,AQUINAS COLLEGE,1,0,2000,NA,NA,362,244,118,89,24,65,0.26,0.2,0.25,14034,26,89,337
168786,AQUINAS COLLEGE,1,0,2001,NA,NA,321,227,94,107,29,78,0.34,0.31,0.33,14876,26,96,304
168786,AQUINAS COLLEGE,1,0,2002,NA,NA,346,216,130,85,25,60,0.27,0.19,0.25,15620,27,95,310
168786,AQUINAS COLLEGE,1,0,2003,NA,NA,284,182,102,94,31,63,0.34,0.3,0.33,16400,28,96,264
168786,AQUINAS COLLEGE,1,0,2004,NA,NA,316,199,117,119,45,74,0.37,0.38,0.38,16992,29,94,284
168786,Aquinas College,1,0,2005,NA,NA,364,240,124,160,49,111,0.46,0.4,0.44,17926,28,94,317
168786,Aquinas College,1,0,2006,NA,NA,387,252,135,192,67,125,0.49,0.5,0.5,19000,29,92,332
168786,Aquinas College,1,0,2007,NA,NA,410,269,141,124,35,89,0.33,0.25,0.3,20048,30,86,361
168786,Aquinas College,1,0,2008,NA,NA,456,283,173,138,43,95,0.33,0.25,0.3,21150,32,89,401
168786,Aquinas College,1,0,2009,NA,NA,402,271,131,158,46,112,0.41000000000000003,0.35,0.39,22314,34,90,349
168786,Aquinas College,1,0,2010,NA,NA,428,255,173,140,53,87,0.34,0.31,0.33,23206,33,92,365
169080,CALVIN COLLEGE,1,0,1991,NA,NA,858,489,369,412,168,244,0.49,0.46,0.48,8100,52,236,751
169080,CALVIN COLLEGE,1,0,1992,NA,NA,803,474,329,369,145,224,0.47000000000000003,0.44,0.46,8630,52,225,716
169080,CALVIN COLLEGE,1,0,1993,NA,NA,908,524,384,471,194,277,0.52,0.51,0.52,9450,53,212,785
169080,CALVIN COLLEGE,1,0,1995,NA,NA,1013,571,442,506,215,291,0.5,0.49,0.5,10995,58,238,915
169080,CALVIN COLLEGE,1,0,1996,NA,NA,960,565,395,545,209,336,0.59,0.53,0.57,11655,64,258,846
169080,CALVIN COLLEGE,1,0,1997,NA,NA,1053,614,439,595,243,352,0.5700000000000001,0.55,0.57,12225,56,261,940
169080,CALVIN COLLEGE,1,0,1998,NA,NA,974,536,438,559,236,323,0.6,0.54,0.57,12915,58,266,847
169080,CALVIN COLLEGE,1,0,1999,NA,NA,1059,591,468,574,225,349,0.59,0.48,0.54,13420,62,273,914
169080,CALVIN COLLEGE,1,0,2000,NA,NA,1050,594,456,585,241,344,0.5700000000000001,0.53,0.56,14040,66,282,893
169080,CALVIN COLLEGE,1,0,2001,NA,NA,1026,601,425,571,214,357,0.59,0.5,0.56,14870,73,291,863
169080,CALVIN COLLEGE,1,0,2002,NA,NA,1045,577,468,586,228,358,0.62,0.49,0.56,15750,78,300,905
169080,CALVIN COLLEGE,1,0,2003,NA,NA,1041,577,464,572,230,342,0.59,0.5,0.55,16775,84,302,876
169080,CALVIN COLLEGE,1,0,2004,NA,NA,899,467,432,524,245,279,0.59,0.57,0.58,17770,90,304,766
169080,Calvin College,1,0,2005,NA,NA,1000,564,436,598,232,366,0.64,0.53,0.6,18925,94,309,866
169080,Calvin College,1,0,2006,NA,NA,1020,551,469,615,268,347,0.62,0.57,0.6,20245,98,315,867
169080,Calvin College,1,0,2007,NA,NA,1034,556,478,590,246,344,0.61,0.51,0.57,21460,103,319,846
169080,Calvin College,1,0,2008,NA,NA,935,500,435,539,235,304,0.6,0.54,0.58,22940,115,316,751
169080,Calvin College,1,0,2009,NA,NA,943,492,451,540,244,296,0.6,0.54,0.57,23810,118,325,749
169080,Calvin College,1,0,2010,NA,NA,929,469,460,573,250,323,0.68,0.54,0.62,24645,120,319,719
169798,EASTERN MICHIGAN UNIVERSITY,1,0,1991,NA,NA,2232,1255,977,176,65,111,0.08,0.07,0.08,2347,155,733,1785
169798,EASTERN MICHIGAN UNIVERSITY,1,0,1992,NA,NA,2149,1200,949,174,50,124,0.1,0.05,0.08,2471,151,731,1681
169798,EASTERN MICHIGAN UNIVERSITY,1,0,1993,NA,NA,2242,1217,1025,180,67,113,0.09,0.07,0.08,2804,170,729,1675
169798,EASTERN MICHIGAN UNIVERSITY,1,0,1995,NA,NA,2172,1230,942,198,65,133,0.1,0.07,0.09,3314,180,727,1642
169798,EASTERN MICHIGAN UNIVERSITY,1,0,1996,NA,NA,2298,1371,927,225,77,148,0.1,0.08,0.1,3399,187,741,1720
169798,EASTERN MICHIGAN UNIVERSITY,1,0,1997,NA,NA,2314,1372,942,260,80,180,0.13,0.08,0.11,3529,194,730,1706
169798,EASTERN MICHIGAN UNIVERSITY,1,0,1998,NA,NA,2349,1426,923,244,79,165,0.11,0.09,0.1,3645,206,739,1749
169798,EASTERN MICHIGAN UNIVERSITY,1,0,1999,NA,NA,2767,1627,1140,298,93,205,0.12,0.08,0.11,3146,215,767,1927
169798,EASTERN MICHIGAN UNIVERSITY,1,0,2000,NA,NA,2664,1619,1045,327,109,218,0.13,0.1,0.12,3097,227,761,1885
169798,EASTERN MICHIGAN UNIVERSITY,1,0,2001,NA,NA,2706,1627,1079,284,92,192,0.11,0.09,0.1,3622,241,756,1855
169798,EASTERN MICHIGAN UNIVERSITY,1,0,2002,NA,NA,2601,1564,1037,272,91,181,0.11,0.09,0.1,4047,248,760,1785
169798,EASTERN MICHIGAN UNIVERSITY,1,0,2003,NA,NA,2479,1510,969,295,85,210,0.13,0.09,0.12,4594,270,751,1676
169798,EASTERN MICHIGAN UNIVERSITY,1,0,2004,NA,NA,2281,1329,952,280,85,195,0.14,0.09,0.12,4707,269,735,1508
169798,Eastern Michigan University,1,0,2005,NA,NA,2301,1416,885,297,89,208,0.14,0.1,0.13,5463,276,769,1544
169798,Eastern Michigan University,1,0,2006,NA,NA,2272,1315,957,276,97,179,0.13,0.1,0.12,5835,284,764,1463
169798,Eastern Michigan University,1,0,2007,NA,NA,2365,1345,1020,294,109,185,0.13,0.11,0.12,6390,297,756,1437
169798,Eastern Michigan University,1,0,2008,NA,NA,2167,1283,884,269,84,185,0.14,0.1,0.12,6885,305,738,1176
169798,Eastern Michigan University,1,0,2009,NA,NA,2196,1308,888,288,84,204,0.15,0.09,0.13,7148,313,755,1298
169798,Eastern Michigan University,1,0,2010,NA,NA,1955,1152,803,254,75,179,0.15,0.09,0.13,7148,338,764,1080
169910,FERRIS STATE UNIVERSITY,0,1,1991,1993,0,2377,889,1488,90,47,43,0.04,0.03,0.04,2565,112,512,1994
169910,FERRIS STATE UNIVERSITY,0,1,1992,1993,0,2051,835,1216,57,28,29,0.03,0.02,0.03,2970,120,500,1617
169910,FERRIS STATE UNIVERSITY,1,0,1993,1993,1,2114,810,1304,51,26,25,0.03,0.02,0.02,3222,123,477,1681
169910,FERRIS STATE UNIVERSITY,1,0,1995,1993,1,1893,752,1141,55,28,27,0.03,0.02,0.03,3532,122,445,1439
169910,FERRIS STATE UNIVERSITY,1,0,1996,1993,1,1831,731,1100,48,28,20,0.02,0.03,0.03,3630,124,430,1413
169910,FERRIS STATE UNIVERSITY,1,0,1997,1993,1,1906,763,1143,46,21,25,0.03,0.02,0.02,3808,129,429,1504
169910,FERRIS STATE UNIVERSITY,1,0,1998,1993,1,1946,812,1134,53,25,28,0.03,0.02,0.03,3998,137,422,1472
169910,FERRIS STATE UNIVERSITY,1,0,1999,1993,1,1916,798,1118,78,44,34,0.04,0.04,0.04,4118,141,419,1511
169910,FERRIS STATE UNIVERSITY,1,0,2000,1993,1,2147,883,1264,94,47,47,0.05,0.04,0.04,4284,160,430,1667
169910,FERRIS STATE UNIVERSITY,1,0,2001,1993,1,2128,901,1227,123,66,57,0.06,0.05,0.06,4670,172,442,1671
169910,FERRIS STATE UNIVERSITY,1,0,2002,1993,1,2035,882,1153,138,67,71,0.08,0.06,0.07,5334,165,446,1653
169910,FERRIS STATE UNIVERSITY,1,0,2003,1993,1,2205,960,1245,137,67,70,0.07,0.05,0.06,6044,175,429,1821
169910,FERRIS STATE UNIVERSITY,1,0,2004,1993,1,1924,834,1090,127,60,67,0.08,0.06,0.07,6190,172,463,1559
169910,Ferris State University,1,0,2005,1993,1,2189,1003,1186,140,59,81,0.08,0.05,0.06,6740,178,512,1744
169910,Ferris State University,1,0,2006,1993,1,1895,860,1035,167,82,85,0.09,0.08,0.09,7200,186,537,1660
169910,Ferris State University,1,0,2007,1993,1,2035,933,1102,182,79,103,0.11,0.07,0.09,8460,190,540,1645
169910,Ferris State University,1,0,2008,1993,1,2103,992,1111,169,75,94,0.09,0.07,0.08,9000,204,544,1680
169910,Ferris State University,1,0,2009,1993,1,1958,980,978,152,58,94,0.09,0.06,0.08,9480,212,586,1529
169910,Ferris State University,1,0,2010,1993,1,1960,976,984,143,59,84,0.08,0.06,0.07,9930,225,525,1533
170082,GRAND VALLEY STATE UNIVERSITY,1,0,1991,NA,NA,1545,941,604,240,63,177,0.18,0.1,0.16,2306,74,303,1377
170082,GRAND VALLEY STATE UNIVERSITY,1,0,1992,NA,NA,1557,982,575,289,91,198,0.2,0.16,0.19,2508,80,317,1378
170082,GRAND VALLEY STATE UNIVERSITY,1,0,1993,NA,NA,1511,916,595,262,79,183,0.19,0.13,0.17,2742,86,320,1341
170082,GRAND VALLEY STATE UNIVERSITY,1,0,1995,NA,NA,1773,1087,686,287,95,192,0.17,0.14,0.16,3140,105,362,1575
170082,GRAND VALLEY STATE UNIVERSITY,1,0,1996,NA,NA,2039,1200,839,356,112,244,0.2,0.13,0.17,3226,110,380,1835
170082,GRAND VALLEY STATE UNIVERSITY,1,0,1997,NA,NA,2406,1494,912,410,120,290,0.19,0.13,0.17,3288,122,400,2187
170082,GRAND VALLEY STATE UNIVERSITY,1,0,1998,NA,NA,2482,1544,938,469,153,316,0.2,0.16,0.19,3362,132,435,2235
170082,GRAND VALLEY STATE UNIVERSITY,1,0,1999,NA,NA,2528,1553,975,512,163,349,0.22,0.17,0.2,4048,151,475,2283
170082,GRAND VALLEY STATE UNIVERSITY,1,0,2000,NA,NA,2831,1732,1099,548,166,382,0.22,0.15,0.19,4230,190,580,2577
170082,GRAND VALLEY STATE UNIVERSITY,1,0,2001,NA,NA,2977,1826,1151,569,189,380,0.2,0.16,0.19,4660,204,685,2642
170082,GRAND VALLEY STATE UNIVERSITY,1,0,2002,NA,NA,2868,1801,1067,634,188,446,0.24,0.18,0.22,5056,190,748,2573
170082,GRAND VALLEY STATE UNIVERSITY,1,0,2003,NA,NA,3270,2096,1174,851,257,594,0.28,0.22,0.26,5254,213,827,2842
170082,GRAND VALLEY STATE UNIVERSITY,1,0,2004,NA,NA,3324,2123,1201,875,270,605,0.28,0.22,0.26,5782,230,880,2881
170082,Grand Valley State University,1,0,2005,NA,NA,3407,2220,1187,1011,308,703,0.31,0.26,0.3,6220,249,880,2864
170082,Grand Valley State University,1,0,2006,NA,NA,3556,2276,1280,1116,346,770,0.33,0.27,0.31,6588,264,904,2948
170082,Grand Valley State University,1,0,2007,NA,NA,3446,2201,1245,1137,346,791,0.35000000000000003,0.28,0.33,7240,290,923,2850
170082,Grand Valley State University,1,0,2008,NA,NA,3879,2413,1466,1216,403,813,0.33,0.27,0.31,8196,312,981,3464
170082,Grand Valley State University,1,0,2009,NA,NA,3716,2278,1438,1363,461,902,0.39,0.32,0.37,8630,335,1036,3271
170082,Grand Valley State University,1,0,2010,NA,NA,3414,2084,1330,1165,413,752,0.36,0.31,0.34,9088,353,1048,2900
170301,HOPE COLLEGE,1,0,1991,NA,NA,554,317,237,278,99,179,0.56,0.42,0.5,10086,45,162,515
170301,HOPE COLLEGE,1,0,1992,NA,NA,687,408,279,371,134,237,0.58,0.48,0.54,10792,46,167,640
170301,HOPE COLLEGE,1,0,1993,NA,NA,657,360,297,360,157,203,0.56,0.53,0.55,11542,50,159,599
170301,HOPE COLLEGE,1,0,1995,NA,NA,709,418,291,412,143,269,0.64,0.49,0.58,13234,55,177,660
170301,HOPE COLLEGE,1,0,1996,NA,NA,695,415,280,474,166,308,0.74,0.59,0.68,14310,57,184,657
170301,HOPE COLLEGE,1,0,1997,NA,NA,721,432,289,450,164,286,0.66,0.57,0.62,14878,56,186,673
170301,HOPE COLLEGE,1,0,1998,NA,NA,747,462,285,446,148,298,0.64,0.52,0.6,15470,59,186,708
170301,HOPE COLLEGE,1,0,1999,NA,NA,755,455,300,485,184,301,0.66,0.61,0.64,15934,63,200,709
170301,HOPE COLLEGE,1,0,2000,NA,NA,754,468,286,480,170,310,0.66,0.59,0.64,16554,64,199,683
170301,HOPE COLLEGE,1,0,2001,NA,NA,763,468,295,474,158,316,0.67,0.54,0.62,17348,68,199,718
170301,HOPE COLLEGE,1,0,2002,NA,NA,725,465,260,457,139,318,0.68,0.53,0.63,18158,69,210,676
170301,HOPE COLLEGE,1,0,2003,NA,NA,810,515,295,531,167,364,0.7000000000000001,0.57,0.66,19212,72,218,760
170301,HOPE COLLEGE,1,0,2004,NA,NA,780,463,317,531,194,337,0.72,0.61,0.68,20300,75,227,700
170301,Hope College,1,0,2005,NA,NA,774,463,311,531,194,337,0.72,0.62,0.69,21420,81,232,713
170301,Hope College,1,0,2006,NA,NA,778,461,317,524,189,335,0.72,0.6,0.67,22430,84,235,714
170301,Hope College,1,0,2007,NA,NA,819,495,324,554,199,355,0.71,0.61,0.68,23660,91,245,728
170301,Hope College,1,0,2008,NA,NA,805,499,306,565,189,376,0.75,0.62,0.7,24780,94,246,711
170301,Hope College,1,0,2009,NA,NA,803,486,317,515,186,329,0.67,0.59,0.64,25500,94,243,701
170301,Hope College,1,0,2010,NA,NA,765,455,310,524,185,339,0.74,0.6,0.68,26350,92,240,660
170532,KALAMAZOO COLLEGE,0,1,1991,Inf,0,336,179,157,192,86,106,0.59,0.55,0.57,12669,25,89,294
170532,KALAMAZOO COLLEGE,0,1,1992,Inf,0,349,201,148,193,77,116,0.5700000000000001,0.52,0.55,13785,27,90,303
170532,KALAMAZOO COLLEGE,0,1,1993,Inf,0,338,198,140,217,86,131,0.66,0.61,0.64,15135,29,92,298
170532,KALAMAZOO COLLEGE,0,1,1995,Inf,0,350,197,153,221,90,131,0.66,0.59,0.63,16713,32,89,305
170532,KALAMAZOO COLLEGE,0,1,1996,Inf,0,360,202,158,239,108,131,0.64,0.68,0.66,17214,33,82,313
170532,KALAMAZOO COLLEGE,0,1,1997,Inf,0,290,170,120,201,78,123,0.72,0.65,0.69,17976,37,84,247
170532,KALAMAZOO COLLEGE,0,1,1998,Inf,0,442,256,186,322,126,196,0.76,0.68,0.73,18630,39,84,391
170532,KALAMAZOO COLLEGE,0,1,1999,Inf,0,369,187,182,270,128,142,0.75,0.7,0.73,19188,42,90,318
170532,KALAMAZOO COLLEGE,0,1,2000,Inf,0,324,180,144,246,103,143,0.79,0.72,0.76,19764,42,93,260
170532,KALAMAZOO COLLEGE,0,1,2001,Inf,0,341,198,143,248,100,148,0.74,0.7,0.73,20652,45,97,289
170532,KALAMAZOO COLLEGE,0,1,2002,Inf,0,335,177,158,239,105,134,0.75,0.66,0.71,21603,47,106,267
170532,KALAMAZOO COLLEGE,0,1,2003,Inf,0,382,220,162,275,118,157,0.71,0.73,0.72,22908,47,106,309
170532,KALAMAZOO COLLEGE,0,1,2004,Inf,0,310,188,122,240,86,154,0.81,0.7,0.77,24351,50,102,239
170532,Kalamazoo College,0,1,2005,Inf,0,377,196,181,286,134,152,0.77,0.74,0.76,25644,50,103,308
170532,Kalamazoo College,0,1,2006,Inf,0,379,211,168,279,110,169,0.8,0.65,0.74,27054,54,106,277
170532,Kalamazoo College,0,1,2007,Inf,0,363,213,150,263,100,163,0.76,0.67,0.72,28716,40,99,259
170532,Kalamazoo College,0,1,2008,Inf,0,364,200,164,279,128,151,0.75,0.78,0.77,30723,43,98,274
170532,Kalamazoo College,0,1,2009,Inf,0,389,219,170,299,121,178,0.81,0.71,0.77,32643,44,94,273
170532,Kalamazoo College,0,1,2010,Inf,0,341,192,149,250,106,144,0.75,0.71,0.73,34017,44,99,211
170639,LAKE SUPERIOR STATE UNIVERSITY,1,0,1991,NA,NA,492,221,271,60,28,32,0.14,0.1,0.12,2518,27,107,413
170639,LAKE SUPERIOR STATE UNIVERSITY,1,0,1992,NA,NA,482,226,256,84,35,49,0.21,0.14,0.17,2694,32,108,385
170639,LAKE SUPERIOR STATE UNIVERSITY,1,0,1993,NA,NA,593,290,303,95,35,60,0.2,0.12,0.16,3200,32,112,443
170639,LAKE SUPERIOR STATE UNIVERSITY,1,0,1995,NA,NA,593,281,312,80,39,41,0.14,0.12,0.13,3396,32,111,480
170639,LAKE SUPERIOR STATE UNIVERSITY,1,0,1996,NA,NA,540,247,293,63,27,36,0.14,0.09,0.12,3534,35,114,418
170639,LAKE SUPERIOR STATE UNIVERSITY,1,0,1997,NA,NA,522,239,283,71,34,37,0.15,0.12,0.14,3642,36,114,386
170639,LAKE SUPERIOR STATE UNIVERSITY,1,0,1998,NA,NA,575,250,325,67,27,40,0.16,0.08,0.12,3871,36,115,453
170639,LAKE SUPERIOR STATE UNIVERSITY,1,0,1999,NA,NA,505,242,263,71,30,41,0.16,0.11,0.14,4030,39,115,392
170639,LAKE SUPERIOR STATE UNIVERSITY,1,0,2000,NA,NA,555,262,293,76,35,41,0.15,0.12,0.14,3818,41,112,437
170639,LAKE SUPERIOR STATE UNIVERSITY,1,0,2001,NA,NA,536,235,301,83,42,41,0.17,0.14,0.15,4128,40,110,428
170639,LAKE SUPERIOR STATE UNIVERSITY,1,0,2002,NA,NA,574,262,312,53,29,24,0.09,0.09,0.09,4548,44,115,454
170639,LAKE SUPERIOR STATE UNIVERSITY,1,0,2003,NA,NA,551,243,308,42,17,25,0.1,0.06,0.08,5136,45,108,453
170639,LAKE SUPERIOR STATE UNIVERSITY,1,0,2004,NA,NA,527,242,285,67,27,40,0.16,0.09,0.13,5418,43,107,436
170639,Lake Superior State University,1,0,2005,NA,NA,474,216,258,62,31,31,0.14,0.12,0.13,5988,41,107,379
170639,Lake Superior State University,1,0,2006,NA,NA,454,232,222,58,23,35,0.15,0.1,0.13,6558,43,101,367
170639,Lake Superior State University,1,0,2007,NA,NA,469,230,239,66,35,31,0.13,0.15,0.14,7176,44,104,400
170639,Lake Superior State University,1,0,2008,NA,NA,490,250,240,72,32,40,0.16,0.13,0.15,7824,45,104,403
170639,Lake Superior State University,1,0,2009,NA,NA,437,209,228,65,33,32,0.15,0.14,0.15,8184,48,115,358
170639,Lake Superior State University,1,0,2010,NA,NA,501,229,272,91,54,37,0.16,0.2,0.18,8664,48,113,399
170976,UNIVERSITY OF MICHIGAN-ANN ARBOR,0,1,1991,Inf,0,4908,2299,2609,2841,1363,1478,0.64,0.52,0.58,4044,1759,1929,3399
170976,UNIVERSITY OF MICHIGAN-ANN ARBOR,0,1,1992,Inf,0,5006,2342,2664,3058,1490,1568,0.66,0.56,0.61,4583,1868,1968,3411
170976,UNIVERSITY OF MICHIGAN-ANN ARBOR,0,1,1993,Inf,0,5016,2428,2588,3078,1451,1627,0.67,0.56,0.61,5119,2031,1968,3366
170976,UNIVERSITY OF MICHIGAN-ANN ARBOR,0,1,1995,Inf,0,5265,2658,2607,3223,1428,1795,0.67,0.55,0.61,5842,2303,1961,3375
170976,UNIVERSITY OF MICHIGAN-ANN ARBOR,0,1,1996,Inf,0,5328,2710,2618,3399,1533,1866,0.68,0.59,0.64,5710,2339,1977,3338
170976,UNIVERSITY OF MICHIGAN-ANN ARBOR,0,1,1997,Inf,0,5535,2763,2772,3619,1656,1963,0.71,0.6,0.65,5878,2516,1985,3616
170976,UNIVERSITY OF MICHIGAN-ANN ARBOR,0,1,1998,Inf,0,5258,2654,2604,3531,1620,1911,0.72,0.62,0.67,6098,2662,2020,3321
170976,UNIVERSITY OF MICHIGAN-ANN ARBOR,0,1,1999,Inf,0,5563,2853,2710,3879,1779,2100,0.73,0.66,0.7,6148,2714,2113,3607
170976,UNIVERSITY OF MICHIGAN-ANN ARBOR,0,1,2000,Inf,0,5403,2860,2543,3803,1697,2106,0.73,0.67,0.7,6328,3034,2360,3447
170976,UNIVERSITY OF MICHIGAN-ANN ARBOR,0,1,2001,Inf,0,5531,2884,2647,3896,1752,2144,0.74,0.66,0.7,6750,3743,2608,3618
170976,UNIVERSITY OF MICHIGAN-ANN ARBOR,0,1,2002,Inf,0,5180,2704,2476,3641,1634,2007,0.74,0.66,0.7,7298,3405,2651,3402
170976,UNIVERSITY OF MICHIGAN-ANN ARBOR,0,1,2003,Inf,0,5538,2903,2635,4025,1840,2185,0.75,0.7,0.73,7788,3585,2645,3530
170976,UNIVERSITY OF MICHIGAN-ANN ARBOR,0,1,2004,Inf,0,6016,3033,2983,4334,1990,2344,0.77,0.67,0.72,8014,3747,2662,3990
170976,University of Michigan-Ann Arbor,0,1,2005,Inf,0,6080,3071,3009,4431,2061,2370,0.77,0.68,0.73,9024,3885,2495,3955
170976,University of Michigan-Ann Arbor,0,1,2006,Inf,0,5356,2704,2652,4072,1880,2192,0.81,0.71,0.76,9534,4119,2572,3555
170976,University of Michigan-Ann Arbor,0,1,2007,Inf,0,5955,3019,2936,4513,2063,2450,0.81,0.7,0.76,10258,4283,2998,3873
170976,University of Michigan-Ann Arbor,0,1,2008,Inf,0,5738,2905,2833,4336,1989,2347,0.8,0.7,0.76,10848,5988,3079,3821
170976,University of Michigan-Ann Arbor,0,1,2009,Inf,0,6019,2983,3036,4503,2101,2402,0.8,0.69,0.75,11470,4917,3228,4316
170976,University of Michigan-Ann Arbor,0,1,2010,Inf,0,6443,3217,3226,4929,2317,2612,0.81,0.72,0.77,11648,5098,3258,4480
171100,MICHIGAN STATE UNIVERSITY,0,1,1991,1992,0,6314,3456,2858,1480,535,945,0.27,0.19,0.23,3474,765,1927,5257
171100,MICHIGAN STATE UNIVERSITY,1,0,1992,1992,1,6086,3320,2766,1897,669,1228,0.36,0.24,0.31,3876,820,1876,5064
171100,MICHIGAN STATE UNIVERSITY,1,0,1993,1992,1,6164,3372,2792,1851,641,1210,0.35000000000000003,0.23,0.3,4260,850,1840,5016
171100,MICHIGAN STATE UNIVERSITY,1,0,1995,1992,1,6396,3546,2850,2076,693,1383,0.39,0.24,0.32,4521,896,1848,5312
171100,MICHIGAN STATE UNIVERSITY,1,0,1996,1992,1,6708,3728,2980,2358,809,1549,0.41000000000000003,0.27,0.35,4655,925,1861,5551
171100,MICHIGAN STATE UNIVERSITY,1,0,1997,1992,1,6804,3723,3081,2232,751,1481,0.39,0.24,0.33,4789,960,1851,5567
171100,MICHIGAN STATE UNIVERSITY,1,0,1998,1992,1,6724,3767,2957,2343,757,1586,0.42,0.26,0.35,4896,1020,1847,5437
171100,MICHIGAN STATE UNIVERSITY,1,0,1999,1992,1,6499,3674,2825,2580,833,1747,0.47000000000000003,0.29,0.4,5003,1066,1838,5186
171100,MICHIGAN STATE UNIVERSITY,1,0,2000,1992,1,6790,3756,3034,2908,1026,1882,0.5,0.34,0.43,4830,1129,1889,5338
171100,MICHIGAN STATE UNIVERSITY,1,0,2001,1992,1,6755,3808,2947,2878,1041,1837,0.48,0.35,0.43,5257,1277,1940,5224
171100,MICHIGAN STATE UNIVERSITY,1,0,2002,1992,1,6829,3864,2965,3127,1133,1994,0.51,0.38,0.46,5704,1248,2068,5275
171100,MICHIGAN STATE UNIVERSITY,1,0,2003,1992,1,6938,3932,3006,3315,1201,2114,0.53,0.4,0.48,6266,1299,2091,5460
171100,MICHIGAN STATE UNIVERSITY,1,0,2004,1992,1,7426,4073,3353,3531,1334,2197,0.53,0.4,0.48,6540,1303,2075,5898
171100,Michigan State University,1,0,2005,1992,1,7303,4147,3156,3470,1232,2238,0.53,0.39,0.48,7161,1401,2180,5712
171100,Michigan State University,1,0,2006,1992,1,7306,4103,3203,3800,1448,2352,0.5700000000000001,0.45,0.52,7759,1498,2268,5639
171100,Michigan State University,1,0,2007,1992,1,7398,4099,3299,3666,1372,2294,0.55,0.42,0.5,8672,1572,2285,5678
171100,Michigan State University,1,0,2008,1992,1,7385,4098,3287,3831,1442,2389,0.58,0.44,0.52,9806,1714,2340,5488
171100,Michigan State University,1,0,2009,1992,1,7249,3869,3380,3612,1445,2167,0.56,0.43,0.5,10913,1798,2346,5207
171100,Michigan State University,1,0,2010,1992,1,7221,3821,3400,3685,1516,2169,0.56,0.45,0.51,11670,1829,2256,5213
171128,MICHIGAN TECHNOLOGICAL UNIVERSITY,0,1,1991,2000,0,1283,319,964,234,145,89,0.27,0.15,0.18,2916,97,322,1191
171128,MICHIGAN TECHNOLOGICAL UNIVERSITY,0,1,1992,2000,0,1260,321,939,253,169,84,0.26,0.18,0.2,3249,100,322,1143
171128,MICHIGAN TECHNOLOGICAL UNIVERSITY,0,1,1993,2000,0,1026,262,764,215,133,82,0.31,0.17,0.21,3441,106,338,958
171128,MICHIGAN TECHNOLOGICAL UNIVERSITY,0,1,1995,2000,0,1072,285,787,218,134,84,0.29,0.17,0.2,3843,120,368,971
171128,MICHIGAN TECHNOLOGICAL UNIVERSITY,0,1,1996,2000,0,1068,260,808,298,199,99,0.38,0.25,0.28,3948,126,374,963
171128,MICHIGAN TECHNOLOGICAL UNIVERSITY,0,1,1997,2000,0,1251,295,956,329,224,105,0.35000000000000003,0.23,0.26,4062,127,370,1131
171128,MICHIGAN TECHNOLOGICAL UNIVERSITY,0,1,1998,2000,0,1194,328,866,323,202,121,0.36,0.23,0.27,4362,134,369,1056
171128,MICHIGAN TECHNOLOGICAL UNIVERSITY,0,1,1999,2000,0,1137,276,861,259,183,76,0.27,0.21,0.23,4365,138,366,1022
171128,MICHIGAN TECHNOLOGICAL UNIVERSITY,1,0,2000,2000,1,1267,292,975,316,223,93,0.31,0.23,0.25,4530,147,366,1115
171128,MICHIGAN TECHNOLOGICAL UNIVERSITY,1,0,2001,2000,1,1189,281,908,281,181,100,0.35000000000000003,0.2,0.24,5028,159,367,1021
171128,MICHIGAN TECHNOLOGICAL UNIVERSITY,1,0,2002,2000,1,1186,267,919,306,210,96,0.35000000000000003,0.23,0.26,5782,156,366,1050
171128,MICHIGAN TECHNOLOGICAL UNIVERSITY,1,0,2003,2000,1,1168,238,930,251,177,74,0.31,0.19,0.21,6810,159,346,1051
171128,MICHIGAN TECHNOLOGICAL UNIVERSITY,1,0,2004,2000,1,1219,243,976,327,221,106,0.43,0.23,0.27,6978,153,355,1102
171128,Michigan Technological University,1,0,2005,2000,1,1321,236,1085,327,243,84,0.35000000000000003,0.22,0.25,7560,157,343,1152
171128,Michigan Technological University,1,0,2006,2000,1,1163,283,880,328,221,107,0.37,0.25,0.28,8271,167,349,1023
171128,Michigan Technological University,1,0,2007,2000,1,1215,287,928,275,197,78,0.27,0.21,0.23,9180,184,367,1035
171128,Michigan Technological University,1,0,2008,2000,1,1361,318,1043,333,218,115,0.36,0.21,0.24,9930,197,361,1200
171128,Michigan Technological University,1,0,2009,2000,1,1155,301,854,260,162,98,0.32,0.19,0.23,10500,208,378,1001
171128,Michigan Technological University,1,0,2010,2000,1,1110,273,837,308,202,106,0.38,0.24,0.28,11175,213,389,959
171137,UNIVERSITY OF MICHIGAN-DEARBORN,1,0,1991,NA,NA,597,308,289,50,22,28,0.09,0.08,0.08,2766,45,201,507
171137,UNIVERSITY OF MICHIGAN-DEARBORN,1,0,1992,NA,NA,625,323,302,46,18,28,0.08,0.06,0.07,2886,44,206,552
171137,UNIVERSITY OF MICHIGAN-DEARBORN,1,0,1993,NA,NA,631,311,320,50,21,29,0.09,0.07,0.08,3160,48,219,518
171137,UNIVERSITY OF MICHIGAN-DEARBORN,1,0,1995,NA,NA,600,320,280,49,23,26,0.08,0.08,0.08,3736,54,221,493
171137,UNIVERSITY OF MICHIGAN-DEARBORN,1,0,1996,NA,NA,666,321,345,67,23,44,0.13,0.07,0.1,3970,58,230,523
171137,UNIVERSITY OF MICHIGAN-DEARBORN,1,0,1997,NA,NA,696,378,318,96,29,67,0.17,0.09,0.14,4087,64,237,569
171137,UNIVERSITY OF MICHIGAN-DEARBORN,1,0,1998,NA,NA,741,373,368,99,41,58,0.15,0.11,0.13,4274,66,233,569
171137,UNIVERSITY OF MICHIGAN-DEARBORN,1,0,1999,NA,NA,690,334,356,88,30,58,0.17,0.08,0.13,4077,67,239,514
171137,UNIVERSITY OF MICHIGAN-DEARBORN,1,0,2000,NA,NA,738,371,367,118,52,66,0.17,0.14,0.16,4492,74,257,583
171137,UNIVERSITY OF MICHIGAN-DEARBORN,1,0,2001,NA,NA,658,330,328,90,33,57,0.17,0.1,0.14,4915,77,276,497
171137,UNIVERSITY OF MICHIGAN-DEARBORN,1,0,2002,NA,NA,735,342,393,105,48,57,0.16,0.12,0.14,5332,80,283,573
171137,UNIVERSITY OF MICHIGAN-DEARBORN,1,0,2003,NA,NA,704,313,391,123,62,61,0.19,0.16,0.17,5839,83,291,535
171137,UNIVERSITY OF MICHIGAN-DEARBORN,1,0,2004,NA,NA,656,311,345,106,45,61,0.19,0.13,0.16,5491,91,295,460
171137,University of Michigan-Dearborn,1,0,2005,NA,NA,798,381,417,128,47,81,0.21,0.11,0.16,6146,97,290,601
171137,University of Michigan-Dearborn,1,0,2006,NA,NA,761,394,367,136,56,80,0.2,0.15,0.18,6641,99,288,563
171137,University of Michigan-Dearborn,1,0,2007,NA,NA,859,420,439,128,61,67,0.15,0.14,0.15,7165,104,292,611
171137,University of Michigan-Dearborn,1,0,2008,NA,NA,905,436,469,145,60,85,0.19,0.13,0.16,7631,108,294,645
171137,University of Michigan-Dearborn,1,0,2009,NA,NA,886,418,468,146,60,86,0.2,0.13,0.16,8142,111,306,651
171137,University of Michigan-Dearborn,1,0,2010,NA,NA,883,429,454,149,51,98,0.22,0.11,0.17,8460,116,305,650
171146,UNIVERSITY OF MICHIGAN-FLINT,1,0,1991,NA,NA,485,286,199,32,7,25,0.08,0.04,0.07,2460,37,176,411
171146,UNIVERSITY OF MICHIGAN-FLINT,1,0,1992,NA,NA,523,317,206,45,8,37,0.11,0.04,0.09,2700,37,184,421
171146,UNIVERSITY OF MICHIGAN-FLINT,1,0,1993,NA,NA,504,322,182,41,12,29,0.09,0.07,0.08,2916,40,184,434
171146,UNIVERSITY OF MICHIGAN-FLINT,1,0,1995,NA,NA,263,169,94,116,45,71,0.42,0.48,0.44,3304,42,192,226
171146,UNIVERSITY OF MICHIGAN-FLINT,1,0,1996,NA,NA,551,352,199,53,15,38,0.1,0.08,0.1,3433,45,204,472
171146,UNIVERSITY OF MICHIGAN-FLINT,1,0,1997,NA,NA,552,337,215,30,10,20,0.05,0.05,0.05,3559,48,206,450
171146,UNIVERSITY OF MICHIGAN-FLINT,1,0,1998,NA,NA,613,372,241,60,20,40,0.1,0.08,0.1,3697,51,198,524
171146,UNIVERSITY OF MICHIGAN-FLINT,1,0,1999,NA,NA,492,289,203,49,15,34,0.11,0.07,0.1,3640,52,202,395
171146,UNIVERSITY OF MICHIGAN-FLINT,1,0,2000,NA,NA,576,349,227,64,18,46,0.13,0.08,0.11,3712,60,209,464
171146,UNIVERSITY OF MICHIGAN-FLINT,1,0,2001,NA,NA,549,330,219,54,17,37,0.11,0.08,0.1,4135,59,216,455
171146,UNIVERSITY OF MICHIGAN-FLINT,1,0,2002,NA,NA,467,269,198,52,16,36,0.13,0.08,0.11,4494,63,211,382
171146,UNIVERSITY OF MICHIGAN-FLINT,1,0,2003,NA,NA,420,252,168,57,17,40,0.15,0.1,0.14,5000,72,191,334
171146,UNIVERSITY OF MICHIGAN-FLINT,1,0,2004,NA,NA,474,293,181,53,17,36,0.12,0.09,0.11,5126,71,191,393
171146,University of Michigan-Flint,1,0,2005,NA,NA,509,293,216,48,18,30,0.1,0.08,0.09,5752,66,214,374
171146,University of Michigan-Flint,1,0,2006,NA,NA,483,274,209,46,14,32,0.11,0.07,0.1,6214,75,222,347
171146,University of Michigan-Flint,1,0,2007,NA,NA,594,346,248,56,16,40,0.11,0.06,0.09,6618,77,220,407
171146,University of Michigan-Flint,1,0,2008,NA,NA,846,512,334,78,31,47,0.09,0.09,0.09,7008,84,229,537
171146,University of Michigan-Flint,1,0,2009,NA,NA,713,401,312,77,29,48,0.11,0.09,0.11,7474,92,231,471
171146,University of Michigan-Flint,1,0,2010,NA,NA,724,398,326,94,34,60,0.15,0.1,0.13,7809,95,242,506
171599,OLIVET COLLEGE,1,0,1991,NA,NA,162,55,107,30,18,12,0.21,0.17,0.19,7890,9,41,136
171599,OLIVET COLLEGE,1,0,1992,NA,NA,139,39,100,14,5,9,0.23,0.05,0.1,8291,9,40,120
171599,OLIVET COLLEGE,1,0,1993,NA,NA,234,78,156,53,30,23,0.29,0.19,0.23,10500,10,44,210
171599,OLIVET COLLEGE,1,0,1995,NA,NA,209,69,140,28,20,8,0.11,0.14,0.13,11580,12,40,171
171599,OLIVET COLLEGE,1,0,1996,NA,NA,241,93,148,45,21,24,0.25,0.14,0.19,12160,13,45,163
171599,OLIVET COLLEGE,1,0,1997,NA,NA,228,73,155,2,0,2,0.02,0,0.01,12660,15,43,159
171599,OLIVET COLLEGE,1,0,1998,NA,NA,198,85,113,42,21,21,0.24,0.19,0.21,12900,16,36,117
171599,OLIVET COLLEGE,1,0,1999,NA,NA,181,74,107,63,32,31,0.41000000000000003,0.3,0.35,12948,16,40,118
171599,OLIVET COLLEGE,1,0,2000,NA,NA,183,66,117,36,18,18,0.27,0.15,0.2,13142,17,38,94
171599,OLIVET COLLEGE,1,0,2001,NA,NA,151,59,92,52,26,26,0.44,0.28,0.34,13982,20,36,95
171599,OLIVET COLLEGE,1,0,2002,NA,NA,238,85,153,82,42,40,0.47000000000000003,0.27,0.34,14332,18,31,174
171599,OLIVET COLLEGE,1,0,2003,NA,NA,271,99,172,101,53,48,0.48,0.31,0.37,14762,13,33,175
171599,OLIVET COLLEGE,1,0,2004,NA,NA,198,72,126,51,26,25,0.34,0.21,0.26,15500,15,34,144
171599,Olivet College,1,0,2005,NA,NA,257,103,154,77,33,44,0.42,0.21,0.3,15970,16,33,198
171599,Olivet College,1,0,2006,NA,NA,195,73,122,52,28,24,0.32,0.23,0.27,17584,15,34,153
171599,Olivet College,1,0,2007,NA,NA,182,67,115,48,18,30,0.44,0.16,0.26,17994,16,37,137
171599,Olivet College,1,0,2008,NA,NA,282,99,183,76,34,42,0.42,0.19,0.27,18580,17,41,202
171599,Olivet College,1,0,2009,NA,NA,258,141,117,68,26,42,0.29,0.22,0.26,19138,18,42,212
171599,Olivet College,1,0,2010,NA,NA,229,93,136,80,35,45,0.48,0.26,0.35,19710,16,43,187
172051,SAGINAW VALLEY STATE UNIVERSITY,1,0,1991,NA,NA,564,296,268,26,6,20,0.06,0.02,0.05,2426,39,166,492
172051,SAGINAW VALLEY STATE UNIVERSITY,1,0,1992,NA,NA,655,360,295,42,8,34,0.09,0.03,0.06,2620,47,170,561
172051,SAGINAW VALLEY STATE UNIVERSITY,1,0,1993,NA,NA,633,337,296,112,36,76,0.22,0.12,0.18,2891,42,174,580
172051,SAGINAW VALLEY STATE UNIVERSITY,1,0,1995,NA,NA,752,412,340,40,14,26,0.06,0.04,0.05,3259,45,171,674
172051,SAGINAW VALLEY STATE UNIVERSITY,1,0,1996,NA,NA,747,425,322,33,8,25,0.05,0.02,0.04,3350,47,180,664
172051,SAGINAW VALLEY STATE UNIVERSITY,1,0,1997,NA,NA,818,461,357,55,12,43,0.09,0.03,0.07,3447,51,179,673
172051,SAGINAW VALLEY STATE UNIVERSITY,1,0,1998,NA,NA,895,492,403,59,20,39,0.07,0.05,0.07,3526,55,200,757
172051,SAGINAW VALLEY STATE UNIVERSITY,1,0,1999,NA,NA,1015,549,466,81,36,45,0.08,0.08,0.08,3351,58,211,843
172051,SAGINAW VALLEY STATE UNIVERSITY,1,0,2000,NA,NA,1049,559,490,68,24,44,0.07,0.05,0.06,3290,65,218,878
172051,SAGINAW VALLEY STATE UNIVERSITY,1,0,2001,NA,NA,1044,539,505,106,39,67,0.12,0.08,0.1,3455,74,226,865
172051,SAGINAW VALLEY STATE UNIVERSITY,1,0,2002,NA,NA,1109,654,455,97,27,70,0.1,0.06,0.09,3824,77,233,923
172051,SAGINAW VALLEY STATE UNIVERSITY,1,0,2003,NA,NA,1156,667,489,104,32,72,0.1,0.07,0.09,4188,82,235,969
172051,SAGINAW VALLEY STATE UNIVERSITY,1,0,2004,NA,NA,1209,720,489,129,32,97,0.13,0.07,0.11,4271,84,243,1044
172051,Saginaw Valley State University,1,0,2005,NA,NA,1233,742,491,102,26,76,0.1,0.05,0.08,4877,90,258,1014
172051,Saginaw Valley State University,1,0,2006,NA,NA,1434,840,594,123,36,87,0.1,0.06,0.09,5130,96,266,1167
172051,Saginaw Valley State University,1,0,2007,NA,NA,1533,883,650,155,56,99,0.11,0.09,0.1,5832,102,279,1219
172051,Saginaw Valley State University,1,0,2008,NA,NA,1647,949,698,144,50,94,0.09,0.07,0.09,6054,115,286,1337
172051,Saginaw Valley State University,1,0,2009,NA,NA,1728,1028,700,177,59,118,0.11,0.08,0.1,6462,119,288,1338
172051,Saginaw Valley State University,1,0,2010,NA,NA,1729,1013,716,196,51,145,0.14,0.07,0.11,6870,126,296,1284
172699,WESTERN MICHIGAN UNIVERSITY,0,1,1991,1996,0,2778,1543,1235,432,162,270,0.17,0.13,0.16,2447,209,740,2379
172699,WESTERN MICHIGAN UNIVERSITY,0,1,1992,1996,0,2863,1614,1249,484,165,319,0.19,0.13,0.17,2807,239,709,2370
172699,WESTERN MICHIGAN UNIVERSITY,0,1,1993,1996,0,2810,1587,1223,538,161,377,0.23,0.13,0.19,2997,242,731,2439
172699,WESTERN MICHIGAN UNIVERSITY,0,1,1995,1996,0,3165,1851,1314,524,148,376,0.2,0.11,0.17,3242,264,729,2704
172699,WESTERN MICHIGAN UNIVERSITY,1,0,1996,1996,1,3121,1801,1320,557,177,380,0.21,0.13,0.18,3332,272,756,2672
172699,WESTERN MICHIGAN UNIVERSITY,1,0,1997,1996,1,3213,1835,1378,592,211,381,0.2,0.15,0.18,3655,288,751,2820
172699,WESTERN MICHIGAN UNIVERSITY,1,0,1998,1996,1,3621,1981,1640,699,255,444,0.22,0.16,0.19,3937,309,808,3198
172699,WESTERN MICHIGAN UNIVERSITY,1,0,1999,1996,1,4302,2288,2014,864,306,558,0.24,0.15,0.2,3453,328,799,3916
172699,WESTERN MICHIGAN UNIVERSITY,1,0,2000,1996,1,4429,2349,2080,865,323,542,0.23,0.16,0.2,3492,359,857,4012
172699,WESTERN MICHIGAN UNIVERSITY,1,0,2001,1996,1,4562,2306,2256,857,334,523,0.22,0.15,0.19,3897,384,916,4113
172699,WESTERN MICHIGAN UNIVERSITY,1,0,2002,1996,1,4442,2318,2124,941,381,560,0.24,0.18,0.21,4322,404,962,4020
172699,WESTERN MICHIGAN UNIVERSITY,1,0,2003,1996,1,4218,2191,2027,915,388,527,0.24,0.19,0.22,4933,421,962,3743
172699,WESTERN MICHIGAN UNIVERSITY,1,0,2004,1996,1,3725,1872,1853,802,301,501,0.26,0.16,0.22,5066,416,954,3246
172699,Western Michigan University,1,0,2005,1996,1,3702,1917,1785,919,374,545,0.28,0.21,0.25,5826,420,890,3272
172699,Western Michigan University,1,0,2006,1996,1,3531,1800,1731,852,359,493,0.27,0.21,0.24,6176,437,872,2977
172699,Western Michigan University,1,0,2007,1996,1,3473,1750,1723,842,362,480,0.27,0.21,0.24,6570,445,867,2838
172699,Western Michigan University,1,0,2008,1996,1,3803,1934,1869,880,381,499,0.25,0.2,0.23,7220,476,893,3067
172699,Western Michigan University,1,0,2009,1996,1,3162,1591,1571,718,279,439,0.27,0.18,0.23,7654,491,862,2453
172699,Western Michigan University,1,0,2010,1996,1,3346,1734,1612,721,259,462,0.26,0.16,0.22,8182,494,865,2502
173160,BETHEL COLLEGE,1,0,1991,NA,NA,272,183,89,157,49,108,0.59,0.55,0.58,9950,28,109,260
173160,BETHEL COLLEGE,1,0,1992,NA,NA,236,143,93,153,54,99,0.6900000000000001,0.58,0.65,10540,30,105,225
173160,BETHEL COLLEGE,1,0,1993,NA,NA,275,168,107,175,64,111,0.66,0.6,0.64,11050,31,103,262
173160,BETHEL COLLEGE,1,0,1995,NA,NA,475,303,172,282,90,192,0.63,0.52,0.59,12260,36,116,450
173160,BETHEL COLLEGE,1,0,1996,NA,NA,468,284,184,292,103,189,0.66,0.56,0.62,13180,40,115,439
173160,BETHEL COLLEGE,1,0,1997,NA,NA,447,281,166,279,98,181,0.64,0.59,0.62,13840,34,125,431
173160,BETHEL COLLEGE,1,0,1998,NA,NA,513,314,199,314,122,192,0.61,0.61,0.61,14720,37,132,485
173160,BETHEL COLLEGE,1,0,1999,NA,NA,479,315,164,295,98,197,0.62,0.6,0.62,15300,43,143,459
173160,BETHEL COLLEGE,1,0,2000,NA,NA,591,357,234,364,127,237,0.66,0.54,0.62,15900,45,153,568
173160,BETHEL COLLEGE,1,0,2001,NA,NA,645,385,260,442,173,269,0.6900000000000001,0.67,0.69,16780,48,163,614
173160,BETHEL COLLEGE,1,0,2002,NA,NA,567,348,219,370,125,245,0.7000000000000001,0.57,0.65,17700,51,171,540
173160,BETHEL COLLEGE,1,0,2003,NA,NA,690,419,271,427,172,255,0.6,0.63,0.62,18700,53,178,650
173160,BETHEL UNIVERSITY,1,0,2004,NA,NA,669,386,283,385,160,225,0.58,0.57,0.58,19880,57,189,615
173160,Bethel University,1,0,2005,NA,NA,683,425,258,436,149,287,0.67,0.58,0.64,21130,63,186,638
173160,Bethel University,1,0,2006,NA,NA,629,351,278,392,157,235,0.66,0.56,0.62,22590,67,198,575
173160,Bethel University,1,0,2007,NA,NA,597,370,227,374,126,248,0.67,0.56,0.63,24400,75,195,562
173160,Bethel University,1,0,2008,NA,NA,632,377,255,408,155,253,0.67,0.61,0.65,25750,80,207,578
173160,Bethel University,1,0,2009,NA,NA,683,387,296,430,169,261,0.67,0.57,0.63,26900,95,210,629
173160,Bethel University,1,0,2010,NA,NA,604,366,238,408,146,262,0.71,0.61,0.68,27950,89,195,557
173258,CARLETON COLLEGE,0,1,1991,Inf,0,471,247,224,387,175,212,0.85,0.78,0.82,16296,48,158,389
173258,CARLETON COLLEGE,0,1,1992,Inf,0,494,249,245,402,204,198,0.79,0.83,0.81,17360,51,154,399
173258,CARLETON COLLEGE,0,1,1993,Inf,0,488,252,236,391,185,206,0.81,0.78,0.8,18405,55,155,405
173258,CARLETON COLLEGE,0,1,1995,Inf,0,463,232,231,393,191,202,0.87,0.83,0.85,20300,61,163,379
173258,CARLETON COLLEGE,0,1,1996,Inf,0,471,256,215,387,164,223,0.87,0.76,0.82,21117,64,166,384
173258,CARLETON COLLEGE,0,1,1997,Inf,0,484,255,229,412,195,217,0.85,0.85,0.85,21885,58,169,405
173258,CARLETON COLLEGE,0,1,1998,Inf,0,520,279,241,450,204,246,0.88,0.85,0.87,22611,62,166,421
173258,CARLETON COLLEGE,0,1,1999,Inf,0,507,257,250,410,199,211,0.8200000000000001,0.8,0.81,23325,65,170,423
173258,CARLETON COLLEGE,0,1,2000,Inf,0,471,247,224,415,194,221,0.89,0.87,0.88,24240,70,170,385
173258,CARLETON COLLEGE,0,1,2001,Inf,0,516,265,251,467,222,245,0.92,0.88,0.91,25371,79,170,397
173258,CARLETON COLLEGE,0,1,2002,Inf,0,499,264,235,447,203,244,0.92,0.86,0.9,26745,89,202,350
173258,CARLETON COLLEGE,0,1,2003,Inf,0,488,241,247,435,215,220,0.91,0.87,0.89,28362,88,212,359
173258,CARLETON COLLEGE,0,1,2004,Inf,0,487,263,224,432,195,237,0.9,0.87,0.89,30501,86,220,355
173258,Carleton College,0,1,2005,Inf,0,542,278,264,478,226,252,0.9,0.86,0.88,32460,89,213,359
173258,Carleton College,0,1,2006,Inf,0,504,272,232,458,209,249,0.91,0.9,0.91,34083,94,212,368
173258,Carleton College,0,1,2007,Inf,0,509,255,254,456,221,235,0.92,0.87,0.9,35958,98,215,361
173258,Carleton College,0,1,2008,Inf,0,488,244,244,444,220,224,0.91,0.9,0.91,37845,102,216,335
173258,Carleton College,0,1,2009,Inf,0,528,272,256,480,222,258,0.9400000000000001,0.87,0.91,39546,109,222,352
173258,Carleton College,0,1,2010,Inf,0,511,268,243,451,209,242,0.9,0.86,0.88,41076,111,228,343
173328,CONCORDIA COLLEGE,0,1,1991,1998,0,151,94,57,31,10,21,0.22,0.18,0.21,8268,14,51,119
173328,CONCORDIA COLLEGE,0,1,1992,1998,0,149,90,59,39,12,27,0.3,0.2,0.26,9000,15,54,118
173328,CONCORDIA COLLEGE,0,1,1993,1998,0,138,77,61,39,16,23,0.29,0.26,0.28,9720,16,53,116
173328,CONCORDIA COLLEGE,0,1,1995,1998,0,153,91,62,42,13,29,0.31,0.21,0.27,10815,17,52,125
173328,CONCORDIA COLLEGE,0,1,1996,1998,0,161,82,79,53,25,28,0.34,0.32,0.33,11355,17,50,133
173328,CONCORDIA UNIVERSITY,0,1,1997,1998,0,222,132,90,86,32,54,0.4,0.36,0.39,11980,20,49,178
173328,CONCORDIA UNIVERSITY,1,0,1998,1998,1,213,106,107,57,24,33,0.31,0.22,0.27,12658,22,72,179
173328,CONCORDIA UNIVERSITY,1,0,1999,1998,1,258,142,116,76,32,44,0.3,0.28,0.29,13040,24,68,187
173328,CONCORDIA UNIVERSITY,1,0,2000,1998,1,212,124,88,57,15,42,0.33,0.17,0.27,14752,25,77,158
173328,CONCORDIA UNIVERSITY,1,0,2001,1998,1,200,87,113,57,26,31,0.35000000000000003,0.23,0.28,15786,28,86,138
173328,CONCORDIA UNIVERSITY,1,0,2002,1998,1,175,89,86,57,19,38,0.42,0.22,0.33,17326,30,81,137
173328,CONCORDIA UNIVERSITY-ST PAUL,1,0,2003,1998,1,167,83,84,59,25,34,0.4,0.3,0.35,18624,31,86,123
173328,CONCORDIA UNIVERSITY-ST PAUL,1,0,2004,1998,1,176,102,74,64,24,40,0.39,0.32,0.36,19928,34,81,127
173328,Concordia University-Saint Paul,1,0,2005,1998,1,163,84,79,53,21,32,0.38,0.27,0.33,21312,38,84,113
173328,Concordia University-Saint Paul,1,0,2006,1998,1,199,108,91,51,19,32,0.29,0.21,0.26,22378,37,89,139
173328,Concordia University-Saint Paul,1,0,2007,1998,1,201,112,89,61,20,41,0.36,0.22,0.3,23496,39,73,138
173328,Concordia University-Saint Paul,1,0,2008,1998,1,211,116,95,60,25,35,0.3,0.26,0.28,24900,33,78,137
173328,Concordia University-Saint Paul,1,0,2009,1998,1,183,82,101,56,22,34,0.41000000000000003,0.22,0.31,26400,35,70,110
173328,Concordia University-Saint Paul,1,0,2010,1998,1,217,126,91,81,19,62,0.49,0.21,0.37,27400,35,69,132
173647,GUSTAVUS ADOLPHUS COLLEGE,1,0,1991,NA,NA,624,336,288,464,210,254,0.75,0.73,0.74,11900,35,142,595
173647,GUSTAVUS ADOLPHUS COLLEGE,1,0,1992,NA,NA,620,327,293,455,224,231,0.7000000000000001,0.76,0.73,12600,38,160,582
173647,GUSTAVUS ADOLPHUS COLLEGE,1,0,1993,NA,NA,630,369,261,485,191,294,0.79,0.73,0.77,13400,40,162,584
173647,GUSTAVUS ADOLPHUS COLLEGE,1,0,1995,NA,NA,690,380,310,478,196,282,0.74,0.63,0.69,14760,47,164,659
173647,GUSTAVUS ADOLPHUS COLLEGE,1,0,1996,NA,NA,633,375,258,504,202,302,0.8,0.78,0.8,15350,50,164,585
173647,GUSTAVUS ADOLPHUS COLLEGE,1,0,1997,NA,NA,625,353,272,438,174,264,0.74,0.64,0.7,15940,42,165,592
173647,GUSTAVUS ADOLPHUS COLLEGE,1,0,1998,NA,NA,695,391,304,477,195,282,0.72,0.64,0.69,16560,42,166,663
173647,GUSTAVUS ADOLPHUS COLLEGE,1,0,1999,NA,NA,654,365,289,473,207,266,0.72,0.72,0.72,17200,47,170,612
173647,GUSTAVUS ADOLPHUS COLLEGE,1,0,2000,NA,NA,652,383,269,392,169,223,0.58,0.63,0.6,17970,53,172,603
173647,GUSTAVUS ADOLPHUS COLLEGE,1,0,2001,NA,NA,601,343,258,468,196,272,0.79,0.76,0.78,18940,55,174,546
173647,GUSTAVUS ADOLPHUS COLLEGE,1,0,2002,NA,NA,645,383,262,521,216,305,0.79,0.82,0.81,19215,59,185,601
173647,GUSTAVUS ADOLPHUS COLLEGE,1,0,2003,NA,NA,623,331,292,514,235,279,0.84,0.8,0.83,20405,59,178,571
173647,GUSTAVUS ADOLPHUS COLLEGE,1,0,2004,NA,NA,651,361,290,468,221,247,0.68,0.76,0.72,22625,59,183,584
173647,Gustavus Adolphus College,1,0,2005,NA,NA,739,439,300,588,208,380,0.86,0.69,0.8,25765,62,204,673
173647,Gustavus Adolphus College,1,0,2006,NA,NA,684,396,288,553,226,327,0.8200000000000001,0.78,0.81,26310,67,192,610
173647,Gustavus Adolphus College,1,0,2007,NA,NA,666,374,292,542,234,308,0.8200000000000001,0.8,0.81,28125,68,193,573
173647,Gustavus Adolphus College,1,0,2008,NA,NA,616,346,270,495,211,284,0.8200000000000001,0.78,0.8,29990,72,205,541
173647,Gustavus Adolphus College,1,0,2009,NA,NA,611,372,239,495,193,302,0.81,0.81,0.81,31460,75,215,514
173647,Gustavus Adolphus College,1,0,2010,NA,NA,585,314,271,454,208,246,0.78,0.77,0.78,33100,76,226,470
173902,MACALESTER COLLEGE,1,0,1991,NA,NA,403,206,197,284,126,158,0.76,0.64,0.7,13331,36,124,311
173902,MACALESTER COLLEGE,1,0,1992,NA,NA,475,258,217,332,139,193,0.74,0.64,0.7,14125,49,126,358
173902,MACALESTER COLLEGE,1,0,1993,NA,NA,452,252,200,318,128,190,0.75,0.64,0.7,15107,52,120,346
173902,MACALESTER COLLEGE,1,0,1995,NA,NA,437,231,206,322,143,179,0.77,0.69,0.74,16686,60,138,353
173902,MACALESTER COLLEGE,1,0,1996,NA,NA,491,293,198,377,151,226,0.77,0.76,0.77,17580,63,141,387
173902,MACALESTER COLLEGE,1,0,1997,NA,NA,450,251,199,339,140,199,0.79,0.7,0.75,18630,47,143,347
173902,MACALESTER COLLEGE,1,0,1998,NA,NA,465,260,205,339,153,186,0.71,0.75,0.73,19673,52,147,352
173902,MACALESTER COLLEGE,1,0,1999,NA,NA,460,271,189,360,147,213,0.78,0.78,0.78,20560,54,147,332
173902,MACALESTER COLLEGE,1,0,2000,NA,NA,454,299,155,366,126,240,0.8,0.81,0.81,21486,55,147,336
173902,MACALESTER COLLEGE,1,0,2001,NA,NA,505,265,240,415,193,222,0.8300000000000001,0.8,0.82,22480,60,148,379
173902,MACALESTER COLLEGE,1,0,2002,NA,NA,440,241,199,370,169,201,0.8300000000000001,0.85,0.84,23604,64,150,310
173902,MACALESTER COLLEGE,1,0,2003,NA,NA,513,300,213,422,168,254,0.84,0.79,0.82,24902,66,149,407
173902,MACALESTER COLLEGE,1,0,2004,NA,NA,485,284,201,410,164,246,0.86,0.82,0.85,26638,68,151,321
173902,MacAlester College,1,0,2005,NA,NA,491,287,204,405,158,247,0.86,0.77,0.82,28474,70,154,352
173902,Macalester College,1,0,2006,NA,NA,501,281,220,429,181,248,0.88,0.82,0.86,30870,75,154,353
173902,Macalester College,1,0,2007,NA,NA,485,270,215,411,176,235,0.87,0.82,0.85,33494,77,157,327
173902,Macalester College,1,0,2008,NA,NA,478,279,199,401,161,240,0.86,0.81,0.84,36304,83,164,346
173902,Macalester College,1,0,2009,NA,NA,564,329,235,481,196,285,0.86,0.83,0.85,37974,90,163,391
173902,Macalester College,1,0,2010,NA,NA,515,314,201,434,158,276,0.87,0.79,0.84,39846,90,165,332
174066,UNIVERSITY OF MINNESOTA TWIN CITIES,0,1,1991,1999,0,1979,917,1062,318,134,184,0.2,0.13,0.16,2829,1418,1513,1618
174066,UNIVERSITY OF MINNESOTA TWIN CITIES,0,1,1992,1999,0,1980,905,1075,329,137,192,0.21,0.13,0.17,3158,1887,1560,1634
174066,UNIVERSITY OF MINNESOTA TWIN CITIES,0,1,1993,1999,0,2272,1080,1192,413,171,242,0.22,0.14,0.18,3266,1444,1538,1848
174066,UNIVERSITY OF MINNESOTA TWIN CITIES,0,1,1995,1999,0,4128,2100,2028,984,418,566,0.26,0.21,0.24,3857,1616,1499,3308
174066,UNIVERSITY OF MINNESOTA TWIN CITIES,0,1,1996,1999,0,4057,2049,2008,1050,451,599,0.29,0.22,0.26,4320,1673,1478,3300
174066,UNIVERSITY OF MINNESOTA-TWIN CITIES,0,1,1997,1999,0,4371,2282,2089,1208,467,741,0.32,0.22,0.28,4749,1594,1446,3462
174066,UNIVERSITY OF MINNESOTA-TWIN CITIES,0,1,1998,1999,0,4992,2582,2410,1441,573,868,0.33,0.24,0.29,4963,1487,1440,3986
174066,UNIVERSITY OF MINNESOTA-TWIN CITIES,1,0,1999,1999,1,5025,2636,2389,1604,655,949,0.36,0.27,0.32,4171,1626,1461,4033
174066,UNIVERSITY OF MINNESOTA-TWIN CITIES,1,0,2000,1999,1,4865,2577,2288,1581,668,913,0.35000000000000003,0.29,0.32,4401,1636,1490,3853
174066,UNIVERSITY OF MINNESOTA-TWIN CITIES,1,0,2001,1999,1,5259,2677,2582,1939,841,1098,0.41000000000000003,0.33,0.37,4852,1755,1519,4248
174066,UNIVERSITY OF MINNESOTA-TWIN CITIES,1,0,2002,1999,1,5162,2762,2400,2118,869,1249,0.45,0.36,0.41,5420,1850,1559,4109
174066,UNIVERSITY OF MINNESOTA-TWIN CITIES,1,0,2003,1999,1,5160,2820,2340,2341,902,1439,0.51,0.39,0.45,5962,1964,1626,3970
174066,UNIVERSITY OF MINNESOTA-TWIN CITIES,1,0,2004,1999,1,5562,3081,2481,2549,994,1555,0.5,0.4,0.46,6677,1936,1669,4434
174066,University of Minnesota-Twin Cities,1,0,2005,1999,1,5274,2856,2418,2488,1023,1465,0.51,0.42,0.47,7140,2037,1677,4165
174066,University of Minnesota-Twin Cities,1,0,2006,1999,1,5418,2970,2448,2734,1150,1584,0.53,0.47,0.5,7588,2182,1710,4194
174066,University of Minnesota-Twin Cities,1,0,2007,1999,1,5256,2927,2329,2863,1182,1681,0.5700000000000001,0.51,0.54,7950,2328,2041,3990
174066,University of Minnesota-Twin Cities,1,0,2008,1999,1,5089,2813,2276,2975,1224,1751,0.62,0.54,0.58,8500,2610,1933,3729
174066,University of Minnesota-Twin Cities,1,0,2009,1999,1,5381,2849,2532,3188,1380,1808,0.63,0.55,0.59,9120,2682,1834,3986
174066,University of Minnesota-Twin Cities,1,0,2010,1999,1,5310,2810,2500,3251,1428,1823,0.64,0.57,0.61,9794,2743,1846,4074
174233,UNIVERSITY OF MINNESOTA DULUTH,0,1,1991,1999,0,1091,567,524,196,69,127,0.22,0.13,0.18,2750,86,281,975
174233,UNIVERSITY OF MINNESOTA DULUTH,0,1,1992,1999,0,1163,566,597,221,95,126,0.22,0.16,0.19,3044,51,290,1092
174233,UNIVERSITY OF MINNESOTA-DULUTH,0,1,1993,1999,0,1248,631,617,226,88,138,0.21,0.14,0.18,3137,96,285,1164
174233,UNIVERSITY OF MINNESOTA-DULUTH,0,1,1995,1999,0,1462,688,774,361,146,215,0.31,0.19,0.25,3745,90,327,1341
174233,UNIVERSITY OF MINNESOTA-DULUTH,0,1,1996,1999,0,1736,886,850,411,156,255,0.28,0.18,0.24,4187,93,334,1614
174233,UNIVERSITY OF MINNESOTA-DULUTH,0,1,1997,1999,0,1679,843,836,363,140,223,0.26,0.17,0.22,4522,97,335,1550
174233,UNIVERSITY OF MINNESOTA-DULUTH,0,1,1998,1999,0,1746,911,835,362,138,224,0.24,0.17,0.21,4725,103,342,1623
174233,UNIVERSITY OF MINNESOTA-DULUTH,1,0,1999,1999,1,2000,1032,968,416,168,248,0.24,0.17,0.21,4230,112,356,1869
174233,UNIVERSITY OF MINNESOTA-DULUTH,1,0,2000,1999,1,2088,1107,981,508,182,326,0.29,0.19,0.24,4463,117,370,1947
174233,UNIVERSITY OF MINNESOTA-DULUTH,1,0,2001,1999,1,2109,1094,1015,495,180,315,0.28,0.18,0.23,4920,128,385,1970
174233,UNIVERSITY OF MINNESOTA-DULUTH,1,0,2002,1999,1,2025,1029,996,476,183,293,0.28,0.18,0.24,5585,142,410,1870
174233,UNIVERSITY OF MINNESOTA-DULUTH,1,0,2003,1999,1,2155,1073,1082,514,218,296,0.27,0.2,0.24,6045,150,378,1972
174233,UNIVERSITY OF MINNESOTA-DULUTH,1,0,2004,1999,1,2205,1153,1052,568,208,360,0.31,0.2,0.26,6710,150,398,2021
174233,University of Minnesota-Duluth,1,0,2005,1999,1,2111,1025,1086,565,243,322,0.31,0.22,0.27,7157,164,417,1969
174233,University of Minnesota-Duluth,1,0,2006,1999,1,2283,1105,1178,629,270,359,0.32,0.23,0.28,7605,177,414,2122
174233,University of Minnesota-Duluth,1,0,2007,1999,1,2196,1100,1096,649,244,405,0.36,0.22,0.3,7700,190,430,2006
174233,University of Minnesota-Duluth,1,0,2008,1999,1,2213,1110,1103,760,306,454,0.4,0.28,0.34,8230,214,437,1999
174233,University of Minnesota-Duluth,1,0,2009,1999,1,2079,1028,1051,728,296,432,0.42,0.28,0.35,8830,212,431,1887
174233,University of Minnesota-Duluth,1,0,2010,1999,1,2316,1112,1204,819,356,463,0.41000000000000003,0.3,0.35,9482,200,439,2097
174251,UNIVERSITY OF MINNESOTA MORRIS,0,1,1991,2000,0,462,272,190,155,55,100,0.36,0.29,0.34,2781,22,116,384
174251,UNIVERSITY OF MINNESOTA MORRIS,0,1,1992,2000,0,497,291,206,187,67,120,0.41000000000000003,0.33,0.38,3246,13,113,435
174251,UNIVERSITY OF MINNESOTA-MORRIS,0,1,1993,2000,0,519,284,235,209,88,121,0.42,0.37,0.4,3417,23,112,440
174251,UNIVERSITY OF MINNESOTA-MORRIS,0,1,1995,2000,0,503,297,206,202,66,136,0.45,0.32,0.4,4189,23,113,430
174251,UNIVERSITY OF MINNESOTA-MORRIS,0,1,1996,2000,0,522,310,212,223,71,152,0.49,0.33,0.43,4554,25,115,447
174251,UNIVERSITY OF MINNESOTA-MORRIS,0,1,1997,2000,0,461,271,190,161,53,108,0.39,0.28,0.35,4766,25,111,387
174251,UNIVERSITY OF MINNESOTA-MORRIS,0,1,1998,2000,0,522,330,192,198,62,136,0.41000000000000003,0.32,0.38,4956,26,114,441
174251,UNIVERSITY OF MINNESOTA-MORRIS,0,1,1999,2000,0,453,270,183,174,70,104,0.38,0.38,0.38,4777,28,112,386
174251,UNIVERSITY OF MINNESOTA-MORRIS,1,0,2000,2000,1,467,267,200,186,66,120,0.44,0.33,0.4,5033,30,117,391
174251,UNIVERSITY OF MINNESOTA-MORRIS,1,0,2001,2000,1,474,296,178,206,74,132,0.44,0.42,0.43,5549,32,123,394
174251,UNIVERSITY OF MINNESOTA-MORRIS,1,0,2002,2000,1,475,309,166,219,71,148,0.47000000000000003,0.43,0.46,6381,34,123,404
174251,UNIVERSITY OF MINNESOTA-MORRIS,1,0,2003,2000,1,412,249,163,179,60,119,0.47000000000000003,0.37,0.43,6908,35,120,349
174251,UNIVERSITY OF MINNESOTA-MORRIS,1,0,2004,2000,1,383,235,148,205,73,132,0.56,0.49,0.54,7668,35,113,303
174251,University of Minnesota-Morris,1,0,2005,2000,1,353,207,146,171,63,108,0.52,0.43,0.48,8204,35,118,275
174251,University of Minnesota-Morris,1,0,2006,2000,1,377,214,163,179,66,113,0.52,0.4,0.47,8720,38,113,283
174251,University of Minnesota-Morris,1,0,2007,2000,1,358,205,153,180,65,115,0.56,0.42,0.5,7700,41,123,281
174251,University of Minnesota-Morris,1,0,2008,2000,1,373,209,164,200,80,120,0.5700000000000001,0.49,0.54,8230,44,112,286
174251,University of Minnesota-Morris,1,0,2009,2000,1,404,235,169,206,74,132,0.56,0.44,0.51,8830,41,105,315
174251,University of Minnesota-Morris,1,0,2010,2000,1,418,242,176,211,81,130,0.53,0.46,0.5,9482,41,110,295
174491,NORTHWESTERN COLLEGE,0,1,1991,1999,0,267,165,102,84,24,60,0.36,0.24,0.31,9096,23,53,260
174491,NORTHWESTERN COLLEGE,0,1,1992,1999,0,308,183,125,106,40,66,0.36,0.32,0.34,9825,27,57,297
174491,NORTHWESTERN COLLEGE,0,1,1993,1999,0,329,209,120,107,38,69,0.33,0.32,0.33,10659,29,57,314
174491,NORTHWESTERN COLLEGE,0,1,1995,1999,0,378,245,133,155,43,112,0.45,0.32,0.41,11985,31,54,366
174491,NORTHWESTERN COLLEGE,0,1,1996,1999,0,358,223,135,140,36,104,0.46,0.27,0.39,12750,33,57,336
174491,NORTHWESTERN COLLEGE,0,1,1997,1999,0,372,231,141,162,61,101,0.43,0.43,0.44,13125,25,61,352
174491,NORTHWESTERN COLLEGE,0,1,1998,1999,0,393,242,151,155,55,100,0.41000000000000003,0.36,0.39,13920,26,58,375
174491,NORTHWESTERN COLLEGE,1,0,1999,1999,1,392,262,130,160,42,118,0.45,0.32,0.41,14336,29,61,376
174491,NORTHWESTERN COLLEGE,1,0,2000,1999,1,430,279,151,178,52,126,0.45,0.34,0.41,14982,33,63,409
174491,NORTHWESTERN COLLEGE,1,0,2001,1999,1,400,262,138,184,54,130,0.49,0.39,0.46,15600,36,66,373
174491,NORTHWESTERN COLLEGE,1,0,2002,1999,1,431,267,164,183,75,108,0.4,0.46,0.42,16500,46,78,410
174491,NORTHWESTERN COLLEGE,1,0,2003,1999,1,431,291,140,191,55,136,0.46,0.39,0.44,17400,41,84,395
174491,NORTHWESTERN COLLEGE,1,0,2004,1999,1,409,245,164,194,67,127,0.51,0.41,0.47,18370,45,89,378
174491,Northwestern College,1,0,2005,1999,1,476,295,181,221,76,145,0.49,0.42,0.46,19100,48,89,424
174491,Northwestern College,1,0,2006,1999,1,498,302,196,256,89,167,0.55,0.45,0.51,19990,52,95,459
174491,Northwestern College,1,0,2007,1999,1,526,315,211,264,99,165,0.52,0.47,0.5,20990,56,98,478
174491,Northwestern College,1,0,2008,1999,1,455,273,182,202,62,140,0.51,0.34,0.44,22250,59,101,420
174491,Northwestern College,1,0,2009,1999,1,450,258,192,240,86,154,0.59,0.45,0.53,22990,62,101,404
174491,Northwestern College,1,0,2010,1999,1,451,247,204,219,89,130,0.52,0.44,0.49,24370,62,103,378
174792,SAINT JOHN'S UNIVERSITY,1,0,1991,NA,NA,415,0,415,247,247,0,NA,0.6,0.6,10135,33,129,380
174792,SAINT JOHN'S UNIVERSITY,1,0,1992,NA,NA,435,0,435,236,236,0,NA,0.54,0.54,10578,35,129,399
174792,SAINT JOHNS UNIVERSITY,1,0,1993,NA,NA,444,0,444,265,265,0,NA,0.6,0.6,11428,37,126,420
174792,SAINT JOHNS UNIVERSITY,1,0,1995,NA,NA,430,0,430,286,286,0,NA,0.67,0.67,13089,39,127,409
174792,SAINT JOHNS UNIVERSITY,1,0,1996,NA,NA,426,0,426,296,296,0,NA,0.69,0.69,13996,42,132,404
174792,SAINT JOHNS UNIVERSITY,1,0,1997,NA,NA,450,0,450,335,335,0,NA,0.74,0.74,14758,36,128,434
174792,SAINT JOHNS UNIVERSITY,1,0,1998,NA,NA,427,0,427,317,317,0,NA,0.74,0.74,15574,38,143,410
174792,SAINT JOHNS UNIVERSITY,1,0,1999,NA,NA,475,0,475,335,335,0,NA,0.71,0.71,16195,41,145,457
174792,SAINT JOHNS UNIVERSITY,1,0,2000,NA,NA,522,0,522,406,406,0,NA,0.78,0.78,16995,45,144,486
174792,SAINT JOHNS UNIVERSITY,1,0,2001,NA,NA,502,0,502,360,360,0,NA,0.72,0.72,18015,48,143,470
174792,SAINT JOHNS UNIVERSITY,1,0,2002,NA,NA,468,0,468,340,340,0,NA,0.73,0.73,18916,50,142,435
174792,SAINT JOHNS UNIVERSITY,1,0,2003,NA,NA,490,0,490,346,346,0,NA,0.71,0.71,20335,53,143,451
174792,SAINT JOHNS UNIVERSITY,1,0,2004,NA,NA,512,0,512,338,338,0,NA,0.66,0.66,21758,54,136,480
174792,Saint Johns University,1,0,2005,NA,NA,447,0,447,325,325,0,NA,0.73,0.73,23064,57,137,410
174792,Saint Johns University,1,0,2006,NA,NA,506,0,506,347,347,0,NA,0.69,0.69,24448,58,137,461
174792,Saint Johns University,1,0,2007,NA,NA,516,0,516,364,364,0,NA,0.71,0.71,26038,60,136,468
174792,Saint Johns University,1,0,2008,NA,NA,461,0,461,332,332,0,NA,0.72,0.72,28122,64,137,402
174792,Saint Johns University,1,0,2009,NA,NA,461,0,461,303,303,0,NA,0.66,0.66,29388,65,133,375
174792,Saint Johns University,1,0,2010,NA,NA,503,0,503,360,360,0,NA,0.72,0.72,31006,67,136,427
174844,SAINT OLAF COLLEGE,1,0,1991,NA,NA,733,391,342,534,246,288,0.73,0.72,0.73,12080,56,253,674
174844,SAINT OLAF COLLEGE,1,0,1992,NA,NA,701,409,292,501,192,309,0.75,0.66,0.71,12750,61,230,641
174844,SAINT OLAF COLLEGE,1,0,1993,NA,NA,737,413,324,515,215,300,0.72,0.66,0.7,13560,63,235,687
174844,SAINT OLAF COLLEGE,1,0,1995,NA,NA,742,431,311,557,223,334,0.77,0.72,0.75,15000,70,244,692
174844,SAINT OLAF COLLEGE,1,0,1996,NA,NA,771,448,323,565,228,337,0.75,0.71,0.73,15700,75,238,715
174844,SAINT OLAF COLLEGE,1,0,1997,NA,NA,722,416,306,539,227,312,0.75,0.74,0.75,16500,60,227,666
174844,SAINT OLAF COLLEGE,1,0,1998,NA,NA,756,431,325,594,256,338,0.78,0.79,0.79,17140,62,218,692
174844,SAINT OLAF COLLEGE,1,0,1999,NA,NA,761,451,310,594,225,369,0.81,0.73,0.78,18250,66,210,661
174844,SAINT OLAF COLLEGE,1,0,2000,NA,NA,753,441,312,600,232,368,0.8300000000000001,0.74,0.8,19400,70,202,675
174844,SAINT OLAF COLLEGE,1,0,2001,NA,NA,744,432,312,608,253,355,0.8200000000000001,0.81,0.82,21280,74,195,639
174844,SAINT OLAF COLLEGE,1,0,2002,NA,NA,777,479,298,645,235,410,0.85,0.79,0.83,22200,78,200,689
174844,SAINT OLAF COLLEGE,1,0,2003,NA,NA,719,422,297,593,234,359,0.85,0.79,0.82,23650,81,211,606
174844,SAINT OLAF COLLEGE,1,0,2004,NA,NA,777,446,331,631,258,373,0.8300000000000001,0.78,0.81,25150,86,198,632
174844,St. Olaf College,1,0,2005,NA,NA,764,426,338,617,270,347,0.81,0.8,0.81,26500,87,206,657
174844,St. Olaf College,1,0,2006,NA,NA,792,436,356,660,288,372,0.85,0.81,0.83,28200,89,199,688
174844,St. Olaf College,1,0,2007,NA,NA,751,406,345,624,287,337,0.8300000000000001,0.83,0.83,30600,95,207,652
174844,St. Olaf College,1,0,2008,NA,NA,813,454,359,698,292,406,0.89,0.81,0.86,34300,100,216,688
174844,St. Olaf College,1,0,2009,NA,NA,778,445,333,652,267,385,0.86,0.8,0.84,35500,104,220,640
174844,St Olaf College,1,0,2010,NA,NA,844,434,410,719,332,387,0.89,0.81,0.85,36800,105,229,690
174899,COLLEGE OF SAINT SCHOLASTICA,0,1,1991,1999,0,276,206,70,114,28,86,0.41000000000000003,0.4,0.41,9861,26,93,273
174899,COLLEGE OF SAINT SCHOLASTICA,0,1,1992,1999,0,325,240,85,126,36,90,0.37,0.42,0.39,10659,28,101,318
174899,COLLEGE OF SAINT SCHOLASTICA,0,1,1993,1999,0,254,193,61,120,25,95,0.49,0.41,0.47,11280,28,108,222
174899,COLLEGE OF SAINT SCHOLASTICA,0,1,1995,1999,0,270,201,69,142,30,112,0.55,0.43,0.53,12534,28,128,238
174899,COLLEGE OF SAINT SCHOLASTICA,0,1,1996,1999,0,295,229,66,145,36,109,0.47000000000000003,0.55,0.49,13131,31,113,265
174899,COLLEGE OF SAINT SCHOLASTICA,0,1,1997,1999,0,244,180,64,141,32,109,0.6,0.5,0.58,13995,25,119,211
174899,COLLEGE OF SAINT SCHOLASTICA,0,1,1998,1999,0,277,213,64,163,30,133,0.62,0.47,0.59,15060,27,93,245
174899,THE COLLEGE OF SAINT SCHOLASTICA,1,0,1999,1999,1,305,230,75,156,36,120,0.52,0.48,0.51,15420,24,101,275
174899,THE COLLEGE OF SAINT SCHOLASTICA,1,0,2000,1999,1,315,226,89,173,45,128,0.56,0.51,0.55,16190,25,101,287
174899,THE COLLEGE OF SAINT SCHOLASTICA,1,0,2001,1999,1,314,224,90,175,48,127,0.56,0.53,0.56,17080,26,102,288
174899,THE COLLEGE OF SAINT SCHOLASTICA,1,0,2002,1999,1,382,286,96,218,43,175,0.61,0.45,0.57,18106,30,105,348
174899,THE COLLEGE OF SAINT SCHOLASTICA,1,0,2003,1999,1,411,299,112,256,75,181,0.6,0.67,0.62,19192,34,111,371
174899,THE COLLEGE OF SAINT SCHOLASTICA,1,0,2004,1999,1,437,300,137,227,66,161,0.53,0.48,0.52,20630,38,124,382
174899,The College of Saint Scholastica,1,0,2005,1999,1,490,350,140,265,70,195,0.55,0.5,0.54,22110,43,133,438
174899,The College of Saint Scholastica,1,0,2006,1999,1,493,331,162,283,79,204,0.61,0.49,0.57,23434,46,135,412
174899,The College of Saint Scholastica,1,0,2007,1999,1,487,336,151,288,76,212,0.63,0.5,0.59,24840,49,145,423
174899,The College of Saint Scholastica,1,0,2008,1999,1,575,381,194,314,93,221,0.58,0.48,0.55,26324,54,155,476
174899,The College of Saint Scholastica,1,0,2009,1999,1,540,359,181,337,90,247,0.68,0.5,0.62,27114,59,166,476
174899,The College of Saint Scholastica,1,0,2010,1999,1,575,358,217,328,100,228,0.63,0.46,0.57,28200,62,175,489
174914,UNIVERSITY OF ST THOMAS,1,0,1991,NA,NA,854,457,397,393,174,219,0.47000000000000003,0.44,0.46,10564,92,280,784
174914,UNIVERSITY OF ST THOMAS,1,0,1992,NA,NA,798,444,354,362,141,221,0.49,0.4,0.45,11204,106,295,727
174914,UNIVERSITY OF ST THOMAS,1,0,1993,NA,NA,827,439,388,382,155,227,0.51,0.4,0.46,11748,111,310,737
174914,UNIVERSITY OF ST THOMAS,1,0,1995,NA,NA,852,454,398,430,181,249,0.54,0.45,0.5,13106,119,298,769
174914,UNIVERSITY OF ST THOMAS,1,0,1996,NA,NA,991,540,451,519,204,315,0.58,0.45,0.52,13778,126,299,919
174914,UNIVERSITY OF ST THOMAS,1,0,1997,NA,NA,955,514,441,595,237,358,0.6900000000000001,0.54,0.62,14660,121,317,869
174914,UNIVERSITY OF ST THOMAS,1,0,1998,NA,NA,1038,579,459,561,230,331,0.5700000000000001,0.5,0.54,15396,129,321,942
174914,UNIVERSITY OF ST THOMAS,1,0,1999,NA,NA,1087,603,484,642,255,387,0.64,0.53,0.59,16128,142,338,993
174914,UNIVERSITY OF ST THOMAS,1,0,2000,NA,NA,1082,578,504,597,244,353,0.61,0.48,0.55,17088,152,357,971
174914,UNIVERSITY OF ST THOMAS,1,0,2001,NA,NA,1080,579,501,601,253,348,0.6,0.5,0.56,18096,167,376,943
174914,UNIVERSITY OF ST THOMAS,1,0,2002,NA,NA,1095,577,518,629,280,349,0.6,0.54,0.57,19120,158,387,992
174914,UNIVERSITY OF ST THOMAS,1,0,2003,NA,NA,1038,547,491,584,244,340,0.62,0.5,0.56,20240,165,387,952
174914,UNIVERSITY OF ST THOMAS,1,0,2004,NA,NA,1161,608,553,710,312,398,0.65,0.56,0.61,21440,172,395,970
174914,University of St Thomas,1,0,2005,NA,NA,1325,706,619,812,342,470,0.66,0.55,0.61,22880,174,384,1115
174914,University of St Thomas,1,0,2006,NA,NA,1298,644,654,816,392,424,0.65,0.6,0.63,24368,183,395,1129
174914,University of St Thomas,1,0,2007,NA,NA,1313,672,641,822,365,457,0.68,0.57,0.63,25808,195,394,1111
174914,University of St Thomas,1,0,2008,NA,NA,1321,638,683,792,374,418,0.65,0.55,0.6,27328,205,410,1088
174914,University of St Thomas,1,0,2009,NA,NA,1350,586,764,812,439,373,0.63,0.57,0.6,28944,218,420,1106
174914,University of St Thomas,1,0,2010,NA,NA,1518,762,756,941,396,545,0.71,0.52,0.62,29952,215,433,1329
175342,ALCORN STATE UNIVERSITY,1,0,1991,NA,NA,899,520,379,108,25,83,0.15,0.07,0.12,2068,32,160,16
175342,ALCORN STATE UNIVERSITY,1,0,1992,NA,NA,531,310,221,73,16,57,0.18,0.07,0.14,2376,32,158,19
175342,ALCORN STATE UNIVERSITY,1,0,1993,NA,NA,506,299,207,100,24,76,0.25,0.12,0.2,2376,36,168,9
175342,ALCORN STATE UNIVERSITY,1,0,1995,NA,NA,746,410,336,148,38,110,0.26,0.11,0.2,2389,40,159,3
175342,ALCORN STATE UNIVERSITY,1,0,1996,NA,NA,621,384,237,175,44,131,0.34,0.19,0.28,2389,44,162,4
175342,ALCORN STATE UNIVERSITY,1,0,1997,NA,NA,532,299,233,138,42,96,0.32,0.18,0.26,2429,47,159,7
175342,ALCORN STATE UNIVERSITY,1,0,1998,NA,NA,556,306,250,140,41,99,0.32,0.16,0.25,2685,47,172,3
175342,ALCORN STATE UNIVERSITY,1,0,1999,NA,NA,553,309,244,130,41,89,0.28,0.17,0.24,2685,52,176,1
175342,ALCORN STATE UNIVERSITY,1,0,2000,NA,NA,489,248,241,107,28,79,0.31,0.12,0.22,2585,63,171,5
175342,ALCORN STATE UNIVERSITY,1,0,2001,NA,NA,495,262,233,97,36,61,0.23,0.15,0.2,2294,61,167,6
175342,ALCORN STATE UNIVERSITY,1,0,2002,NA,NA,423,249,174,86,23,63,0.25,0.13,0.2,2478,55,171,8
175342,ALCORN STATE UNIVERSITY,1,0,2003,NA,NA,495,271,224,108,32,76,0.28,0.14,0.22,2478,60,187,8
175342,ALCORN STATE UNIVERSITY,1,0,2004,NA,NA,572,309,263,116,33,83,0.26,0.13,0.2,2999,60,174,21
175342,Alcorn State University,1,0,2005,NA,NA,526,274,252,100,44,56,0.2,0.17,0.19,2733,63,186,17
175342,Alcorn State University,1,0,2006,NA,NA,545,302,243,79,34,45,0.14,0.14,0.14,3300,64,175,7
175342,Alcorn State University,1,0,2007,NA,NA,514,305,209,94,27,67,0.21,0.13,0.18,3432,72,172,3
175342,Alcorn State University,1,0,2008,NA,NA,451,261,190,87,36,51,0.19,0.19,0.19,3571,79,175,7
175342,Alcorn State University,1,0,2009,NA,NA,463,277,186,77,20,57,0.2,0.11,0.17,3571,77,183,12
175342,Alcorn State University,1,0,2010,NA,NA,588,341,247,94,25,69,0.2,0.1,0.16,3931,80,176,2
175421,BELHAVEN COLLEGE,1,0,1991,NA,NA,43,27,16,5,2,3,0.11,0.12,0.12,5850,6,28,29
175421,BELHAVEN COLLEGE,1,0,1992,NA,NA,89,52,37,22,10,12,0.23,0.27,0.25,6300,7,30,70
175421,BELHAVEN COLLEGE,1,0,1993,NA,NA,113,59,54,37,16,21,0.35000000000000003,0.3,0.33,6980,8,34,88
175421,BELHAVEN COLLEGE,1,0,1995,NA,NA,112,67,45,39,13,26,0.38,0.29,0.35,7890,11,36,90
175421,BELHAVEN COLLEGE,1,0,1996,NA,NA,84,42,42,21,11,10,0.23,0.26,0.25,8390,11,36,62
175421,BELHAVEN COLLEGE,1,0,1997,NA,NA,86,42,44,28,11,17,0.4,0.25,0.33,8990,10,38,71
175421,BELHAVEN COLLEGE,1,0,1998,NA,NA,112,53,59,35,12,23,0.43,0.2,0.31,9870,11,42,90
175421,BELHAVEN COLLEGE,1,0,1999,NA,NA,144,71,73,46,25,21,0.29,0.34,0.32,9960,11,46,101
175421,BELHAVEN COLLEGE,1,0,2000,NA,NA,182,95,87,50,19,31,0.32,0.22,0.27,10450,17,47,137
175421,BELHAVEN COLLEGE,1,0,2001,NA,NA,224,122,102,50,22,28,0.22,0.22,0.22,10990,19,48,160
175421,BELHAVEN COLLEGE,1,0,2002,NA,NA,266,150,116,68,19,49,0.32,0.16,0.26,11580,20,51,187
175421,BELHAVEN COLLEGE,1,0,2003,NA,NA,170,96,74,53,15,38,0.39,0.2,0.31,12200,26,56,127
175421,BELHAVEN COLLEGE,1,0,2004,NA,NA,237,144,93,94,28,66,0.45,0.3,0.4,12800,24,57,164
175421,Belhaven College,1,0,2005,NA,NA,201,105,96,68,16,52,0.49,0.17,0.34,13450,28,56,155
175421,Belhaven College,1,0,2006,NA,NA,248,133,115,76,31,45,0.33,0.27,0.31,14124,31,69,166
175421,Belhaven College,1,0,2007,NA,NA,241,134,107,60,15,45,0.33,0.14,0.25,15580,33,68,146
175421,Belhaven College,1,0,2008,NA,NA,239,146,93,79,27,52,0.35000000000000003,0.29,0.33,16360,35,68,141
175421,Belhaven University,1,0,2009,NA,NA,208,116,92,67,18,49,0.42,0.2,0.32,16780,37,68,123
175421,Belhaven University,1,0,2010,NA,NA,234,126,108,65,17,48,0.38,0.16,0.28,17700,41,69,117
175616,DELTA STATE UNIVERSITY,1,0,1991,NA,NA,445,283,162,111,33,78,0.27,0.2,0.25,2000,28,176,341
175616,DELTA STATE UNIVERSITY,1,0,1992,NA,NA,443,247,196,98,35,63,0.25,0.18,0.22,2194,29,172,345
175616,DELTA STATE UNIVERSITY,1,0,1993,NA,NA,450,255,195,81,28,53,0.2,0.14,0.18,2194,30,175,360
175616,DELTA STATE UNIVERSITY,1,0,1995,NA,NA,464,301,163,102,25,77,0.25,0.15,0.22,2294,37,185,333
175616,DELTA STATE UNIVERSITY,1,0,1996,NA,NA,449,278,171,94,27,67,0.24,0.16,0.21,2294,38,191,306
175616,DELTA STATE UNIVERSITY,1,0,1997,NA,NA,521,338,183,136,40,96,0.28,0.22,0.26,2354,39,187,368
175616,DELTA STATE UNIVERSITY,1,0,1998,NA,NA,427,265,162,100,23,77,0.29,0.14,0.23,2596,42,184,298
175616,DELTA STATE UNIVERSITY,1,0,1999,NA,NA,458,275,183,107,38,69,0.25,0.21,0.23,2054,46,191,334
175616,DELTA STATE UNIVERSITY,1,0,2000,NA,NA,461,273,188,111,24,87,0.31,0.13,0.24,2145,49,187,331
175616,DELTA STATE UNIVERSITY,1,0,2001,NA,NA,430,253,177,77,21,56,0.22,0.12,0.18,2549,49,184,308
175616,DELTA STATE UNIVERSITY,1,0,2002,NA,NA,336,200,136,58,13,45,0.22,0.1,0.17,2924,50,166,236
175616,DELTA STATE UNIVERSITY,1,0,2003,NA,NA,327,191,136,55,19,36,0.18,0.14,0.17,2924,56,146,198
175616,DELTA STATE UNIVERSITY,1,0,2004,NA,NA,381,211,170,76,24,52,0.24,0.14,0.2,3092,65,167,258
175616,Delta State University,1,0,2005,NA,NA,393,222,171,67,25,42,0.18,0.15,0.17,3272,67,165,236
175616,Delta State University,1,0,2006,NA,NA,468,288,180,85,33,52,0.18,0.18,0.18,3518,64,163,294
175616,Delta State University,1,0,2007,NA,NA,477,293,184,78,27,51,0.17,0.15,0.16,3708,60,179,268
175616,Delta State University,1,0,2008,NA,NA,384,227,157,58,19,39,0.17,0.12,0.15,3946,63,192,221
175616,Delta State University,1,0,2009,NA,NA,367,230,137,62,22,40,0.17,0.16,0.17,3946,61,193,189
175616,Delta State University,1,0,2010,NA,NA,370,208,162,61,25,36,0.17,0.15,0.16,4347,65,186,219
175856,JACKSON STATE UNIVERSITY,1,0,1991,NA,NA,1081,615,466,113,34,79,0.12,0.07,0.1,2028,65,302,2
175856,JACKSON STATE UNIVERSITY,1,0,1992,NA,NA,906,477,429,89,21,68,0.14,0.05,0.1,2230,65,314,4
175856,JACKSON STATE UNIVERSITY,1,0,1993,NA,NA,1105,596,509,124,35,89,0.14,0.07,0.11,2230,67,328,3
175856,JACKSON STATE UNIVERSITY,1,0,1995,NA,NA,1212,679,533,162,39,123,0.18,0.07,0.13,2380,80,325,2
175856,JACKSON STATE UNIVERSITY,1,0,1996,NA,NA,906,508,398,140,33,107,0.21,0.08,0.15,2380,85,307,2
175856,JACKSON STATE UNIVERSITY,1,0,1997,NA,NA,808,463,345,124,28,96,0.2,0.08,0.15,2380,74,315,5
175856,JACKSON STATE UNIVERSITY,1,0,1998,NA,NA,842,494,348,155,43,112,0.22,0.12,0.18,2688,79,318,0
175856,JACKSON STATE UNIVERSITY,1,0,1999,NA,NA,845,527,318,128,34,94,0.17,0.11,0.15,2688,84,327,1
175856,JACKSON STATE UNIVERSITY,1,0,2000,NA,NA,936,547,389,134,40,94,0.17,0.1,0.14,2788,114,335,2
175856,JACKSON STATE UNIVERSITY,1,0,2001,NA,NA,930,540,390,154,35,119,0.22,0.09,0.17,3206,125,343,4
175856,JACKSON STATE UNIVERSITY,1,0,2002,NA,NA,1014,581,433,206,49,157,0.27,0.11,0.2,3462,135,339,5
175856,JACKSON STATE UNIVERSITY,1,0,2003,NA,NA,883,470,413,141,43,98,0.2,0.1,0.16,3612,149,356,2
175856,JACKSON STATE UNIVERSITY,1,0,2004,NA,NA,995,587,408,200,50,150,0.25,0.12,0.2,3842,166,360,5
175856,Jackson State University,1,0,2005,NA,NA,1131,690,441,221,64,157,0.22,0.15,0.2,3964,172,367,18
175856,Jackson State University,1,0,2006,NA,NA,889,513,376,191,57,134,0.26,0.15,0.21,4224,172,354,19
175856,Jackson State University,1,0,2007,NA,NA,919,541,378,153,41,112,0.2,0.11,0.17,4432,180,384,18
175856,Jackson State University,1,0,2008,NA,NA,938,547,391,177,48,129,0.23,0.12,0.19,4634,183,344,15
175856,Jackson State University,1,0,2009,NA,NA,841,507,334,157,47,110,0.21,0.14,0.19,4634,182,406,14
175856,Jackson State University,1,0,2010,NA,NA,879,489,390,169,52,117,0.23,0.13,0.19,5050,177,380,33
175980,MILLSAPS COLLEGE,1,0,1991,NA,NA,273,140,133,170,73,97,0.6900000000000001,0.55,0.62,9710,20,83,256
175980,MILLSAPS COLLEGE,1,0,1992,NA,NA,274,143,131,167,75,92,0.64,0.57,0.61,10280,20,83,252
175980,MILLSAPS COLLEGE,1,0,1993,NA,NA,319,161,158,189,95,94,0.58,0.6,0.59,11236,43,85,304
175980,MILLSAPS COLLEGE,1,0,1995,NA,NA,261,128,133,180,74,106,0.8200000000000001,0.56,0.69,12700,25,89,237
175980,MILLSAPS COLLEGE,1,0,1996,NA,NA,292,163,129,166,64,102,0.62,0.5,0.57,13088,28,91,262
175980,MILLSAPS COLLEGE,1,0,1997,NA,NA,299,159,140,188,84,104,0.65,0.6,0.63,13612,23,92,263
175980,MILLSAPS COLLEGE,1,0,1998,NA,NA,286,145,141,169,79,90,0.62,0.56,0.59,14424,24,89,243
175980,MILLSAPS COLLEGE,1,0,1999,NA,NA,284,158,126,177,67,110,0.6900000000000001,0.53,0.62,14190,25,89,244
175980,MILLSAPS COLLEGE,1,0,2000,NA,NA,292,152,140,176,82,94,0.61,0.59,0.6,14900,28,91,246
175980,MILLSAPS COLLEGE,1,0,2001,NA,NA,324,178,146,208,80,128,0.71,0.55,0.64,15586,29,93,273
175980,MILLSAPS COLLEGE,1,0,2002,NA,NA,251,125,126,159,75,84,0.67,0.6,0.63,16364,28,93,204
175980,MILLSAPS COLLEGE,1,0,2003,NA,NA,259,141,118,152,63,89,0.63,0.53,0.59,17346,29,93,218
175980,MILLSAPS COLLEGE,1,0,2004,NA,NA,278,136,142,170,83,87,0.63,0.58,0.61,18386,29,93,219
175980,Millsaps College,1,0,2005,NA,NA,258,118,140,158,76,82,0.6900000000000001,0.54,0.61,19490,30,92,208
175980,Millsaps College,1,0,2006,NA,NA,225,122,103,149,63,86,0.7000000000000001,0.61,0.66,20660,31,92,183
175980,Millsaps College,1,0,2007,NA,NA,296,154,142,175,75,100,0.64,0.53,0.59,21900,32,90,247
175980,Millsaps College,1,0,2008,NA,NA,266,141,125,165,66,99,0.7000000000000001,0.53,0.62,23214,35,99,188
175980,Millsaps College,1,0,2009,NA,NA,281,116,165,166,80,86,0.74,0.48,0.59,24608,40,95,205
175980,Millsaps College,1,0,2010,NA,NA,211,106,105,145,69,76,0.71,0.66,0.69,26084,36,101,149
176017,UNIVERSITY OF MISSISSIPPI MAIN CAMPUS,1,0,1991,NA,NA,1690,892,798,484,169,315,0.35000000000000003,0.21,0.29,2221,124,430,1537
176017,UNIVERSITY OF MISSISSIPPI MAIN CAMPUS,1,0,1992,NA,NA,1610,810,800,460,175,285,0.35000000000000003,0.22,0.29,2435,125,424,1448
176017,UNIVERSITY OF MISSISSIPPI MAIN CAMPUS,1,0,1993,NA,NA,1538,796,742,461,156,305,0.38,0.21,0.3,2456,137,439,1386
176017,UNIVERSITY OF MISSISSIPPI MAIN CAMPUS,1,0,1995,NA,NA,1526,825,701,490,180,310,0.37,0.26,0.32,2546,160,440,1363
176017,UNIVERSITY OF MISSISSIPPI MAIN CAMPUS,1,0,1996,NA,NA,1736,909,827,580,199,381,0.41000000000000003,0.24,0.33,2631,164,474,1512
176017,UNIVERSITY OF MISSISSIPPI MAIN CAMPUS,1,0,1997,NA,NA,1770,948,822,578,209,369,0.38,0.25,0.33,2731,166,456,1526
176017,UNIVERSITY OF MISSISSIPPI MAIN CAMPUS,1,0,1998,NA,NA,1794,920,874,602,213,389,0.42,0.24,0.34,3053,172,464,1577
176017,UNIVERSITY OF MISSISSIPPI MAIN CAMPUS,1,0,1999,NA,NA,1810,944,866,621,218,403,0.42,0.25,0.34,3053,192,485,1537
176017,UNIVERSITY OF MISSISSIPPI MAIN CAMPUS,1,0,2000,NA,NA,1981,1019,962,655,248,407,0.39,0.26,0.33,3153,218,498,1693
176017,UNIVERSITY OF MISSISSIPPI MAIN CAMPUS,1,0,2001,NA,NA,2126,1110,1016,402,215,187,0.16,0.21,0.19,3626,245,512,1788
176017,UNIVERSITY OF MISSISSIPPI MAIN CAMPUS,1,0,2002,NA,NA,2230,1150,1080,724,271,453,0.39,0.25,0.32,3916,256,575,1871
176017,UNIVERSITY OF MISSISSIPPI MAIN CAMPUS,1,0,2003,NA,NA,2377,1297,1080,851,286,565,0.43,0.26,0.36,3916,266,587,1991
176017,UNIVERSITY OF MISSISSIPPI MAIN CAMPUS,1,0,2004,NA,NA,2248,1185,1063,761,292,469,0.39,0.27,0.34,4110,265,591,1906
176017,University of Mississippi Main Campus,1,0,2005,NA,NA,2131,1139,992,800,280,520,0.45,0.28,0.38,4320,280,622,1823
176017,University of Mississippi Main Campus,1,0,2006,NA,NA,2521,1320,1201,920,352,568,0.43,0.29,0.36,4602,303,647,2061
176017,University of Mississippi Main Campus,1,0,2007,NA,NA,2434,1293,1141,885,328,557,0.43,0.29,0.36,4932,327,653,2002
176017,University of Mississippi Main Campus,1,0,2008,NA,NA,2316,1272,1044,857,301,556,0.43,0.29,0.37,5106,350,702,1846
176017,University of Mississippi Main Campus,1,0,2009,NA,NA,2547,1358,1189,996,360,636,0.46,0.3,0.39,5106,358,711,2012
176017,University of Mississippi Main Campus,1,0,2010,NA,NA,3065,1580,1485,1135,440,695,0.43,0.3,0.37,5436,369,723,2321
176035,MISSISSIPPI UNIVERSITY FOR WOMEN,1,0,1991,NA,NA,339,282,57,99,10,89,0.31,0.18,0.29,2043,19,104,273
176035,MISSISSIPPI UNIVERSITY FOR WOMEN,1,0,1992,NA,NA,259,210,49,52,6,46,0.21,0.12,0.2,2239,21,110,197
176035,MISSISSIPPI UNIVERSITY FOR WOMEN,1,0,1993,NA,NA,272,229,43,68,5,63,0.27,0.12,0.25,2239,22,112,190
176035,MISSISSIPPI UNIVERSITY FOR WOMEN,1,0,1995,NA,NA,288,238,50,59,7,52,0.21,0.14,0.2,2244,27,122,205
176035,MISSISSIPPI UNIVERSITY FOR WOMEN,1,0,1996,NA,NA,291,248,43,58,2,56,0.22,0.05,0.2,2284,29,118,214
176035,MISSISSIPPI UNIVERSITY FOR WOMEN,1,0,1997,NA,NA,231,193,38,71,6,65,0.33,0.16,0.31,2284,30,129,171
176035,MISSISSIPPI UNIVERSITY FOR WOMEN,1,0,1998,NA,NA,210,180,30,47,4,43,0.23,0.13,0.22,2556,33,129,150
176035,MISSISSIPPI UNIVERSITY FOR WOMEN,1,0,1999,NA,NA,202,177,25,59,3,56,0.31,0.12,0.29,2556,34,132,128
176035,MISSISSIPPI UNIVERSITY FOR WOMEN,1,0,2000,NA,NA,205,190,15,57,0,57,0.3,0,0.28,2656,36,133,132
176035,MISSISSIPPI UNIVERSITY FOR WOMEN,1,0,2001,NA,NA,189,163,26,44,3,41,0.25,0.12,0.23,3054,35,134,129
176035,MISSISSIPPI UNIVERSITY FOR WOMEN,1,0,2002,NA,NA,250,223,27,61,2,59,0.26,0.07,0.24,3298,35,129,162
176035,MISSISSIPPI UNIVERSITY FOR WOMEN,1,0,2003,NA,NA,202,178,24,48,3,45,0.25,0.12,0.24,3298,52,134,136
176035,MISSISSIPPI UNIVERSITY FOR WOMEN,1,0,2004,NA,NA,242,207,35,55,1,54,0.26,0.03,0.23,3495,46,135,161
176035,Mississippi University for Women,1,0,2005,NA,NA,238,204,34,53,5,48,0.23,0.15,0.22,3690,47,135,147
176035,Mississippi University for Women,1,0,2006,NA,NA,256,243,13,53,3,50,0.2,0.23,0.21,3933,39,131,145
176035,Mississippi University for Women,1,0,2007,NA,NA,235,213,22,46,6,40,0.18,0.27,0.2,4209,41,135,123
176035,Mississippi University for Women,1,0,2008,NA,NA,252,212,40,54,7,47,0.22,0.17,0.21,4423,42,135,121
176035,Mississippi University for Women,1,0,2009,NA,NA,216,177,39,56,10,46,0.25,0.26,0.26,4423,42,134,103
176035,Mississippi University for Women,1,0,2010,NA,NA,199,154,45,50,7,43,0.27,0.16,0.25,4644,42,130,105
176044,MISSISSIPPI VALLEY STATE UNIVERSITY,1,0,1991,NA,NA,386,223,163,34,7,27,0.12,0.04,0.09,1952,21,98,0
176044,MISSISSIPPI VALLEY STATE UNIVERSITY,1,0,1992,NA,NA,563,290,273,64,26,38,0.13,0.1,0.11,2164,23,95,6
176044,MISSISSIPPI VALLEY STATE UNIVERSITY,1,0,1993,NA,NA,478,256,222,57,19,38,0.14,0.09,0.12,2164,24,106,1
176044,MISSISSIPPI VALLEY STATE UNIVERSITY,1,0,1995,NA,NA,448,244,204,87,23,64,0.26,0.11,0.19,2278,29,111,2
176044,MISSISSIPPI VALLEY STATE UNIVERSITY,1,0,1996,NA,NA,367,170,197,59,26,33,0.19,0.13,0.16,2278,29,118,2
176044,MISSISSIPPI VALLEY STATE UNIVERSITY,1,0,1997,NA,NA,343,198,145,73,23,50,0.25,0.16,0.21,2353,32,118,2
176044,MISSISSIPPI VALLEY STATE UNIVERSITY,1,0,1998,NA,NA,321,182,139,68,16,52,0.28,0.12,0.21,2646,33,110,4
176044,MISSISSIPPI VALLEY STATE UNIVERSITY,1,0,1999,NA,NA,248,138,110,48,18,30,0.21,0.16,0.19,2646,37,107,1
176044,MISSISSIPPI VALLEY STATE UNIVERSITY,1,0,2000,NA,NA,297,173,124,41,13,28,0.16,0.1,0.14,2746,39,112,3
176044,MISSISSIPPI VALLEY STATE UNIVERSITY,1,0,2001,NA,NA,258,158,100,42,9,33,0.2,0.09,0.16,3158,42,117,3
176044,MISSISSIPPI VALLEY STATE UNIVERSITY,1,0,2002,NA,NA,269,129,140,37,14,23,0.17,0.1,0.14,3411,53,105,9
176044,MISSISSIPPI VALLEY STATE UNIVERSITY,1,0,2003,NA,NA,325,187,138,57,16,41,0.21,0.12,0.18,3411,50,110,13
176044,MISSISSIPPI VALLEY STATE UNIVERSITY,1,0,2004,NA,NA,372,184,188,51,15,36,0.19,0.08,0.14,3832,54,115,8
176044,Mississippi Valley State University,1,0,2005,NA,NA,398,197,201,43,13,30,0.15,0.06,0.11,4024,66,117,18
176044,Mississippi Valley State University,1,0,2006,NA,NA,443,216,227,55,14,41,0.18,0.06,0.12,4247,69,121,25
176044,Mississippi Valley State University,1,0,2007,NA,NA,485,256,229,51,15,36,0.14,0.07,0.11,4417,69,136,15
176044,Mississippi Valley State University,1,0,2008,NA,NA,446,203,243,57,23,34,0.16,0.09,0.13,4574,71,138,15
176044,Mississippi Valley State University,1,0,2009,NA,NA,413,222,191,43,13,30,0.13,0.07,0.1,4754,75,133,18
176044,Mississippi Valley State University,1,0,2010,NA,NA,382,192,190,68,25,43,0.22,0.13,0.18,4781,64,126,12
176080,MISSISSIPPI STATE UNIVERSITY,1,0,1991,NA,NA,1569,715,854,320,134,186,0.26,0.16,0.2,2223,227,761,1291
176080,MISSISSIPPI STATE UNIVERSITY,1,0,1992,NA,NA,1672,760,912,316,130,186,0.24,0.14,0.19,2474,228,666,1338
176080,MISSISSIPPI STATE UNIVERSITY,1,0,1993,NA,NA,1633,777,856,330,118,212,0.27,0.14,0.2,2474,239,669,1286
176080,MISSISSIPPI STATE UNIVERSITY,1,0,1995,NA,NA,1826,845,981,382,158,224,0.26,0.16,0.21,2591,286,779,1430
176080,MISSISSIPPI STATE UNIVERSITY,1,0,1996,NA,NA,1864,869,995,463,175,288,0.33,0.18,0.25,2631,294,828,1506
176080,MISSISSIPPI STATE UNIVERSITY,1,0,1997,NA,NA,2016,965,1051,462,162,300,0.31,0.15,0.23,2731,305,822,1578
176080,MISSISSIPPI STATE UNIVERSITY,1,0,1998,NA,NA,1929,944,985,501,178,323,0.34,0.18,0.26,3017,330,851,1450
176080,MISSISSIPPI STATE UNIVERSITY,1,0,1999,NA,NA,2033,1003,1030,507,177,330,0.32,0.17,0.25,3017,371,892,1511
176080,MISSISSIPPI STATE UNIVERSITY,1,0,2000,NA,NA,2055,1057,998,556,204,352,0.33,0.2,0.27,3117,401,887,1540
176080,MISSISSIPPI STATE UNIVERSITY,1,0,2001,NA,NA,1826,909,917,483,201,282,0.31,0.22,0.26,3586,419,883,1444
176080,MISSISSIPPI STATE UNIVERSITY,1,0,2002,NA,NA,1737,833,904,476,181,295,0.35000000000000003,0.2,0.27,3874,420,1011,1373
176080,MISSISSIPPI STATE UNIVERSITY,1,0,2003,NA,NA,1659,822,837,509,185,324,0.39,0.22,0.31,3874,427,1043,1303
176080,MISSISSIPPI STATE UNIVERSITY,1,0,2004,NA,NA,1735,829,906,492,193,299,0.36,0.21,0.28,4106,443,1044,1291
176080,Mississippi State University,1,0,2005,NA,NA,1951,1010,941,585,215,370,0.36,0.23,0.3,4312,466,819,1408
176080,Mississippi State University,1,0,2006,NA,NA,1897,947,950,575,233,342,0.36,0.25,0.3,4596,483,826,1396
176080,Mississippi State University,1,0,2007,NA,NA,2262,1105,1157,699,274,425,0.38,0.24,0.31,4978,534,824,1662
176080,Mississippi State University,1,0,2008,NA,NA,2474,1278,1196,746,282,464,0.36,0.24,0.3,5151,567,854,1811
176080,Mississippi State University,1,0,2009,NA,NA,2447,1210,1237,755,282,473,0.39,0.23,0.31,5151,582,897,1778
176080,Mississippi State University,1,0,2010,NA,NA,2688,1308,1380,847,348,499,0.38,0.25,0.32,5461,591,850,1857
176406,TOUGALOO COLLEGE,1,0,1991,NA,NA,317,205,112,61,16,45,0.21,0.14,0.19,4395,10,64,0
176406,TOUGALOO COLLEGE,1,0,1992,NA,NA,325,215,110,69,15,54,0.25,0.14,0.21,4835,12,53,0
176406,TOUGALOO COLLEGE,1,0,1993,NA,NA,311,223,88,79,17,62,0.27,0.19,0.25,4795,13,66,0
176406,TOUGALOO COLLEGE,1,0,1995,NA,NA,218,141,77,65,19,46,0.32,0.25,0.3,5440,15,64,0
176406,TOUGALOO COLLEGE,1,0,1996,NA,NA,211,144,67,68,11,57,0.39,0.16,0.32,5712,15,68,0
176406,TOUGALOO COLLEGE,1,0,1997,NA,NA,206,146,60,66,11,55,0.37,0.18,0.32,6160,14,67,0
176406,TOUGALOO COLLEGE,1,0,1998,NA,NA,198,142,56,66,12,54,0.38,0.21,0.33,6610,14,59,0
176406,TOUGALOO COLLEGE,1,0,1999,NA,NA,252,196,56,73,11,62,0.31,0.2,0.29,6400,15,58,0
176406,TOUGALOO COLLEGE,1,0,2000,NA,NA,224,168,56,66,15,51,0.3,0.27,0.29,6600,17,61,0
176406,TOUGALOO COLLEGE,1,0,2001,NA,NA,201,137,64,58,13,45,0.32,0.2,0.29,6900,19,64,0
176406,TOUGALOO COLLEGE,1,0,2002,NA,NA,209,149,60,55,12,43,0.28,0.2,0.26,7245,22,63,0
176406,TOUGALOO COLLEGE,1,0,2003,NA,NA,221,166,55,53,9,44,0.26,0.16,0.24,7750,23,64,1
176406,TOUGALOO COLLEGE,1,0,2004,NA,NA,278,190,88,68,16,52,0.27,0.18,0.24,8140,24,71,0
176406,Tougaloo College,1,0,2005,NA,NA,207,146,61,61,15,46,0.31,0.25,0.29,8800,24,80,0
176406,Tougaloo College,1,0,2006,NA,NA,243,172,71,74,15,59,0.34,0.21,0.3,8800,30,74,1
176406,Tougaloo College,1,0,2007,NA,NA,200,135,65,53,9,44,0.32,0.14,0.26,9240,27,74,0
176406,Tougaloo College,1,0,2008,NA,NA,237,158,79,68,19,49,0.31,0.24,0.29,9240,22,76,1
176406,Tougaloo College,1,0,2009,NA,NA,231,154,77,57,12,45,0.29,0.16,0.25,9240,24,76,4
176406,Tougaloo College,1,0,2010,NA,NA,198,126,72,50,10,40,0.31,0.14,0.25,9240,22,76,4
176628,AVILA COLLEGE,1,0,1991,NA,NA,88,53,35,27,8,19,0.35000000000000003,0.23,0.31,7380,7,59,73
176628,AVILA COLLEGE,1,0,1992,NA,NA,91,50,41,21,10,11,0.22,0.24,0.23,7980,8,50,83
176628,AVILA COLLEGE,1,0,1993,NA,NA,84,57,27,25,3,22,0.38,0.11,0.3,8490,9,52,74
176628,AVILA COLLEGE,1,0,1995,NA,NA,101,61,40,31,11,20,0.32,0.28,0.31,9600,10,55,78
176628,AVILA COLLEGE,1,0,1996,NA,NA,91,56,35,20,5,15,0.26,0.14,0.22,10100,11,55,83
176628,AVILA COLLEGE,1,0,1997,NA,NA,96,57,39,29,6,23,0.4,0.15,0.3,10700,12,54,68
176628,AVILA COLLEGE,1,0,1998,NA,NA,113,64,49,39,9,30,0.46,0.18,0.35,11410,12,54,95
176628,AVILA COLLEGE,1,0,1999,NA,NA,113,81,32,45,7,38,0.46,0.22,0.4,11800,13,56,91
176628,AVILA COLLEGE,1,0,2000,NA,NA,162,91,71,36,5,31,0.34,0.07,0.22,12500,15,57,127
176628,AVILA COLLEGE,1,0,2001,NA,NA,155,62,93,32,7,25,0.4,0.08,0.21,13150,16,59,119
176628,AVILA UNIVERSITY,1,0,2002,NA,NA,129,70,59,29,5,24,0.34,0.08,0.22,13900,18,62,94
176628,AVILA UNIVERSITY,1,0,2003,NA,NA,152,93,59,36,5,31,0.33,0.08,0.24,14700,16,63,111
176628,AVILA UNIVERSITY,1,0,2004,NA,NA,129,88,41,39,3,36,0.4,0.07,0.3,15500,17,63,104
176628,Avila University,1,0,2005,NA,NA,154,95,59,38,11,27,0.28,0.19,0.25,16300,18,64,111
176628,Avila University,1,0,2006,NA,NA,138,78,60,34,11,23,0.29,0.18,0.25,17300,19,69,107
176628,Avila University,1,0,2007,NA,NA,114,79,35,30,5,25,0.31,0.14,0.26,18300,19,72,96
176628,Avila University,1,0,2008,NA,NA,183,105,78,45,9,36,0.34,0.12,0.25,19500,21,64,156
176628,Avila University,1,0,2009,NA,NA,118,79,39,36,9,27,0.34,0.23,0.31,20250,22,65,93
176628,Avila University,1,0,2010,NA,NA,166,94,72,46,11,35,0.37,0.15,0.28,21050,22,63,111
176947,CENTRAL METHODIST COLLEGE,1,0,1991,NA,NA,240,109,131,52,22,30,0.27,0.17,0.22,6710,10,60,210
176947,CENTRAL METHODIST COLLEGE,1,0,1992,NA,NA,209,79,130,42,20,22,0.27,0.15,0.2,7050,10,53,178
176947,CENTRAL METHODIST COLLEGE,1,0,1993,NA,NA,238,108,130,62,21,41,0.37,0.16,0.26,7780,11,56,207
176947,CENTRAL METHODIST COLLEGE,1,0,1995,NA,NA,229,95,134,73,36,37,0.38,0.27,0.32,9160,13,53,196
176947,CENTRAL METHODIST COLLEGE,1,0,1996,NA,NA,212,82,130,48,19,29,0.35000000000000003,0.15,0.23,9570,13,55,189
176947,CENTRAL METHODIST COLLEGE,1,0,1997,NA,NA,233,115,118,72,25,47,0.4,0.21,0.31,10220,10,55,193
176947,CENTRAL METHODIST COLLEGE,1,0,1998,NA,NA,218,111,107,59,19,40,0.36,0.18,0.27,10620,11,60,183
176947,CENTRAL METHODIST COLLEGE,1,0,1999,NA,NA,228,108,120,62,25,37,0.34,0.21,0.27,10860,10,60,205
176947,CENTRAL METHODIST COLLEGE,1,0,2000,NA,NA,216,102,114,68,17,51,0.5,0.15,0.31,11390,12,61,174
176947,CENTRAL METHODIST COLLEGE,1,0,2001,NA,NA,240,116,124,67,23,44,0.37,0.19,0.28,11950,13,63,208
176947,CENTRAL METHODIST COLLEGE,1,0,2002,NA,NA,232,100,132,61,16,45,0.45,0.12,0.26,12420,13,53,196
176947,CENTRAL METHODIST COLLEGE,1,0,2003,NA,NA,223,93,130,64,25,39,0.41000000000000003,0.19,0.29,13160,14,52,183
176947,CENTRAL METHODIST UNIV-COLL OF LIBERAL ARTS & SCIENCES,1,0,2004,NA,NA,193,86,107,64,21,43,0.5,0.2,0.33,13800,14,54,168
176947,Central Methodist University-College of Liberal Arts & Sciences,1,0,2005,NA,NA,223,96,127,73,29,44,0.45,0.23,0.33,14490,14,51,198
176947,Central Methodist University-College of Liberal Arts & Sciences,1,0,2006,NA,NA,207,111,96,81,28,53,0.47000000000000003,0.29,0.39,15500,15,57,190
176947,Central Methodist University-College of Liberal Arts & Sciences,1,0,2007,NA,NA,270,123,147,69,31,38,0.3,0.21,0.26,16430,16,55,228
176947,Central Methodist University-College of Liberal Arts & Sciences,1,0,2008,NA,NA,300,141,159,110,47,63,0.44,0.3,0.37,17250,17,59,254
176947,Central Methodist University-College of Liberal Arts & Sciences,1,0,2009,NA,NA,260,129,131,106,42,64,0.49,0.32,0.41,17940,20,59,221
176947,Central Methodist University-College of Liberal Arts & Sciences,1,0,2010,NA,NA,314,147,167,109,33,76,0.51,0.2,0.35,18660,21,60,266
176965,CENTRAL MISSOURI STATE UNIVERSITY,1,0,1991,NA,NA,1952,1038,914,273,107,166,0.15,0.12,0.14,1860,91,447,1691
176965,CENTRAL MISSOURI STATE UNIVERSITY,1,0,1992,NA,NA,1763,921,842,240,105,135,0.14,0.12,0.14,2040,92,444,1564
176965,CENTRAL MISSOURI STATE UNIVERSITY,1,0,1993,NA,NA,1433,757,676,213,72,141,0.18,0.11,0.15,2160,97,454,1232
176965,CENTRAL MISSOURI STATE UNIVERSITY,1,0,1995,NA,NA,1428,755,673,243,79,164,0.21,0.12,0.17,2460,99,455,1259
176965,CENTRAL MISSOURI STATE UNIVERSITY,1,0,1996,NA,NA,1252,655,597,221,77,144,0.21,0.13,0.18,2520,107,433,1138
176965,CENTRAL MISSOURI STATE UNIVERSITY,1,0,1997,NA,NA,1323,718,605,298,88,210,0.29,0.15,0.23,2640,107,432,1195
176965,CENTRAL MISSOURI STATE UNIVERSITY,1,0,1998,NA,NA,1408,730,678,317,107,210,0.28,0.16,0.23,2730,117,425,1250
176965,CENTRAL MISSOURI STATE UNIVERSITY,1,0,1999,NA,NA,1329,725,604,300,94,206,0.28,0.16,0.23,2970,123,446,1191
176965,CENTRAL MISSOURI STATE UNIVERSITY,1,0,2000,NA,NA,1455,794,661,380,146,234,0.29,0.22,0.26,3210,126,441,1274
176965,CENTRAL MISSOURI STATE UNIVERSITY,1,0,2001,NA,NA,1437,789,648,275,33,242,0.3,0.05,0.19,3450,135,437,1191
176965,CENTRAL MISSOURI STATE UNIVERSITY,1,0,2002,NA,NA,1248,668,580,306,106,200,0.29,0.18,0.25,3240,127,425,1041
176965,CENTRAL MISSOURI STATE UNIVERSITY,1,0,2003,NA,NA,1355,737,618,323,115,208,0.28,0.19,0.24,3696,123,428,1098
176965,CENTRAL MISSOURI STATE UNIVERSITY,1,0,2004,NA,NA,1434,798,636,369,120,249,0.31,0.19,0.26,3936,127,430,1232
176965,Central Missouri State University,1,0,2005,NA,NA,1484,810,674,410,164,246,0.3,0.24,0.28,4104,144,448,1245
176965,University of Central Missouri,1,0,2006,NA,NA,1505,871,634,416,134,282,0.32,0.21,0.28,5415,144,457,1188
176965,University of Central Missouri,1,0,2007,NA,NA,1426,786,640,428,148,280,0.35000000000000003,0.23,0.3,4500,150,453,1166
176965,University of Central Missouri,1,0,2008,NA,NA,1583,854,729,463,185,278,0.32,0.25,0.29,4687,156,456,1290
176965,University of Central Missouri,1,0,2009,NA,NA,1478,822,656,452,148,304,0.36,0.23,0.31,5859,158,460,1197
176965,University of Central Missouri,1,0,2010,NA,NA,1546,862,684,496,176,320,0.37,0.26,0.32,5859,161,459,1179
177418,FONTBONNE COLLEGE,1,0,1991,NA,NA,114,87,27,38,9,29,0.33,0.33,0.33,7390,6,43,93
177418,FONTBONNE COLLEGE,1,0,1992,NA,NA,144,110,34,56,5,51,0.46,0.15,0.39,7750,7,44,118
177418,FONTBONNE COLLEGE,1,0,1993,NA,NA,126,95,31,50,7,43,0.45,0.23,0.4,8140,9,42,102
177418,FONTBONNE COLLEGE,1,0,1995,NA,NA,143,110,33,51,11,40,0.36,0.33,0.36,8890,10,40,120
177418,FONTBONNE COLLEGE,1,0,1996,NA,NA,146,104,42,66,13,53,0.5,0.31,0.45,9660,11,43,131
177418,FONTBONNE COLLEGE,1,0,1997,NA,NA,171,124,47,50,10,40,0.32,0.21,0.29,10000,11,45,143
177418,FONTBONNE COLLEGE,1,0,1998,NA,NA,156,111,45,59,11,48,0.43,0.24,0.38,10810,12,46,129
177418,FONTBONNE COLLEGE,1,0,1999,NA,NA,144,94,50,60,14,46,0.48,0.28,0.42,11184,14,48,115
177418,FONTBONNE COLLEGE,1,0,2000,NA,NA,164,124,40,57,4,53,0.42,0.1,0.35,11686,15,53,129
177418,FONTBONNE UNIVERSITY,1,0,2001,NA,NA,153,111,42,50,12,38,0.34,0.29,0.33,12596,17,59,129
177418,FONTBONNE UNIVERSITY,1,0,2002,NA,NA,183,134,49,76,16,60,0.44,0.33,0.42,13414,21,55,157
177418,FONTBONNE UNIVERSITY,1,0,2003,NA,NA,194,143,51,61,14,47,0.32,0.27,0.31,14200,23,59,152
177418,FONTBONNE UNIVERSITY,1,0,2004,NA,NA,190,132,58,52,16,36,0.27,0.28,0.27,15100,24,59,141
177418,Fontbonne University,1,0,2005,NA,NA,187,136,51,44,9,35,0.25,0.18,0.24,16000,27,66,141
177418,Fontbonne University,1,0,2006,NA,NA,187,98,89,30,11,19,0.19,0.12,0.16,17120,30,65,140
177418,Fontbonne University,1,0,2007,NA,NA,193,110,83,5,1,4,0.03,0.01,0.03,18000,32,73,143
177418,Fontbonne University,1,0,2008,NA,NA,187,112,75,44,12,32,0.28,0.16,0.24,19000,35,82,130
177418,Fontbonne University,1,0,2009,NA,NA,173,104,69,65,19,46,0.44,0.28,0.38,19475,38,75,127
177418,Fontbonne University,1,0,2010,NA,NA,151,77,74,53,21,32,0.41000000000000003,0.28,0.35,20060,35,82,119
178059,MARYVILLE UNIVERSITY OF SAINT LOUIS,1,0,1991,NA,NA,102,61,41,63,22,41,0.67,0.54,0.62,7800,16,78,94
178059,MARYVILLE UNIVERSITY OF SAINT LOUIS,1,0,1992,NA,NA,129,93,36,70,19,51,0.54,0.53,0.54,8200,19,81,121
178059,MARYVILLE UNIVERSITY OF SAINT LOUIS,1,0,1993,NA,NA,165,109,56,73,20,53,0.48,0.36,0.44,8700,20,78,149
178059,MARYVILLE UNIVERSITY OF SAINT LOUIS,1,0,1995,NA,NA,167,123,44,77,16,61,0.49,0.36,0.46,9800,22,80,144
178059,MARYVILLE UNIVERSITY OF SAINT LOUIS,1,0,1996,NA,NA,185,127,58,100,28,72,0.56,0.48,0.54,10280,24,85,169
178059,MARYVILLE UNIVERSITY OF SAINT LOUIS,1,0,1997,NA,NA,223,173,50,114,26,88,0.5,0.52,0.51,10850,21,87,199
178059,MARYVILLE UNIVERSITY OF SAINT LOUIS,1,0,1998,NA,NA,225,158,67,100,26,74,0.46,0.39,0.44,11600,22,86,214
178059,MARYVILLE UNIVERSITY OF SAINT LOUIS,1,0,1999,NA,NA,198,133,65,101,26,75,0.56,0.4,0.51,12160,26,91,164
178059,MARYVILLE UNIVERSITY OF SAINT LOUIS,1,0,2000,NA,NA,231,186,45,122,18,104,0.55,0.4,0.53,12880,27,86,206
178059,MARYVILLE UNIVERSITY OF SAINT LOUIS,1,0,2001,NA,NA,247,183,64,141,31,110,0.6,0.48,0.57,13650,29,82,206
178059,MARYVILLE UNIVERSITY OF SAINT LOUIS,1,0,2002,NA,NA,279,194,85,132,46,86,0.44,0.54,0.47,14400,29,83,233
178059,MARYVILLE UNIVERSITY OF SAINT LOUIS,1,0,2003,NA,NA,318,236,82,163,39,124,0.52,0.48,0.51,15200,31,85,286
178059,MARYVILLE UNIVERSITY OF SAINT LOUIS,1,0,2004,NA,NA,313,248,65,160,29,131,0.52,0.45,0.51,16000,34,93,266
178059,Maryville University of Saint Louis,1,0,2005,NA,NA,322,232,90,182,42,140,0.6,0.47,0.57,17000,37,95,296
178059,Maryville University of Saint Louis,1,0,2006,NA,NA,290,237,53,152,26,126,0.53,0.49,0.52,17800,39,101,261
178059,Maryville University of Saint Louis,1,0,2007,NA,NA,294,211,83,149,43,106,0.5,0.52,0.51,18600,43,107,257
178059,Maryville University of Saint Louis,1,0,2008,NA,NA,318,236,82,149,39,110,0.46,0.48,0.47,19650,45,110,283
178059,Maryville University of Saint Louis,1,0,2009,NA,NA,340,233,107,190,57,133,0.5700000000000001,0.53,0.56,20384,46,107,278
178059,Maryville University of Saint Louis,1,0,2010,NA,NA,338,242,96,192,49,143,0.59,0.51,0.57,21100,49,113,271
178341,MISSOURI SOUTHERN STATE COLLEGE,1,0,1991,NA,NA,758,397,361,71,24,47,0.11,0.07,0.09,1272,25,198,729
178341,MISSOURI SOUTHERN STATE COLLEGE,1,0,1992,NA,NA,702,381,321,63,24,39,0.1,0.07,0.09,1598,26,189,655
178341,MISSOURI SOUTHERN STATE COLLEGE,1,0,1993,NA,NA,701,362,339,51,16,35,0.09,0.05,0.07,2018,28,187,665
178341,MISSOURI SOUTHERN STATE COLLEGE,1,0,1995,NA,NA,720,359,361,77,37,40,0.11,0.1,0.11,2205,29,190,672
178341,MISSOURI SOUTHERN STATE COLLEGE,1,0,1996,NA,NA,685,373,312,77,25,52,0.13,0.08,0.11,2310,34,196,644
178341,MISSOURI SOUTHERN STATE COLLEGE,1,0,1997,NA,NA,675,368,307,61,19,42,0.11,0.06,0.09,2376,34,205,632
178341,MISSOURI SOUTHERN STATE COLLEGE,1,0,1998,NA,NA,857,469,388,95,30,65,0.13,0.08,0.11,2471,38,202,794
178341,MISSOURI SOUTHERN STATE COLLEGE,1,0,1999,NA,NA,804,434,370,104,40,64,0.14,0.11,0.13,2265,41,204,738
178341,MISSOURI SOUTHERN STATE COLLEGE,1,0,2000,NA,NA,771,427,344,129,50,79,0.18,0.15,0.17,2370,44,204,713
178341,MISSOURI SOUTHERN STATE COLLEGE,1,0,2001,NA,NA,786,411,375,117,47,70,0.17,0.13,0.15,2700,47,204,686
178341,MISSOURI SOUTHERN STATE COLLEGE,1,0,2002,NA,NA,614,334,280,78,27,51,0.15,0.1,0.13,3720,43,202,544
178341,MISSOURI SOUTHERN STATE UNIVERSITY,1,0,2003,NA,NA,568,319,249,76,25,51,0.15,0.1,0.13,3810,46,198,511
178341,MISSOURI SOUTHERN STATE UNIVERSITY,1,0,2004,NA,NA,695,368,327,97,33,64,0.17,0.1,0.14,3810,46,200,626
178341,Missouri Southern State University,1,0,2005,NA,NA,836,466,370,106,32,74,0.15,0.09,0.13,3750,49,203,709
178341,Missouri Southern State University,1,0,2006,NA,NA,851,484,367,106,40,66,0.13,0.11,0.12,3900,53,208,715
178341,Missouri Southern State University,1,0,2007,NA,NA,766,416,350,110,29,81,0.19,0.08,0.14,4050,59,211,656
178341,Missouri Southern State University,1,0,2008,NA,NA,727,398,329,106,34,72,0.18,0.1,0.15,4290,61,215,621
178341,Missouri Southern State University,1,0,2009,NA,NA,811,395,416,119,53,66,0.16,0.13,0.15,4290,55,208,669
178341,Missouri Southern State University,1,0,2010,NA,NA,844,439,405,88,35,53,0.12,0.09,0.1,4290,60,207,687
178387,MISSOURI WESTERN STATE COLLEGE,1,0,1991,NA,NA,806,435,371,71,27,44,0.1,0.07,0.09,1648,24,160,699
178387,MISSOURI WESTERN STATE COLLEGE,1,0,1992,NA,NA,794,445,349,85,22,63,0.14,0.06,0.11,1822,26,162,696
178387,MISSOURI WESTERN STATE COLLEGE,1,0,1993,NA,NA,928,514,414,86,30,56,0.1,0.07,0.09,1930,28,161,784
178387,MISSOURI WESTERN STATE COLLEGE,1,0,1995,NA,NA,923,530,393,92,24,68,0.12,0.06,0.1,2258,31,165,801
178387,MISSOURI WESTERN STATE COLLEGE,1,0,1996,NA,NA,963,564,399,113,28,85,0.15,0.07,0.12,2414,33,176,836
178387,MISSOURI WESTERN STATE COLLEGE,1,0,1997,NA,NA,985,572,413,135,42,93,0.16,0.1,0.14,2534,37,181,846
178387,MISSOURI WESTERN STATE COLLEGE,1,0,1998,NA,NA,983,577,406,127,27,100,0.17,0.07,0.13,2660,40,185,827
178387,MISSOURI WESTERN STATE COLLEGE,1,0,1999,NA,NA,980,575,405,113,35,78,0.13,0.09,0.12,2622,44,188,832
178387,MISSOURI WESTERN STATE COLLEGE,1,0,2000,NA,NA,908,532,376,91,20,71,0.13,0.05,0.1,2754,47,188,740
178387,MISSOURI WESTERN STATE COLLEGE,1,0,2001,NA,NA,1079,666,413,140,44,96,0.14,0.11,0.13,2928,49,188,903
178387,MISSOURI WESTERN STATE COLLEGE,1,0,2002,NA,NA,1131,655,476,134,52,82,0.12,0.11,0.12,3768,46,184,907
178387,MISSOURI WESTERN STATE COLLEGE,1,0,2003,NA,NA,994,572,422,111,27,84,0.14,0.06,0.11,4098,44,180,783
178387,MISSOURI WESTERN STATE COLLEGE,1,0,2004,NA,NA,1021,573,448,109,26,83,0.14,0.06,0.11,4380,44,179,801
178387,Missouri Western State University,1,0,2005,NA,NA,1005,557,448,111,42,69,0.12,0.09,0.11,4380,47,179,758
178387,Missouri Western State University,1,0,2006,NA,NA,936,516,420,102,39,63,0.12,0.09,0.11,4650,51,178,723
178387,Missouri Western State University,1,0,2007,NA,NA,935,538,397,126,36,90,0.16,0.09,0.13,4800,52,184,699
178387,Missouri Western State University,1,0,2008,NA,NA,956,536,420,146,44,102,0.19,0.1,0.15,3994,54,187,766
178387,Missouri Western State University,1,0,2009,NA,NA,1004,572,432,127,35,92,0.16,0.08,0.13,3994,58,192,793
178387,Missouri Western State University,1,0,2010,NA,NA,1083,559,524,145,55,90,0.16,0.1,0.13,3994,59,195,841
178396,UNIVERSITY OF MISSOURI-COLUMBIA,1,0,1991,NA,NA,3368,1820,1548,959,356,603,0.33,0.23,0.28,2432,561,899,2906
178396,UNIVERSITY OF MISSOURI-COLUMBIA,1,0,1992,NA,NA,2904,1600,1304,828,305,523,0.32,0.23,0.29,2812,594,883,2493
178396,UNIVERSITY OF MISSOURI-COLUMBIA,1,0,1993,NA,NA,2898,1511,1387,828,320,508,0.33,0.23,0.29,3125,638,899,2499
178396,UNIVERSITY OF MISSOURI-COLUMBIA,1,0,1995,NA,NA,3782,2099,1683,1210,420,790,0.37,0.25,0.32,3771,741,879,3232
178396,UNIVERSITY OF MISSOURI-COLUMBIA,1,0,1996,NA,NA,3687,2046,1641,1282,462,820,0.4,0.28,0.35,4121,787,910,3153
178396,UNIVERSITY OF MISSOURI-COLUMBIA,1,0,1997,NA,NA,3512,1935,1577,1290,461,829,0.42,0.29,0.37,4280,820,913,2952
178396,UNIVERSITY OF MISSOURI-COLUMBIA,1,0,1998,NA,NA,3785,2077,1708,1425,500,925,0.44,0.29,0.38,4439,853,899,3251
178396,UNIVERSITY OF MISSOURI-COLUMBIA,1,0,1999,NA,NA,3871,2138,1733,1468,525,943,0.44,0.3,0.38,3978,883,930,3350
178396,UNIVERSITY OF MISSOURI-COLUMBIA,1,0,2000,NA,NA,4170,2247,1923,1657,609,1048,0.46,0.32,0.4,4104,996,968,3598
178396,UNIVERSITY OF MISSOURI-COLUMBIA,1,0,2001,NA,NA,4112,2175,1937,1686,643,1043,0.47000000000000003,0.33,0.41,4245,1083,1006,3577
178396,UNIVERSITY OF MISSOURI-COLUMBIA,1,0,2002,NA,NA,4379,2284,2095,1813,669,1144,0.5,0.32,0.41,4602,1073,1219,3763
178396,UNIVERSITY OF MISSOURI-COLUMBIA,1,0,2003,NA,NA,4605,2443,2162,1985,737,1248,0.51,0.34,0.43,5838,1137,1093,3951
178396,UNIVERSITY OF MISSOURI-COLUMBIA,1,0,2004,NA,NA,4625,2442,2183,1993,765,1228,0.5,0.35,0.43,6276,1183,1544,3957
178396,University of Missouri-Columbia,1,0,2005,NA,NA,4662,2513,2149,2087,810,1277,0.5,0.38,0.45,6062,1357,1242,3954
178396,University of Missouri-Columbia,1,0,2006,NA,NA,4783,2562,2221,2234,835,1399,0.54,0.38,0.47,6364,1437,1276,3953
178396,University of Missouri-Columbia,1,0,2007,NA,NA,4897,2672,2225,2305,829,1476,0.55,0.37,0.47,7077,1513,1292,4143
178396,University of Missouri-Columbia,1,0,2008,NA,NA,5698,3031,2667,2622,1004,1618,0.53,0.38,0.46,7368,1607,1295,4740
178396,University of Missouri-Columbia,1,0,2009,NA,NA,5492,2958,2534,2527,907,1620,0.54,0.36,0.46,7368,1641,1284,4491
178396,University of Missouri-Columbia,1,0,2010,NA,NA,5996,3175,2821,2641,963,1678,0.52,0.34,0.44,7368,1678,1329,4904
178402,UNIVERSITY OF MISSOURI-KANSAS CITY,1,0,1991,NA,NA,494,270,224,55,26,29,0.1,0.12,0.11,2457,125,454,345
178402,UNIVERSITY OF MISSOURI-KANSAS CITY,1,0,1992,NA,NA,480,257,223,42,13,29,0.11,0.06,0.09,2841,132,421,335
178402,UNIVERSITY OF MISSOURI-KANSAS CITY,1,0,1993,NA,NA,515,266,249,53,18,35,0.13,0.07,0.1,3154,138,434,353
178402,UNIVERSITY OF MISSOURI-KANSAS CITY,1,0,1995,NA,NA,568,318,250,70,25,45,0.14,0.1,0.12,3799,151,457,387
178402,UNIVERSITY OF MISSOURI-KANSAS CITY,1,0,1996,NA,NA,567,299,268,86,33,53,0.17,0.12,0.15,4121,173,460,389
178402,UNIVERSITY OF MISSOURI-KANSAS CITY,1,0,1997,NA,NA,588,321,267,79,27,52,0.16,0.1,0.13,4273,185,468,433
178402,UNIVERSITY OF MISSOURI-KANSAS CITY,1,0,1998,NA,NA,618,336,282,114,39,75,0.22,0.14,0.18,4421,195,469,418
178402,UNIVERSITY OF MISSOURI-KANSAS CITY,1,0,1999,NA,NA,639,356,283,105,46,59,0.16,0.16,0.16,3978,207,484,458
178402,UNIVERSITY OF MISSOURI-KANSAS CITY,1,0,2000,NA,NA,688,391,297,120,44,76,0.19,0.15,0.17,4104,220,504,453
178402,UNIVERSITY OF MISSOURI-KANSAS CITY,1,0,2001,NA,NA,734,444,290,106,36,70,0.15,0.12,0.14,4245,231,524,501
178402,UNIVERSITY OF MISSOURI-KANSAS CITY,1,0,2002,NA,NA,747,454,293,128,41,87,0.19,0.14,0.17,4602,218,593,481
178402,UNIVERSITY OF MISSOURI-KANSAS CITY,1,0,2003,NA,NA,758,455,303,124,38,86,0.18,0.13,0.16,5838,250,562,435
178402,UNIVERSITY OF MISSOURI-KANSAS CITY,1,0,2004,NA,NA,904,540,364,160,50,110,0.2,0.14,0.18,6276,260,608,539
178402,University of Missouri-Kansas City,1,0,2005,NA,NA,1007,574,433,173,61,112,0.19,0.14,0.17,6495,275,662,611
178402,University of Missouri-Kansas City,1,0,2006,NA,NA,928,545,383,220,86,134,0.24,0.22,0.24,6819,287,669,539
178402,University of Missouri-Kansas City,1,0,2007,NA,NA,916,568,348,188,59,129,0.22,0.17,0.21,7077,288,696,505
178402,University of Missouri-Kansas City,1,0,2008,NA,NA,971,589,382,218,68,150,0.25,0.18,0.22,7368,305,706,570
178402,University of Missouri-Kansas City,1,0,2009,NA,NA,979,610,369,224,62,162,0.26,0.17,0.23,7368,319,716,559
178402,University of Missouri-Kansas City,1,0,2010,NA,NA,1109,673,436,246,92,154,0.22,0.21,0.22,7368,331,721,640
178411,UNIVERSITY OF MISSOURI-ROLLA,1,0,1991,NA,NA,711,135,576,58,43,15,0.11,0.07,0.08,2543,70,282,630
178411,UNIVERSITY OF MISSOURI-ROLLA,1,0,1992,NA,NA,809,174,635,64,40,24,0.13,0.06,0.08,2932,72,256,704
178411,UNIVERSITY OF MISSOURI-ROLLA,1,0,1993,NA,NA,786,190,596,78,58,20,0.1,0.1,0.1,3254,82,253,707
178411,UNIVERSITY OF MISSOURI-ROLLA,1,0,1995,NA,NA,804,190,614,121,75,46,0.24,0.12,0.15,3899,89,263,704
178411,UNIVERSITY OF MISSOURI-ROLLA,1,0,1996,NA,NA,777,179,598,121,77,44,0.24,0.13,0.16,4213,96,272,684
178411,UNIVERSITY OF MISSOURI-ROLLA,1,0,1997,NA,NA,692,168,524,99,76,23,0.13,0.15,0.14,4373,101,267,631
178411,UNIVERSITY OF MISSOURI-ROLLA,1,0,1998,NA,NA,717,151,566,106,81,25,0.16,0.14,0.15,4522,105,276,641
178411,UNIVERSITY OF MISSOURI-ROLLA,1,0,1999,NA,NA,679,140,539,112,77,35,0.25,0.14,0.16,3978,110,272,588
178411,UNIVERSITY OF MISSOURI-ROLLA,1,0,2000,NA,NA,672,146,526,143,98,45,0.3,0.19,0.21,4104,113,271,583
178411,UNIVERSITY OF MISSOURI-ROLLA,1,0,2001,NA,NA,691,126,565,144,109,35,0.27,0.19,0.21,4245,119,271,586
178411,UNIVERSITY OF MISSOURI-ROLLA,1,0,2002,NA,NA,785,150,635,175,128,47,0.31,0.2,0.22,4602,109,305,690
178411,UNIVERSITY OF MISSOURI-ROLLA,1,0,2003,NA,NA,870,181,689,217,154,63,0.34,0.22,0.25,5838,116,296,752
178411,UNIVERSITY OF MISSOURI-ROLLA,1,0,2004,NA,NA,836,169,667,211,162,49,0.28,0.24,0.25,6276,126,318,721
178411,University of Missouri-Rolla,1,0,2005,NA,NA,877,168,709,224,154,70,0.41000000000000003,0.22,0.26,6495,135,314,772
178411,University of Missouri-Rolla,1,0,2006,NA,NA,929,216,713,258,176,82,0.37,0.25,0.28,6819,144,323,802
178411,Missouri University of Science and Technology,1,0,2007,NA,NA,1018,208,810,257,180,77,0.37,0.22,0.25,7077,140,330,885
178411,Missouri University of Science and Technology,1,0,2008,NA,NA,1036,234,802,253,181,72,0.3,0.23,0.24,7368,154,343,872
178411,Missouri University of Science and Technology,1,0,2009,NA,NA,1099,260,839,263,180,83,0.31,0.21,0.24,7368,155,333,904
178411,Missouri University of Science and Technology,1,0,2010,NA,NA,1138,250,888,246,166,80,0.32,0.19,0.22,7368,160,329,970
178420,UNIVERSITY OF MISSOURI-SAINT LOUIS,1,0,1991,NA,NA,637,341,296,72,28,44,0.12,0.09,0.11,2379,77,327,513
178420,UNIVERSITY OF MISSOURI-SAINT LOUIS,1,0,1992,NA,NA,474,224,250,49,18,31,0.13,0.07,0.1,2740,78,299,388
178420,UNIVERSITY OF MISSOURI-ST LOUIS,1,0,1993,NA,NA,458,231,227,52,17,35,0.15,0.07,0.11,3073,81,304,361
178420,UNIVERSITY OF MISSOURI-ST LOUIS,1,0,1995,NA,NA,552,315,237,85,31,54,0.17,0.13,0.15,3761,101,332,436
178420,UNIVERSITY OF MISSOURI-ST LOUIS,1,0,1996,NA,NA,632,351,281,78,20,58,0.16,0.07,0.12,4145,111,345,484
178420,UNIVERSITY OF MISSOURI-ST LOUIS,1,0,1997,NA,NA,458,242,216,60,12,48,0.19,0.06,0.13,4323,116,348,378
178420,UNIVERSITY OF MISSOURI-ST LOUIS,1,0,1998,NA,NA,528,274,254,114,46,68,0.24,0.18,0.22,4636,128,330,443
178420,UNIVERSITY OF MISSOURI-ST LOUIS,1,0,1999,NA,NA,539,274,265,122,43,79,0.28,0.16,0.23,3978,135,330,415
178420,UNIVERSITY OF MISSOURI-ST LOUIS,1,0,2000,NA,NA,497,279,218,100,35,65,0.23,0.16,0.2,4104,146,329,388
178420,UNIVERSITY OF MISSOURI-ST LOUIS,1,0,2001,NA,NA,515,313,202,96,25,71,0.22,0.12,0.19,4245,155,328,376
178420,UNIVERSITY OF MISSOURI-ST LOUIS,1,0,2002,NA,NA,426,234,192,96,29,67,0.28,0.15,0.23,4602,153,415,324
178420,UNIVERSITY OF MISSOURI-ST LOUIS,1,0,2003,NA,NA,464,280,184,97,26,71,0.25,0.14,0.21,5838,149,414,356
178420,UNIVERSITY OF MISSOURI-ST LOUIS,1,0,2004,NA,NA,398,235,163,82,25,57,0.24,0.15,0.21,6276,164,442,283
178420,University of Missouri-St Louis,1,0,2005,NA,NA,497,288,209,124,41,83,0.28,0.2,0.25,5196,173,462,337
178420,University of Missouri-St Louis,1,0,2006,NA,NA,476,273,203,106,33,73,0.26,0.16,0.22,6819,183,497,297
178420,University of Missouri-St Louis,1,0,2007,NA,NA,462,280,182,94,25,69,0.24,0.14,0.2,7077,192,501,270
178420,University of Missouri-St Louis,1,0,2008,NA,NA,437,244,193,92,34,58,0.23,0.18,0.21,7368,203,504,279
178420,University of Missouri-St Louis,1,0,2009,NA,NA,494,295,199,109,34,75,0.25,0.17,0.22,7368,203,494,266
178420,University of Missouri-St Louis,1,0,2010,NA,NA,479,282,197,141,51,90,0.31,0.26,0.29,7368,200,493,298
178615,NORTHEAST MISSOURI STATE UNIVERSITY,1,0,1991,NA,NA,1375,784,591,459,153,306,0.39,0.26,0.33,1800,50,337,1262
178615,NORTHEAST MISSOURI STATE UNIVERSITY,1,0,1992,NA,NA,1384,786,598,539,167,372,0.47000000000000003,0.28,0.39,2235,52,337,1238
178615,NORTHEAST MISSOURI STATE UNIVERSITY,1,0,1993,NA,NA,1614,962,652,597,178,419,0.43,0.27,0.37,2456,56,328,1451
178615,TRUMAN STATE UNIVERSITY,1,0,1995,NA,NA,1498,883,615,577,183,394,0.44,0.3,0.39,2872,64,349,1021
178615,TRUMAN STATE UNIVERSITY,1,0,1996,NA,NA,1480,868,612,592,185,407,0.46,0.3,0.4,3008,69,347,1124
178615,TRUMAN STATE UNIVERSITY,1,0,1997,NA,NA,1654,1020,634,593,175,418,0.4,0.28,0.36,3256,75,356,1461
178615,TRUMAN STATE UNIVERSITY,1,0,1998,NA,NA,1482,914,568,562,181,381,0.41000000000000003,0.32,0.38,3408,88,357,1304
178615,TRUMAN STATE UNIVERSITY,1,0,1999,NA,NA,1446,884,562,594,201,393,0.44,0.36,0.41,3544,85,363,1245
178615,TRUMAN STATE UNIVERSITY,1,0,2000,NA,NA,1396,840,556,537,181,356,0.42,0.33,0.38,3680,89,366,1222
178615,TRUMAN STATE UNIVERSITY,1,0,2001,NA,NA,1456,865,591,666,232,434,0.5,0.39,0.46,3800,92,370,1249
178615,TRUMAN STATE UNIVERSITY,1,0,2002,NA,NA,1441,872,569,654,227,427,0.48,0.4,0.45,4144,84,366,1242
178615,TRUMAN STATE UNIVERSITY,1,0,2003,NA,NA,1310,787,523,612,198,414,0.52,0.38,0.47,4700,79,354,1113
178615,TRUMAN STATE UNIVERSITY,1,0,2004,NA,NA,1477,872,605,631,228,403,0.46,0.38,0.43,5410,80,347,1310
178615,Truman State University,1,0,2005,NA,NA,1441,830,611,626,232,394,0.47000000000000003,0.38,0.43,5740,84,353,1232
178615,Truman State University,1,0,2006,NA,NA,1365,826,539,781,258,523,0.63,0.48,0.57,5970,89,339,1111
178615,Truman State University,1,0,2007,NA,NA,1402,814,588,754,248,506,0.62,0.42,0.54,6210,88,344,1146
178615,Truman State University,1,0,2008,NA,NA,1334,779,555,757,251,506,0.64,0.45,0.57,6458,95,357,1074
178615,Truman State University,1,0,2009,NA,NA,1337,776,561,739,263,476,0.61,0.47,0.55,6458,98,345,1006
178615,Truman State University,1,0,2010,NA,NA,1416,881,535,800,260,540,0.61,0.49,0.56,6458,94,338,1184
179043,ROCKHURST COLLEGE,1,0,1991,NA,NA,228,142,86,121,44,77,0.54,0.51,0.53,8200,19,83,167
179043,ROCKHURST COLLEGE,1,0,1992,NA,NA,198,121,77,92,30,62,0.51,0.39,0.46,8830,19,96,156
179043,ROCKHURST COLLEGE,1,0,1993,NA,NA,345,194,151,169,74,95,0.48,0.49,0.49,9090,21,99,295
179043,ROCKHURST COLLEGE,1,0,1995,NA,NA,288,161,127,174,74,100,0.62,0.58,0.6,10440,26,105,255
179043,ROCKHURST COLLEGE,1,0,1996,NA,NA,362,196,166,9,3,6,0.03,0.02,0.02,11270,29,107,302
179043,ROCKHURST COLLEGE,1,0,1997,NA,NA,319,175,144,181,78,103,0.58,0.54,0.57,11850,33,108,268
179043,ROCKHURST COLLEGE,1,0,1998,NA,NA,280,153,127,141,50,91,0.59,0.39,0.5,12240,34,107,241
179043,ROCKHURST UNIVERSITY,1,0,1999,NA,NA,303,177,126,152,61,91,0.51,0.48,0.5,12500,36,114,250
179043,ROCKHURST UNIVERSITY,1,0,2000,NA,NA,267,141,126,135,61,74,0.52,0.48,0.51,13500,31,125,216
179043,ROCKHURST UNIVERSITY,1,0,2001,NA,NA,298,150,148,165,76,89,0.59,0.51,0.55,14800,61,137,246
179043,ROCKHURST UNIVERSITY,1,0,2002,NA,NA,214,133,81,119,44,75,0.56,0.54,0.56,15980,99,126,179
179043,ROCKHURST UNIVERSITY,1,0,2003,NA,NA,244,130,114,141,60,81,0.62,0.53,0.58,16950,135,121,209
179043,ROCKHURST UNIVERSITY,1,0,2004,NA,NA,305,176,129,184,76,108,0.61,0.59,0.6,17950,135,125,267
179043,Rockhurst University,1,0,2005,NA,NA,370,203,167,237,110,127,0.62,0.66,0.64,18900,150,125,312
179043,Rockhurst University,1,0,2006,NA,NA,396,260,136,237,73,164,0.63,0.54,0.6,20200,154,129,345
179043,Rockhurst University,1,0,2007,NA,NA,367,230,137,222,81,141,0.61,0.59,0.6,22000,141,118,298
179043,Rockhurst University,1,0,2008,NA,NA,358,237,121,223,69,154,0.64,0.57,0.62,23760,129,124,270
179043,Rockhurst University,1,0,2009,NA,NA,417,263,154,251,84,167,0.63,0.55,0.6,24950,112,127,331
179043,Rockhurst University,1,0,2010,NA,NA,370,232,138,228,79,149,0.64,0.57,0.62,26450,87,129,291
179159,SAINT LOUIS UNIVERSITY MAIN CAMPUS,1,0,1991,NA,NA,914,479,435,355,121,234,0.48,0.28,0.39,9160,385,360,720
179159,SAINT LOUIS UNIVERSITY MAIN CAMPUS,1,0,1992,NA,NA,1051,546,505,473,187,286,0.52,0.37,0.45,9880,436,375,823
179159,SAINT LOUIS UNIVERSITY-MAIN CAMPUS,1,0,1993,NA,NA,1066,578,488,500,188,312,0.53,0.39,0.47,10820,467,394,850
179159,SAINT LOUIS UNIVERSITY-MAIN CAMPUS,1,0,1995,NA,NA,1055,604,451,501,195,306,0.5,0.43,0.47,12800,528,436,817
179159,SAINT LOUIS UNIVERSITY-MAIN CAMPUS,1,0,1996,NA,NA,1047,609,438,577,202,375,0.61,0.46,0.55,13900,483,454,803
179159,SAINT LOUIS UNIVERSITY-MAIN CAMPUS,1,0,1997,NA,NA,1084,609,475,601,246,355,0.58,0.52,0.55,14940,509,511,802
179159,SAINT LOUIS UNIVERSITY-MAIN CAMPUS,1,0,1998,NA,NA,1239,694,545,684,251,433,0.62,0.46,0.55,16100,494,530,962
179159,SAINT LOUIS UNIVERSITY-MAIN CAMPUS,1,0,1999,NA,NA,1252,695,557,764,314,450,0.64,0.56,0.61,17230,390,547,974
179159,SAINT LOUIS UNIVERSITY-MAIN CAMPUS,1,0,2000,NA,NA,1405,748,657,886,397,489,0.65,0.6,0.63,18400,410,559,1163
179159,SAINT LOUIS UNIVERSITY-MAIN CAMPUS,1,0,2001,NA,NA,1329,695,634,827,374,453,0.65,0.59,0.62,19670,429,572,1047
179159,SAINT LOUIS UNIVERSITY-MAIN CAMPUS,1,0,2002,NA,NA,1409,762,647,867,366,501,0.65,0.57,0.62,20840,442,591,1131
179159,SAINT LOUIS UNIVERSITY-MAIN CAMPUS,1,0,2003,NA,NA,1377,752,625,832,338,494,0.65,0.54,0.6,22050,471,629,1124
179159,SAINT LOUIS UNIVERSITY-MAIN CAMPUS,1,0,2004,NA,NA,1456,864,592,892,336,556,0.64,0.57,0.61,23360,509,620,1132
179159,Saint Louis University-Main Campus,1,0,2005,NA,NA,1521,859,662,925,377,548,0.63,0.57,0.61,24760,517,616,1180
179159,Saint Louis University-Main Campus,1,0,2006,NA,NA,1567,940,627,946,358,588,0.62,0.57,0.6,26250,546,615,1218
179159,Saint Louis University-Main Campus,1,0,2007,NA,NA,1629,933,696,988,380,608,0.65,0.55,0.61,28480,555,614,1234
179159,Saint Louis University-Main Campus,1,0,2008,NA,NA,1624,923,701,945,365,580,0.62,0.52,0.58,30330,591,672,1138
179159,Saint Louis University-Main Campus,1,0,2009,NA,NA,1714,966,748,1026,393,633,0.65,0.53,0.6,30940,607,639,1183
179159,Saint Louis University-Main Campus,1,0,2010,NA,NA,1724,1004,720,1063,381,682,0.67,0.53,0.62,32180,626,707,1184
179557,SOUTHEAST MISSOURI STATE UNIVERSITY,1,0,1991,NA,NA,1487,815,672,222,70,152,0.18,0.1,0.15,1716,66,367,1319
179557,SOUTHEAST MISSOURI STATE UNIVERSITY,1,0,1992,NA,NA,1405,806,599,236,67,169,0.2,0.11,0.17,2113,68,389,1259
179557,SOUTHEAST MISSOURI STATE UNIVERSITY,1,0,1993,NA,NA,1229,733,496,226,58,168,0.22,0.12,0.18,2434,71,363,1119
179557,SOUTHEAST MISSOURI STATE UNIVERSITY,1,0,1995,NA,NA,1385,824,561,334,90,244,0.29,0.16,0.24,2760,77,376,1283
179557,SOUTHEAST MISSOURI STATE UNIVERSITY,1,0,1996,NA,NA,1212,681,531,294,82,212,0.31,0.15,0.24,2874,84,376,1117
179557,SOUTHEAST MISSOURI STATE UNIVERSITY,1,0,1997,NA,NA,1124,713,411,248,65,183,0.25,0.16,0.22,3000,90,378,1041
179557,SOUTHEAST MISSOURI STATE UNIVERSITY,1,0,1998,NA,NA,1239,757,482,300,75,225,0.29,0.16,0.24,3105,92,380,1132
179557,SOUTHEAST MISSOURI STATE UNIVERSITY,1,0,1999,NA,NA,1391,816,575,320,87,233,0.28,0.15,0.23,2979,100,369,1273
179557,SOUTHEAST MISSOURI STATE UNIVERSITY,1,0,2000,NA,NA,1433,817,616,372,103,269,0.32,0.17,0.26,3099,109,383,1244
179557,SOUTHEAST MISSOURI STATE UNIVERSITY,1,0,2001,NA,NA,1502,910,592,356,98,258,0.28,0.17,0.24,3234,116,398,1328
179557,SOUTHEAST MISSOURI STATE UNIVERSITY,1,0,2002,NA,NA,1457,858,599,361,105,256,0.29,0.18,0.25,3744,106,404,1276
179557,SOUTHEAST MISSOURI STATE UNIVERSITY,1,0,2003,NA,NA,1410,826,584,336,98,238,0.28,0.17,0.24,4254,110,405,1215
179557,SOUTHEAST MISSOURI STATE UNIVERSITY,1,0,2004,NA,NA,1386,823,563,334,98,236,0.28,0.17,0.24,4554,116,406,1194
179557,Southeast Missouri State University,1,0,2005,NA,NA,1538,918,620,369,102,267,0.29,0.16,0.24,4764,124,387,1267
179557,Southeast Missouri State University,1,0,2006,NA,NA,1383,853,530,318,92,226,0.26,0.17,0.23,5034,131,396,1087
179557,Southeast Missouri State University,1,0,2007,NA,NA,1650,946,704,438,158,280,0.29,0.22,0.27,5304,136,401,1263
179557,Southeast Missouri State University,1,0,2008,NA,NA,1672,1054,618,492,141,351,0.33,0.23,0.29,5544,147,421,1423
179557,Southeast Missouri State University,1,0,2009,NA,NA,1640,943,697,455,165,290,0.3,0.24,0.28,5544,153,419,1392
179557,Southeast Missouri State University,1,0,2010,NA,NA,1813,1097,716,526,165,361,0.32,0.23,0.29,5544,159,411,1482
179566,SOUTHWEST MISSOURI STATE UNIVERSITY,1,0,1991,NA,NA,2895,1571,1324,676,241,435,0.27,0.18,0.23,1594,110,648,2658
179566,SOUTHWEST MISSOURI STATE UNIVERSITY,1,0,1992,NA,NA,2925,1621,1304,420,110,310,0.19,0.08,0.14,1752,113,642,2636
179566,SOUTHWEST MISSOURI STATE UNIVERSITY,1,0,1993,NA,NA,2800,1493,1307,376,109,267,0.17,0.08,0.13,1904,122,671,2577
179566,SOUTHWEST MISSOURI STATE UNIVERSITY,1,0,1995,NA,NA,2479,1394,1085,440,156,284,0.2,0.14,0.18,2758,129,646,2297
179566,SOUTHWEST MISSOURI STATE UNIVERSITY,1,0,1996,NA,NA,2447,1404,1043,433,127,306,0.21,0.12,0.18,2888,138,661,2160
179566,SOUTHWEST MISSOURI STATE UNIVERSITY,1,0,1997,NA,NA,2704,1543,1161,522,180,342,0.22,0.16,0.19,3060,153,673,2436
179566,SOUTHWEST MISSOURI STATE UNIVERSITY,1,0,1998,NA,NA,2739,1545,1194,607,192,415,0.26,0.16,0.22,3214,160,694,2446
179566,SOUTHWEST MISSOURI STATE UNIVERSITY,1,0,1999,NA,NA,2581,1439,1142,605,223,382,0.26,0.2,0.23,3030,168,706,2310
179566,SOUTHWEST MISSOURI STATE UNIVERSITY,1,0,2000,NA,NA,2496,1477,1019,613,204,409,0.27,0.2,0.25,3180,179,674,2243
179566,SOUTHWEST MISSOURI STATE UNIVERSITY,1,0,2001,NA,NA,2508,1417,1091,672,213,459,0.32,0.2,0.27,3330,188,642,2278
179566,SOUTHWEST MISSOURI STATE UNIVERSITY,1,0,2002,NA,NA,2702,1609,1093,720,205,515,0.32,0.19,0.27,3840,190,731,2474
179566,SOUTHWEST MISSOURI STATE UNIVERSITY,1,0,2003,NA,NA,2645,1495,1150,1044,382,662,0.44,0.33,0.39,4140,188,725,2297
179566,SOUTHWEST MISSOURI STATE UNIVERSITY,1,0,2004,NA,NA,2663,1572,1091,755,234,521,0.33,0.21,0.28,4620,190,726,2357
179566,Missouri State University,1,0,2005,NA,NA,2575,1490,1085,822,273,549,0.36,0.25,0.32,4920,200,728,2281
179566,Missouri State University,1,0,2006,NA,NA,2732,1622,1110,854,306,548,0.33,0.28,0.31,5190,207,716,2420
179566,Missouri State University,1,0,2007,NA,NA,2610,1514,1096,796,263,533,0.35000000000000003,0.24,0.3,5370,224,698,2268
179566,Missouri State University,1,0,2008,NA,NA,2532,1464,1068,785,258,527,0.36,0.24,0.31,5580,241,724,2236
179566,Missouri State University,1,0,2009,NA,NA,2625,1542,1083,768,225,543,0.35000000000000003,0.21,0.29,5580,260,721,2222
179566,Missouri State University-Springfield,1,0,2010,NA,NA,2645,1574,1071,796,266,530,0.33,0.25,0.3,5580,269,685,2256
179867,WASHINGTON UNIVERSITY,1,0,1991,NA,NA,1131,544,587,863,417,446,0.81,0.71,0.76,16110,620,610,834
179867,WASHINGTON UNIVERSITY,1,0,1992,NA,NA,1070,513,557,831,421,410,0.79,0.76,0.78,16918,682,605,779
179867,WASHINGTON UNIVERSITY,1,0,1993,NA,NA,1229,569,660,930,460,470,0.8200000000000001,0.7,0.76,17776,755,620,937
179867,WASHINGTON UNIVERSITY,1,0,1995,NA,NA,1180,608,572,911,411,500,0.8200000000000001,0.72,0.77,19291,854,642,820
179867,WASHINGTON UNIVERSITY,1,0,1996,NA,NA,1275,642,633,1006,463,543,0.84,0.73,0.79,20200,925,645,836
179867,WASHINGTON UNIVERSITY,1,0,1997,NA,NA,1230,646,584,976,424,552,0.85,0.73,0.79,21210,826,666,778
179867,WASHINGTON UNIVERSITY,1,0,1998,NA,NA,1465,770,695,1221,570,651,0.84,0.82,0.83,22422,865,589,1011
179867,WASHINGTON UNIVERSITY,1,0,1999,NA,NA,1369,684,685,1125,548,577,0.84,0.8,0.82,23400,949,548,893
179867,WASHINGTON UNIVERSITY,1,0,2000,NA,NA,1392,761,631,1158,498,660,0.86,0.79,0.83,24500,1023,554,926
179867,WASHINGTON UNIVERSITY IN ST LOUIS,1,0,2001,NA,NA,1262,637,625,1049,494,555,0.87,0.79,0.83,25700,1155,560,832
179867,WASHINGTON UNIVERSITY IN ST LOUIS,1,0,2002,NA,NA,1329,699,630,1127,513,614,0.87,0.81,0.85,26900,1236,582,883
179867,WASHINGTON UNIVERSITY IN ST LOUIS,1,0,2003,NA,NA,1349,699,650,1138,517,621,0.88,0.8,0.84,28300,1354,572,880
179867,WASHINGTON UNIVERSITY IN ST LOUIS,1,0,2004,NA,NA,1436,725,711,1233,592,641,0.88,0.83,0.86,29700,1418,698,868
179867,Washington University in St Louis,1,0,2005,NA,NA,1372,715,657,1186,544,642,0.89,0.83,0.86,31100,1515,754,817
179867,Washington University in St Louis,1,0,2006,NA,NA,1456,714,742,1284,628,656,0.91,0.85,0.88,32800,1625,773,881
179867,Washington University in St Louis,1,0,2007,NA,NA,1325,645,680,1169,593,576,0.89,0.87,0.88,34500,1720,783,776
179867,Washington University in St Louis,1,0,2008,NA,NA,1408,711,697,1270,605,665,0.93,0.87,0.9,36200,1793,794,817
179867,Washington University in St Louis,1,0,2009,NA,NA,1481,720,761,1280,622,658,0.91,0.82,0.86,37800,1922,810,812
179867,Washington University in St Louis,1,0,2010,NA,NA,1619,776,843,1430,716,714,0.92,0.85,0.88,39400,1981,817,929
179894,WEBSTER UNIVERSITY,1,0,1991,NA,NA,187,110,77,65,24,41,0.37,0.31,0.35,7300,46,105,149
179894,WEBSTER UNIVERSITY,1,0,1992,NA,NA,201,114,87,68,22,46,0.4,0.25,0.34,8000,51,107,165
179894,WEBSTER UNIVERSITY,1,0,1993,NA,NA,227,132,95,81,28,53,0.4,0.29,0.36,8560,49,115,201
179894,WEBSTER UNIVERSITY,1,0,1995,NA,NA,227,105,122,90,52,38,0.36,0.43,0.4,9710,59,125,153
179894,WEBSTER UNIVERSITY,1,0,1996,NA,NA,270,139,131,116,50,66,0.47000000000000003,0.38,0.43,10292,65,132,211
179894,WEBSTER UNIVERSITY,1,0,1997,NA,NA,314,193,121,124,41,83,0.43,0.34,0.39,10860,72,133,264
179894,WEBSTER UNIVERSITY,1,0,1998,NA,NA,339,198,141,123,50,73,0.36,0.35,0.36,11460,79,147,274
179894,WEBSTER UNIVERSITY,1,0,1999,NA,NA,369,214,155,156,52,104,0.48,0.34,0.42,12150,87,147,299
179894,WEBSTER UNIVERSITY,1,0,2000,NA,NA,412,242,170,168,60,108,0.44,0.35,0.41,12880,94,149,327
179894,WEBSTER UNIVERSITY,1,0,2001,NA,NA,399,250,149,179,64,115,0.46,0.43,0.45,13720,100,152,330
179894,WEBSTER UNIVERSITY,1,0,2002,NA,NA,385,226,159,178,67,111,0.49,0.42,0.46,14600,111,157,287
179894,WEBSTER UNIVERSITY,1,0,2003,NA,NA,419,260,159,201,62,139,0.53,0.39,0.48,15480,124,166,333
179894,WEBSTER UNIVERSITY,1,0,2004,NA,NA,448,256,192,229,89,140,0.54,0.46,0.51,16250,140,166,359
179894,Webster University,1,0,2005,NA,NA,394,224,170,175,76,99,0.44,0.45,0.44,17210,146,169,288
179894,Webster University,1,0,2006,NA,NA,418,240,178,198,69,129,0.53,0.39,0.47,18240,147,169,328
179894,Webster University,1,0,2007,NA,NA,483,278,205,224,80,144,0.51,0.39,0.46,19330,157,170,350
179894,Webster University,1,0,2008,NA,NA,407,250,157,173,58,115,0.46,0.37,0.43,20440,166,175,290
179894,Webster University,1,0,2009,NA,NA,486,289,197,219,78,141,0.48,0.4,0.45,21056,169,182,332
179894,Webster University,1,0,2010,NA,NA,413,238,175,187,67,120,0.5,0.38,0.45,21688,178,186,279
179946,WESTMINSTER COLLEGE,1,0,1991,NA,NA,194,83,111,99,56,43,0.51,0.5,0.51,8400,9,50,181
179946,WESTMINSTER COLLEGE,1,0,1992,NA,NA,203,89,114,75,39,36,0.4,0.34,0.37,8950,9,50,191
179946,WESTMINSTER COLLEGE,1,0,1993,NA,NA,180,71,109,73,39,34,0.47000000000000003,0.36,0.41,9950,10,50,168
179946,WESTMINSTER COLLEGE,1,0,1995,NA,NA,190,88,102,91,47,44,0.5,0.46,0.48,11150,11,46,174
179946,WESTMINSTER COLLEGE,1,0,1996,NA,NA,214,84,130,100,62,38,0.45,0.48,0.47,11700,12,45,195
179946,WESTMINSTER COLLEGE,1,0,1997,NA,NA,190,71,119,78,40,38,0.53,0.34,0.41,12300,10,49,177
179946,WESTMINSTER COLLEGE,1,0,1998,NA,NA,205,94,111,78,40,38,0.4,0.36,0.38,13205,11,35,178
179946,WESTMINSTER COLLEGE,1,0,1999,NA,NA,201,90,111,94,41,53,0.58,0.37,0.47,13490,13,50,180
179946,WESTMINSTER COLLEGE,1,0,2000,NA,NA,173,75,98,82,37,45,0.6,0.38,0.47,14060,14,60,155
179946,WESTMINSTER COLLEGE,1,0,2001,NA,NA,248,102,146,97,42,55,0.53,0.29,0.39,14630,15,70,218
179946,WESTMINSTER COLLEGE,1,0,2002,NA,NA,207,93,114,100,48,52,0.55,0.42,0.48,15360,16,57,172
179946,WESTMINSTER COLLEGE,1,0,2003,NA,NA,240,93,147,96,56,40,0.43,0.38,0.4,16128,17,52,188
179946,WESTMINSTER COLLEGE,1,0,2004,NA,NA,231,108,123,105,54,51,0.47000000000000003,0.44,0.45,12990,17,50,195
179946,Westminster College,1,0,2005,NA,NA,287,125,162,143,65,78,0.62,0.4,0.5,13750,17,57,203
179946,Westminster College,1,0,2006,NA,NA,278,139,139,163,73,90,0.64,0.53,0.59,14120,19,58,212
179946,Westminster College,1,0,2007,NA,NA,223,95,128,115,57,58,0.61,0.45,0.52,15500,20,54,169
179946,Westminster College,1,0,2008,NA,NA,244,108,136,123,67,56,0.51,0.49,0.5,16650,20,58,181
179946,Westminster College,1,0,2009,NA,NA,311,152,159,149,61,88,0.5700000000000001,0.38,0.48,17990,22,61,217
179946,Westminster College,1,0,2010,NA,NA,315,139,176,175,75,100,0.71,0.43,0.56,18990,23,62,227
180179,EASTERN MONTANA COLLEGE,1,0,1991,NA,NA,248,168,80,17,4,13,0.07,0.05,0.07,1524,25,137,211
180179,EASTERN MONTANA COLLEGE,1,0,1992,NA,NA,285,200,85,27,9,18,0.09,0.11,0.09,1835,27,138,253
180179,EASTERN MONTANA COLLEGE,1,0,1993,NA,NA,386,261,125,25,3,22,0.08,0.02,0.06,1916,27,141,348
180179,MONTANA STATE UNIVERSITY-BILLINGS,1,0,1995,NA,NA,384,255,129,12,2,10,0.03,0.02,0.03,2304,28,143,358
180179,MONTANA STATE UNIVERSITY-BILLINGS,1,0,1996,NA,NA,520,332,188,79,28,51,0.15,0.15,0.15,2388,33,142,466
180179,MONTANA STATE UNIVERSITY-BILLINGS,1,0,1997,NA,NA,508,334,174,121,28,93,0.27,0.16,0.24,2517,34,137,431
180179,MONTANA STATE UNIVERSITY-BILLINGS,1,0,1998,NA,NA,539,325,214,52,10,42,0.12,0.05,0.1,2816,36,139,450
180179,MONTANA STATE UNIVERSITY-BILLINGS,1,0,1999,NA,NA,629,384,245,56,15,41,0.1,0.06,0.09,2922,38,131,532
180179,MONTANA STATE UNIVERSITY-BILLINGS,1,0,2000,NA,NA,538,352,186,48,10,38,0.1,0.05,0.09,3052,40,142,424
180179,MONTANA STATE UNIVERSITY-BILLINGS,1,0,2001,NA,NA,526,346,180,48,15,33,0.09,0.08,0.09,3429,45,153,438
180179,MONTANA STATE UNIVERSITY-BILLINGS,1,0,2002,NA,NA,542,357,185,48,9,39,0.1,0.05,0.09,3973,44,148,458
180179,MONTANA STATE UNIVERSITY-BILLINGS,1,0,2003,NA,NA,588,380,208,54,13,41,0.1,0.06,0.09,4180,48,154,513
180179,MONTANA STATE UNIVERSITY-BILLINGS,1,0,2004,NA,NA,502,338,164,64,18,46,0.13,0.11,0.13,4550,52,164,423
180179,Montana State University-Billings,1,0,2005,NA,NA,796,463,333,79,26,53,0.11,0.08,0.1,3762,53,157,677
180179,Montana State University-Billings,1,0,2006,NA,NA,646,339,307,59,17,42,0.12,0.06,0.09,3951,55,157,567
180179,Montana State University-Billings,1,0,2007,NA,NA,724,393,331,60,16,44,0.11,0.05,0.08,3988,58,155,615
180179,Montana State University-Billings,1,0,2008,NA,NA,692,402,290,47,14,33,0.08,0.05,0.07,3988,62,154,577
180179,Montana State University-Billings,1,0,2009,NA,NA,715,400,315,51,19,32,0.08,0.06,0.07,3988,62,154,619
180179,Montana State University-Billings,1,0,2010,NA,NA,829,434,395,44,11,33,0.07,0.03,0.05,3988,63,150,674
180461,MONTANA STATE UNIVERSITY,1,0,1991,NA,NA,1445,652,793,156,60,96,0.14,0.08,0.11,1550,106,494,1227
180461,MONTANA STATE UNIVERSITY,1,0,1992,NA,NA,1530,646,884,155,65,90,0.13,0.07,0.1,1839,129,483,1313
180461,MONTANA STATE UNIVERSITY,1,0,1993,NA,NA,1716,756,960,195,89,106,0.14,0.09,0.11,2002,137,468,1511
180461,MONTANA STATE UNIVERSITY-BOZEMAN,1,0,1995,NA,NA,1744,714,1030,224,101,123,0.17,0.1,0.13,2378,153,460,1565
180461,MONTANA STATE UNIVERSITY-BOZEMAN,1,0,1996,NA,NA,1740,780,960,246,120,126,0.16,0.12,0.14,2504,157,461,1531
180461,MONTANA STATE UNIVERSITY-BOZEMAN,1,0,1997,NA,NA,1819,784,1035,259,116,143,0.18,0.11,0.14,2677,182,442,1616
180461,MONTANA STATE UNIVERSITY-BOZEMAN,1,0,1998,NA,NA,1886,846,1040,299,140,159,0.18,0.13,0.16,2869,170,430,1666
180461,MONTANA STATE UNIVERSITY-BOZEMAN,1,0,1999,NA,NA,1894,891,1003,354,164,190,0.21,0.16,0.19,2177,193,464,1659
180461,MONTANA STATE UNIVERSITY-BOZEMAN,1,0,2000,NA,NA,1852,841,1011,357,160,197,0.23,0.16,0.19,2272,218,467,1698
180461,MONTANA STATE UNIVERSITY-BOZEMAN,1,0,2001,NA,NA,1720,731,989,292,148,144,0.19,0.15,0.17,2567,221,471,1583
180461,MONTANA STATE UNIVERSITY-BOZEMAN,1,0,2002,NA,NA,1924,833,1091,307,130,177,0.21,0.12,0.16,2900,232,496,1765
180461,MONTANA STATE UNIVERSITY-BOZEMAN,1,0,2003,NA,NA,2004,837,1167,383,193,190,0.22,0.17,0.19,3256,252,496,1861
180461,MONTANA STATE UNIVERSITY-BOZEMAN,1,0,2004,NA,NA,1998,836,1162,341,159,182,0.21,0.14,0.17,3654,267,483,1832
180461,Montana State University-Bozeman,1,0,2005,NA,NA,1980,843,1137,412,198,214,0.25,0.17,0.21,4106,283,538,1843
180461,Montana State University-Bozeman,1,0,2006,NA,NA,1940,814,1126,381,173,208,0.25,0.15,0.2,4501,301,545,1782
180461,Montana State University,1,0,2007,NA,NA,1852,791,1061,371,162,209,0.26,0.15,0.2,4559,313,540,1668
180461,Montana State University,1,0,2008,NA,NA,1805,765,1040,354,154,200,0.26,0.15,0.2,4559,333,541,1627
180461,Montana State University,1,0,2009,NA,NA,1795,728,1067,387,190,197,0.27,0.18,0.22,4696,352,559,1627
180461,Montana State University,1,0,2010,NA,NA,2115,877,1238,502,219,283,0.32,0.18,0.24,4836,354,579,1870
180522,NORTHERN MONTANA COLLEGE,0,1,1991,1992,0,188,86,102,27,18,9,0.1,0.18,0.14,1440,13,79,151
180522,NORTHERN MONTANA COLLEGE,1,0,1992,1992,1,188,98,90,20,13,7,0.07,0.14,0.11,1732,14,75,160
180522,NORTHERN MONTANA COLLEGE,1,0,1993,1992,1,223,106,117,20,9,11,0.1,0.08,0.09,1802,15,79,182
180522,MONTANA STATE UNIVERSITY-NORTHERN,1,0,1995,1992,1,192,99,93,38,16,22,0.22,0.17,0.2,2221,16,77,150
180522,MONTANA STATE UNIVERSITY-NORTHERN,1,0,1996,1992,1,218,96,122,24,13,11,0.11,0.11,0.11,2350,16,73,108
180522,MONTANA STATE UNIVERSITY-NORTHERN,1,0,1997,1992,1,235,89,146,28,16,12,0.13,0.11,0.12,2484,17,70,182
180522,MONTANA STATE UNIVERSITY-NORTHERN,1,0,1998,1992,1,253,107,146,25,15,10,0.09,0.1,0.1,2692,17,65,213
180522,MONTANA STATE UNIVERSITY-NORTHERN,1,0,1999,1992,1,261,112,149,30,16,14,0.12,0.11,0.11,1988,18,64,210
180522,MONTANA STATE UNIVERSITY-NORTHERN,1,0,2000,1992,1,187,85,102,28,17,11,0.12,0.17,0.15,1988,18,63,152
180522,MONTANA STATE UNIVERSITY-NORTHERN,1,0,2001,1992,1,177,76,101,16,10,6,0.07,0.1,0.09,2436,19,62,128
180522,MONTANA STATE UNIVERSITY-NORTHERN,1,0,2002,1992,1,185,87,98,23,13,10,0.11,0.13,0.12,2796,19,67,136
180522,MONTANA STATE UNIVERSITY-NORTHERN,1,0,2003,1992,1,214,108,106,36,20,16,0.14,0.19,0.17,2769,20,63,177
180522,MONTANA STATE UNIVERSITY-NORTHERN,1,0,2004,1992,1,175,57,118,19,12,7,0.12,0.1,0.11,3101,20,64,140
180522,Montana State University-Northern,1,0,2005,1992,1,192,55,137,15,10,5,0.09,0.07,0.08,3335,19,66,140
180522,Montana State University-Northern,1,0,2006,1992,1,193,66,127,12,5,7,0.1,0.04,0.06,3586,22,68,160
180522,Montana State University-Northern,1,0,2007,1992,1,186,69,117,19,12,7,0.1,0.1,0.1,3586,21,67,136
180522,Montana State University-Northern,1,0,2008,1992,1,199,70,129,14,5,9,0.12,0.04,0.07,3586,21,63,153
180522,Montana State University-Northern,1,0,2009,1992,1,233,71,162,21,13,8,0.11,0.08,0.09,3586,21,60,178
180522,Montana State University-Northern,1,0,2010,1992,1,226,78,148,16,10,6,0.07,0.07,0.07,3586,22,62,160
180984,CONCORDIA TEACHERS COLLEGE,1,0,1991,NA,NA,204,117,87,58,17,41,0.35000000000000003,0.2,0.28,7110,10,57,194
180984,CONCORDIA TEACHERS COLLEGE,1,0,1992,NA,NA,202,114,88,73,24,49,0.42,0.27,0.36,8090,11,59,189
180984,CONCORDIA TEACHERS COLLEGE,1,0,1993,NA,NA,230,114,116,87,31,56,0.49,0.27,0.38,8506,12,54,210
180984,CONCORDIA TEACHERS COLLEGE,1,0,1995,NA,NA,227,128,99,92,37,55,0.42,0.37,0.41,9480,14,65,220
180984,CONCORDIA TEACHERS COLLEGE,1,0,1996,NA,NA,247,133,114,67,27,40,0.3,0.24,0.27,10150,16,59,214
180984,CONCORDIA TEACHERS COLLEGE,1,0,1997,NA,NA,277,152,125,64,22,42,0.27,0.18,0.23,10750,12,58,262
180984,CONCORDIA UNIVERSITY,1,0,1998,NA,NA,294,172,122,90,25,65,0.37,0.2,0.31,11310,13,55,273
180984,CONCORDIA UNIVERSITY,1,0,1999,NA,NA,324,149,175,86,41,45,0.3,0.23,0.27,11876,15,57,209
180984,CONCORDIA UNIVERSITY,1,0,2000,NA,NA,329,173,156,84,42,42,0.24,0.27,0.26,12470,15,56,317
180984,CONCORDIA UNIVERSITY,1,0,2001,NA,NA,265,163,102,71,23,48,0.29,0.23,0.27,13468,18,56,245
180984,CONCORDIA UNIVERSITY,1,0,2002,NA,NA,319,175,144,130,41,89,0.5,0.28,0.41,14546,18,51,299
180984,CONCORDIA UNIVERSITY,1,0,2003,NA,NA,222,138,84,77,25,52,0.37,0.3,0.35,16000,18,52,200
180984,CONCORDIA UNIVERSITY,1,0,2004,NA,NA,278,146,132,103,28,75,0.51,0.21,0.37,16880,18,52,247
180984,Concordia University,1,0,2005,NA,NA,289,146,143,113,33,80,0.54,0.23,0.39,17724,20,54,199
180984,Concordia University,1,0,2006,NA,NA,302,153,149,114,43,71,0.46,0.29,0.38,18750,21,57,265
180984,Concordia University,1,0,2007,NA,NA,264,141,123,111,41,70,0.49,0.33,0.42,19670,23,56,239
180984,Concordia University,1,0,2008,NA,NA,273,129,144,125,57,68,0.52,0.4,0.46,20580,23,58,245
180984,Concordia University,1,0,2009,NA,NA,288,139,149,117,47,70,0.5,0.32,0.41,21100,23,55,259
180984,Concordia University-Seward,1,0,2010,NA,NA,276,139,137,138,57,81,0.58,0.42,0.5,21940,25,58,254
181002,CREIGHTON UNIVERSITY,1,0,1991,NA,NA,750,445,305,430,170,260,0.58,0.56,0.57,8996,143,334,648
181002,CREIGHTON UNIVERSITY,1,0,1992,NA,NA,843,517,326,509,190,319,0.61,0.58,0.6,9670,159,344,728
181002,CREIGHTON UNIVERSITY,1,0,1993,NA,NA,833,492,341,438,164,274,0.55,0.48,0.53,10252,165,342,711
181002,CREIGHTON UNIVERSITY,1,0,1995,NA,NA,746,441,305,421,157,264,0.59,0.51,0.56,11964,184,370,608
181002,CREIGHTON UNIVERSITY,1,0,1996,NA,NA,832,494,338,489,194,295,0.59,0.57,0.59,12210,197,373,642
181002,CREIGHTON UNIVERSITY,1,0,1997,NA,NA,798,457,341,466,184,282,0.61,0.54,0.58,12756,188,373,627
181002,CREIGHTON UNIVERSITY,1,0,1998,NA,NA,794,462,332,481,195,286,0.61,0.59,0.61,13394,195,394,627
181002,CREIGHTON UNIVERSITY,1,0,1999,NA,NA,822,499,323,516,209,307,0.61,0.65,0.63,13566,208,374,677
181002,CREIGHTON UNIVERSITY,1,0,2000,NA,NA,881,535,346,537,197,340,0.63,0.57,0.61,14312,217,508,719
181002,CREIGHTON UNIVERSITY,1,0,2001,NA,NA,760,440,320,454,170,284,0.64,0.53,0.6,16500,241,643,643
181002,CREIGHTON UNIVERSITY,1,0,2002,NA,NA,802,488,314,534,191,343,0.7000000000000001,0.61,0.67,18200,253,642,675
181002,CREIGHTON UNIVERSITY,1,0,2003,NA,NA,933,567,366,601,223,378,0.66,0.61,0.64,19202,273,424,792
181002,CREIGHTON UNIVERSITY,1,0,2004,NA,NA,968,584,384,633,246,387,0.66,0.64,0.65,20354,291,431,796
181002,Creighton University,1,0,2005,NA,NA,970,562,408,640,257,383,0.68,0.63,0.66,21576,315,432,789
181002,Creighton University,1,0,2006,NA,NA,965,591,374,653,257,396,0.67,0.69,0.68,24166,333,441,783
181002,Creighton University,1,0,2007,NA,NA,947,577,370,638,254,384,0.66,0.69,0.67,25616,362,454,740
181002,Creighton University,1,0,2008,NA,NA,984,582,402,647,257,390,0.67,0.64,0.66,27282,397,474,751
181002,Creighton University,1,0,2009,NA,NA,1052,635,417,709,275,434,0.68,0.66,0.67,28232,397,474,807
181002,Creighton University,1,0,2010,NA,NA,1010,606,404,676,248,428,0.7000000000000001,0.61,0.67,29226,399,475,736
181020,DOANE COLLEGE,1,0,1991,NA,NA,230,116,114,117,42,75,0.64,0.37,0.51,8320,13,54,216
181020,DOANE COLLEGE,1,0,1992,NA,NA,241,125,116,136,55,81,0.64,0.47,0.56,8770,14,55,223
181020,DOANE COLLEGE,1,0,1993,NA,NA,246,135,111,127,52,75,0.55,0.47,0.52,9390,15,57,236
181020,DOANE COLLEGE,1,0,1995,NA,NA,243,130,113,140,56,84,0.64,0.5,0.58,10410,18,61,236
181020,DOANE COLLEGE,1,0,1996,NA,NA,276,139,137,146,62,84,0.6,0.45,0.53,10950,19,62,260
181020,DOANE COLLEGE,1,0,1997,NA,NA,260,134,126,135,55,80,0.59,0.44,0.52,11450,20,64,236
181020,DOANE COLLEGE,1,0,1998,NA,NA,266,123,143,156,70,86,0.6900000000000001,0.49,0.59,11800,15,63,256
181020,DOANE COLLEGE,1,0,1999,NA,NA,278,141,137,174,79,95,0.67,0.58,0.63,12010,16,63,257
181020,DOANE COLLEGE,1,0,2000,NA,NA,300,160,140,174,75,99,0.61,0.54,0.58,12500,18,69,282
181020,DOANE COLLEGE,1,0,2001,NA,NA,218,118,100,128,62,66,0.55,0.62,0.59,13150,20,75,202
181020,DOANE COLLEGE,1,0,2002,NA,NA,273,142,131,178,84,94,0.66,0.64,0.65,13960,21,76,255
181020,DOANE COLLEGE,1,0,2003,NA,NA,288,152,136,173,75,98,0.64,0.55,0.6,15080,22,79,260
181020,DOANE COLLEGE,1,0,2004,NA,NA,303,172,131,162,67,95,0.55,0.51,0.53,15620,24,80,247
181020,Doane College,1,0,2005,NA,NA,256,146,110,153,56,97,0.66,0.51,0.6,17186,24,81,234
181020,Doane College,1,0,2006,NA,NA,247,147,100,149,54,95,0.64,0.54,0.6,18420,21,74,208
181020,Doane College,1,0,2007,NA,NA,259,115,144,132,65,67,0.58,0.45,0.51,18800,23,73,204
181020,Doane College,1,0,2008,NA,NA,247,105,142,135,62,73,0.6900000000000001,0.44,0.55,19750,23,73,205
181020,Doane College,1,0,2009,NA,NA,309,167,142,175,65,110,0.65,0.46,0.57,20540,24,70,278
181020,Doane College-Crete,1,0,2010,NA,NA,327,179,148,163,52,111,0.62,0.35,0.5,21570,24,71,277
181127,HASTINGS COLLEGE,1,0,1991,NA,NA,255,111,144,102,55,47,0.42,0.38,0.4,8090,11,67,227
181127,HASTINGS COLLEGE,1,0,1992,NA,NA,254,124,130,112,43,69,0.55,0.33,0.44,8720,11,67,235
181127,HASTINGS COLLEGE,1,0,1993,NA,NA,266,147,119,119,48,71,0.48,0.4,0.45,9296,12,66,250
181127,HASTINGS COLLEGE,1,0,1995,NA,NA,271,134,137,117,44,73,0.54,0.32,0.43,10164,14,67,257
181127,HASTINGS COLLEGE,1,0,1996,NA,NA,262,140,122,138,51,87,0.62,0.42,0.53,10724,15,68,250
181127,HASTINGS COLLEGE,1,0,1997,NA,NA,282,145,137,145,50,95,0.65,0.36,0.51,11368,12,68,272
181127,HASTINGS COLLEGE,1,0,1998,NA,NA,309,168,141,160,57,103,0.61,0.4,0.52,11940,12,68,289
181127,HASTINGS COLLEGE,1,0,1999,NA,NA,286,141,145,146,54,92,0.65,0.37,0.51,11916,14,70,267
181127,HASTINGS COLLEGE,1,0,2000,NA,NA,271,119,152,129,61,68,0.5700000000000001,0.4,0.48,12396,14,71,256
181127,HASTINGS COLLEGE,1,0,2001,NA,NA,252,125,127,130,55,75,0.6,0.43,0.52,13116,15,73,235
181127,HASTINGS COLLEGE,1,0,2002,NA,NA,276,132,144,148,57,91,0.68,0.4,0.54,13972,16,74,261
181127,HASTINGS COLLEGE,1,0,2003,NA,NA,338,143,195,185,87,98,0.68,0.45,0.55,14782,17,80,313
181127,HASTINGS COLLEGE,1,0,2004,NA,NA,289,140,149,152,60,92,0.65,0.4,0.53,15640,18,81,265
181127,Hastings College,1,0,2005,NA,NA,312,133,179,143,69,74,0.55,0.39,0.46,16578,20,79,288
181127,Hastings College,1,0,2006,NA,NA,262,111,151,122,57,65,0.58,0.38,0.47,17572,21,84,242
181127,Hastings College,1,0,2007,NA,NA,302,117,185,131,70,61,0.52,0.38,0.43,18822,22,87,275
181127,Hastings College,1,0,2008,NA,NA,320,151,169,153,63,90,0.59,0.37,0.48,19952,22,86,282
181127,Hastings College,1,0,2009,NA,NA,290,150,140,132,50,82,0.54,0.36,0.46,20912,23,86,252
181127,Hastings College,1,0,2010,NA,NA,312,150,162,144,66,78,0.52,0.41,0.46,21720,23,81,277
181215,UNIVERSITY OF NEBRASKA AT KEARNEY,1,0,1991,NA,NA,1230,665,565,141,54,87,0.13,0.1,0.11,1572,40,296,1099
181215,UNIVERSITY OF NEBRASKA AT KEARNEY,1,0,1992,NA,NA,1322,723,599,137,38,99,0.13,0.06,0.1,1720,44,309,1151
181215,UNIVERSITY OF NEBRASKA AT KEARNEY,1,0,1993,NA,NA,936,501,435,124,37,87,0.17,0.09,0.13,1811,47,309,844
181215,UNIVERSITY OF NEBRASKA AT KEARNEY,1,0,1995,NA,NA,1306,729,577,138,46,92,0.12,0.08,0.11,2061,48,311,1154
181215,UNIVERSITY OF NEBRASKA AT KEARNEY,1,0,1996,NA,NA,1279,707,572,174,59,115,0.16,0.1,0.14,2145,50,317,1117
181215,UNIVERSITY OF NEBRASKA AT KEARNEY,1,0,1997,NA,NA,1005,570,435,174,60,114,0.2,0.14,0.17,2268,54,314,885
181215,UNIVERSITY OF NEBRASKA AT KEARNEY,1,0,1998,NA,NA,1022,598,424,204,55,149,0.24,0.13,0.2,2508,53,316,895
181215,UNIVERSITY OF NEBRASKA AT KEARNEY,1,0,1999,NA,NA,1035,579,456,212,71,141,0.24,0.16,0.2,2122,57,321,949
181215,UNIVERSITY OF NEBRASKA AT KEARNEY,1,0,2000,NA,NA,996,550,446,159,48,111,0.2,0.11,0.16,2243,58,316,897
181215,UNIVERSITY OF NEBRASKA AT KEARNEY,1,0,2001,NA,NA,1038,602,436,213,62,151,0.25,0.14,0.21,2468,63,312,896
181215,UNIVERSITY OF NEBRASKA AT KEARNEY,1,0,2002,NA,NA,1022,574,448,216,69,147,0.25,0.15,0.21,2715,64,307,865
181215,UNIVERSITY OF NEBRASKA AT KEARNEY,1,0,2003,NA,NA,1012,588,424,229,73,156,0.26,0.17,0.23,3120,67,294,864
181215,UNIVERSITY OF NEBRASKA AT KEARNEY,1,0,2004,NA,NA,1061,589,472,238,85,153,0.25,0.18,0.22,3495,67,298,906
181215,University of Nebraska at Kearney,1,0,2005,NA,NA,1013,584,429,228,71,157,0.26,0.17,0.23,3668,72,306,848
181215,University of Nebraska at Kearney,1,0,2006,NA,NA,937,521,416,202,80,122,0.23,0.19,0.22,3885,75,309,771
181215,University of Nebraska at Kearney,1,0,2007,NA,NA,915,484,431,193,74,119,0.24,0.17,0.21,4118,79,305,729
181215,University of Nebraska at Kearney,1,0,2008,NA,NA,1019,530,489,232,87,145,0.27,0.18,0.23,4365,81,304,816
181215,University of Nebraska at Kearney,1,0,2009,NA,NA,974,548,426,231,81,150,0.27,0.19,0.24,4538,86,305,764
181215,University of Nebraska at Kearney,1,0,2010,NA,NA,1124,656,468,305,96,209,0.31,0.21,0.27,4808,89,306,922
181394,UNIVERSITY OF NEBRASKA AT OMAHA,1,0,1991,NA,NA,1275,635,640,70,31,39,0.06,0.05,0.05,1242,82,399,1049
181394,UNIVERSITY OF NEBRASKA AT OMAHA,1,0,1992,NA,NA,1256,630,626,54,19,35,0.05,0.03,0.04,1467,90,398,982
181394,UNIVERSITY OF NEBRASKA AT OMAHA,1,0,1993,NA,NA,1220,664,556,52,14,38,0.05,0.03,0.04,1535,91,403,1025
181394,UNIVERSITY OF NEBRASKA AT OMAHA,1,0,1995,NA,NA,1123,607,516,64,20,44,0.07,0.04,0.06,1790,90,415,929
181394,UNIVERSITY OF NEBRASKA AT OMAHA,1,0,1996,NA,NA,1129,588,541,87,32,55,0.09,0.06,0.08,1848,97,422,954
181394,UNIVERSITY OF NEBRASKA AT OMAHA,1,0,1997,NA,NA,1185,615,570,95,33,62,0.1,0.06,0.08,1926,102,438,960
181394,UNIVERSITY OF NEBRASKA AT OMAHA,1,0,1998,NA,NA,1296,701,595,120,42,78,0.11,0.07,0.09,2144,107,434,1072
181394,UNIVERSITY OF NEBRASKA AT OMAHA,1,0,1999,NA,NA,1477,762,715,151,45,106,0.13,0.06,0.1,2393,114,423,1251
181394,UNIVERSITY OF NEBRASKA AT OMAHA,1,0,2000,NA,NA,1517,825,692,157,55,102,0.12,0.08,0.1,2528,119,434,1273
181394,UNIVERSITY OF NEBRASKA AT OMAHA,1,0,2001,NA,NA,1588,857,731,170,62,108,0.12,0.08,0.11,2226,129,445,1338
181394,UNIVERSITY OF NEBRASKA AT OMAHA,1,0,2002,NA,NA,1601,851,750,199,77,122,0.14,0.1,0.12,3060,142,467,1355
181394,UNIVERSITY OF NEBRASKA AT OMAHA,1,0,2003,NA,NA,1465,787,678,189,85,104,0.13,0.13,0.13,3518,141,452,1261
181394,UNIVERSITY OF NEBRASKA AT OMAHA,1,0,2004,NA,NA,1577,878,699,201,78,123,0.14,0.11,0.13,3938,143,448,1366
181394,University of Nebraska at Omaha,1,0,2005,NA,NA,1690,911,779,259,105,154,0.16,0.13,0.15,4133,151,465,1402
181394,University of Nebraska at Omaha,1,0,2006,NA,NA,1637,864,773,231,95,136,0.15,0.12,0.14,4380,157,472,1349
181394,University of Nebraska at Omaha,1,0,2007,NA,NA,1596,834,762,228,106,122,0.14,0.14,0.14,4643,162,474,1279
181394,University of Nebraska at Omaha,1,0,2008,NA,NA,1755,920,835,286,107,179,0.19,0.13,0.16,4920,172,479,1419
181394,University of Nebraska at Omaha,1,0,2009,NA,NA,1747,932,815,278,93,185,0.19,0.11,0.16,5115,186,483,1393
181394,University of Nebraska at Omaha,1,0,2010,NA,NA,1703,925,778,14,8,6,0,0.01,0.01,5423,192,466,1281
181446,NEBRASKA WESLEYAN UNIVERSITY,1,0,1991,NA,NA,343,192,151,170,72,98,0.51,0.48,0.5,8226,17,87,319
181446,NEBRASKA WESLEYAN UNIVERSITY,1,0,1992,NA,NA,366,212,154,174,72,102,0.48,0.47,0.48,8430,17,86,348
181446,NEBRASKA WESLEYAN UNIVERSITY,1,0,1993,NA,NA,382,218,164,153,62,91,0.41000000000000003,0.38,0.4,8894,18,87,363
181446,NEBRASKA WESLEYAN UNIVERSITY,1,0,1995,NA,NA,362,214,148,164,57,107,0.5,0.39,0.45,9890,19,91,338
181446,NEBRASKA WESLEYAN UNIVERSITY,1,0,1996,NA,NA,383,225,158,202,79,123,0.54,0.5,0.53,10284,20,89,367
181446,NEBRASKA WESLEYAN UNIVERSITY,1,0,1997,NA,NA,437,250,187,205,87,118,0.47000000000000003,0.47,0.47,11220,17,86,422
181446,NEBRASKA WESLEYAN UNIVERSITY,1,0,1998,NA,NA,429,246,183,200,76,124,0.5,0.42,0.47,12004,18,89,415
181446,NEBRASKA WESLEYAN UNIVERSITY,1,0,1999,NA,NA,358,204,154,197,84,113,0.55,0.55,0.55,12584,19,92,343
181446,NEBRASKA WESLEYAN UNIVERSITY,1,0,2000,NA,NA,423,254,169,235,87,148,0.58,0.51,0.56,13452,21,95,403
181446,NEBRASKA WESLEYAN UNIVERSITY,1,0,2001,NA,NA,392,223,169,219,84,135,0.6,0.5,0.56,14380,23,99,374
181446,NEBRASKA WESLEYAN UNIVERSITY,1,0,2002,NA,NA,336,187,149,157,70,87,0.46,0.47,0.47,15372,24,95,316
181446,NEBRASKA WESLEYAN UNIVERSITY,1,0,2003,NA,NA,417,241,176,216,83,133,0.55,0.47,0.52,16140,23,101,396
181446,NEBRASKA WESLEYAN UNIVERSITY,1,0,2004,NA,NA,428,238,190,223,101,122,0.51,0.53,0.52,17090,25,103,406
181446,Nebraska Wesleyan University,1,0,2005,NA,NA,406,237,169,236,82,154,0.64,0.49,0.58,18100,28,105,394
181446,Nebraska Wesleyan University,1,0,2006,NA,NA,413,212,201,212,94,118,0.55,0.47,0.51,18980,30,109,385
181446,Nebraska Wesleyan University,1,0,2007,NA,NA,438,272,166,239,74,165,0.6,0.45,0.55,19930,31,110,414
181446,Nebraska Wesleyan University,1,0,2008,NA,NA,383,212,171,211,76,135,0.63,0.44,0.55,20950,32,115,352
181446,Nebraska Wesleyan University,1,0,2009,NA,NA,393,233,160,201,63,138,0.59,0.39,0.51,21980,33,113,364
181446,Nebraska Wesleyan University,1,0,2010,NA,NA,427,237,190,256,106,150,0.63,0.56,0.6,23124,34,118,376
181464,UNIVERSITY OF NEBRASKA AT LINCOLN,1,0,1991,NA,NA,3386,1641,1745,379,121,258,0.15,0.07,0.11,2040,337,1127,3162
181464,UNIVERSITY OF NEBRASKA AT LINCOLN,1,0,1992,NA,NA,3392,1651,1741,330,124,206,0.12,0.07,0.1,2187,351,1126,3154
181464,UNIVERSITY OF NEBRASKA AT LINCOLN,1,0,1993,NA,NA,3325,1571,1754,449,170,279,0.17,0.1,0.14,2283,374,1127,3079
181464,UNIVERSITY OF NEBRASKA AT LINCOLN,1,0,1995,NA,NA,3891,1925,1966,620,256,364,0.18,0.13,0.16,2555,402,1115,3514
181464,UNIVERSITY OF NEBRASKA AT LINCOLN,1,0,1996,NA,NA,3625,1814,1811,654,248,406,0.22,0.14,0.18,2638,426,1100,3258
181464,UNIVERSITY OF NEBRASKA AT LINCOLN,1,0,1997,NA,NA,3195,1596,1599,681,259,422,0.26,0.16,0.21,2829,438,1127,2863
181464,UNIVERSITY OF NEBRASKA AT LINCOLN,1,0,1998,NA,NA,3353,1619,1734,740,275,465,0.28,0.16,0.22,3083,458,1129,3026
181464,UNIVERSITY OF NEBRASKA AT LINCOLN,1,0,1999,NA,NA,3592,1778,1814,807,317,490,0.27,0.17,0.22,2617,476,1154,3259
181464,UNIVERSITY OF NEBRASKA AT LINCOLN,1,0,2000,NA,NA,3598,1783,1815,823,326,497,0.27,0.18,0.23,2760,501,1135,3123
181464,UNIVERSITY OF NEBRASKA AT LINCOLN,1,0,2001,NA,NA,3480,1691,1789,788,308,480,0.28,0.17,0.23,3038,528,1116,3090
181464,UNIVERSITY OF NEBRASKA AT LINCOLN,1,0,2002,NA,NA,3615,1878,1737,919,358,561,0.29,0.21,0.25,3345,568,1088,3158
181464,UNIVERSITY OF NEBRASKA AT LINCOLN,1,0,2003,NA,NA,3639,1825,1814,904,341,563,0.3,0.19,0.25,3847,597,1035,3184
181464,UNIVERSITY OF NEBRASKA AT LINCOLN,1,0,2004,NA,NA,3236,1559,1677,950,394,556,0.35000000000000003,0.23,0.29,4312,598,1038,2817
181464,University of Nebraska at Lincoln,1,0,2005,NA,NA,3533,1671,1862,1118,505,613,0.36,0.27,0.32,4530,636,1129,3012
181464,University of Nebraska at Lincoln,1,0,2006,NA,NA,3828,1805,2023,1126,503,623,0.34,0.25,0.29,4800,696,1131,3245
181464,University of Nebraska-Lincoln,1,0,2007,NA,NA,4214,2061,2153,1363,555,808,0.39,0.26,0.32,5085,718,1164,3423
181464,University of Nebraska-Lincoln,1,0,2008,NA,NA,4164,2015,2149,1377,566,811,0.4,0.26,0.33,5392,768,1166,3582
181464,University of Nebraska-Lincoln,1,0,2009,NA,NA,3965,1870,2095,1308,552,756,0.4,0.26,0.33,5610,773,1152,3409
181464,University of Nebraska-Lincoln,1,0,2010,NA,NA,4039,1889,2150,1461,647,814,0.43,0.3,0.36,5948,810,1180,3510
181534,PERU STATE COLLEGE,1,0,1991,NA,NA,235,129,106,24,7,17,0.13,0.07,0.1,1589,8,49,211
181534,PERU STATE COLLEGE,1,0,1992,NA,NA,264,135,129,27,9,18,0.13,0.07,0.1,1671,9,48,247
181534,PERU STATE COLLEGE,1,0,1993,NA,NA,211,112,99,22,4,18,0.16,0.04,0.1,1687,9,50,200
181534,PERU STATE COLLEGE,1,0,1995,NA,NA,225,122,103,45,19,26,0.21,0.18,0.2,1848,10,47,205
181534,PERU STATE COLLEGE,1,0,1996,NA,NA,223,97,126,38,11,27,0.27,0.09,0.17,1936,10,46,199
181534,PERU STATE COLLEGE,1,0,1997,NA,NA,258,107,151,38,16,22,0.2,0.11,0.15,2018,11,43,222
181534,PERU STATE COLLEGE,1,0,1998,NA,NA,213,91,122,22,3,19,0.2,0.02,0.1,2161,12,42,184
181534,PERU STATE COLLEGE,1,0,1999,NA,NA,192,87,105,65,31,34,0.39,0.3,0.34,1875,11,43,168
181534,PERU STATE COLLEGE,1,0,2000,NA,NA,201,93,108,26,7,19,0.2,0.06,0.13,1973,12,41,170
181534,PERU STATE COLLEGE,1,0,2001,NA,NA,186,85,101,16,5,11,0.12,0.05,0.09,2093,13,40,164
181534,PERU STATE COLLEGE,1,0,2002,NA,NA,171,85,86,29,10,19,0.22,0.12,0.17,2288,12,41,149
181534,PERU STATE COLLEGE,1,0,2003,NA,NA,188,89,99,29,9,20,0.22,0.09,0.15,2610,12,39,161
181534,PERU STATE COLLEGE,1,0,2004,NA,NA,217,114,103,21,5,16,0.14,0.05,0.1,2850,12,40,189
181534,Peru State College,1,0,2005,NA,NA,213,112,101,26,7,19,0.16,0.07,0.12,2932,13,45,174
181534,Peru State College,1,0,2006,NA,NA,204,95,109,37,17,20,0.21,0.16,0.18,3296,14,47,166
181534,Peru State College,1,0,2007,NA,NA,197,89,108,38,13,25,0.28,0.12,0.19,3300,15,45,159
181534,Peru State College,1,0,2008,NA,NA,210,101,109,23,10,13,0.12,0.09,0.11,3495,16,48,178
181534,Peru State College,1,0,2009,NA,NA,227,113,114,35,12,23,0.2,0.11,0.15,3675,17,46,190
181534,Peru State College,1,0,2010,NA,NA,243,117,126,32,6,26,0.22,0.05,0.13,3863,18,46,209
181783,WAYNE STATE COLLEGE,1,0,1991,NA,NA,681,357,324,103,38,65,0.18,0.12,0.15,1515,18,120,649
181783,WAYNE STATE COLLEGE,1,0,1992,NA,NA,630,348,282,117,39,78,0.22,0.14,0.19,1599,20,124,605
181783,WAYNE STATE COLLEGE,1,0,1993,NA,NA,718,398,320,105,25,80,0.2,0.08,0.15,1690,22,125,674
181783,WAYNE STATE COLLEGE,1,0,1995,NA,NA,722,382,340,146,45,101,0.26,0.13,0.2,1839,22,131,666
181783,WAYNE STATE COLLEGE,1,0,1996,NA,NA,690,397,293,147,53,94,0.23,0.18,0.21,1938,23,132,636
181783,WAYNE STATE COLLEGE,1,0,1997,NA,NA,707,407,300,161,42,119,0.29,0.14,0.23,2080,25,138,641
181783,WAYNE STATE COLLEGE,1,0,1998,NA,NA,700,402,298,177,56,121,0.3,0.19,0.25,2163,28,138,636
181783,WAYNE STATE COLLEGE,1,0,1999,NA,NA,659,387,272,150,41,109,0.28,0.15,0.23,1875,28,140,601
181783,WAYNE STATE COLLEGE,1,0,2000,NA,NA,623,366,257,168,49,119,0.32,0.19,0.27,1973,28,134,573
181783,WAYNE STATE COLLEGE,1,0,2001,NA,NA,583,359,224,138,40,98,0.27,0.18,0.24,2093,29,129,524
181783,WAYNE STATE COLLEGE,1,0,2002,NA,NA,602,325,277,155,66,89,0.27,0.24,0.26,2288,28,126,533
181783,WAYNE STATE COLLEGE,1,0,2003,NA,NA,598,342,256,163,59,104,0.3,0.23,0.27,2610,30,126,536
181783,WAYNE STATE COLLEGE,1,0,2004,NA,NA,552,310,242,128,39,89,0.28,0.16,0.23,2850,29,127,494
181783,Wayne State College,1,0,2005,NA,NA,587,320,267,162,71,91,0.28,0.27,0.28,2346,32,126,533
181783,Wayne State College,1,0,2006,NA,NA,606,335,271,166,53,113,0.33,0.2,0.27,2460,34,130,527
181783,Wayne State College,1,0,2007,NA,NA,654,364,290,162,48,114,0.31,0.17,0.25,2640,36,132,554
181783,Wayne State College,1,0,2008,NA,NA,653,345,308,148,52,96,0.27,0.17,0.23,2796,38,125,568
181783,Wayne State College,1,0,2009,NA,NA,663,361,302,158,56,102,0.28,0.19,0.24,3675,40,123,537
181783,Wayne State College,1,0,2010,NA,NA,677,366,311,172,58,114,0.31,0.19,0.25,3863,39,125,537
182281,UNIVERSITY OF NEVADA-LAS VEGAS,1,0,1991,NA,NA,1172,604,568,125,47,78,0.12,0.08,0.11,1470,128,598,796
182281,UNIVERSITY OF NEVADA-LAS VEGAS,1,0,1992,NA,NA,1213,641,572,128,44,84,0.13,0.08,0.11,1665,136,593,838
182281,UNIVERSITY OF NEVADA-LAS VEGAS,1,0,1993,NA,NA,1281,669,612,127,47,80,0.11,0.08,0.1,1665,132,642,828
182281,UNIVERSITY OF NEVADA-LAS VEGAS,1,0,1995,NA,NA,1324,748,576,161,54,107,0.14,0.09,0.12,1830,161,612,837
182281,UNIVERSITY OF NEVADA-LAS VEGAS,1,0,1996,NA,NA,1509,797,712,179,49,130,0.16,0.07,0.12,1920,170,607,911
182281,UNIVERSITY OF NEVADA-LAS VEGAS,1,0,1997,NA,NA,1491,773,718,183,54,129,0.16,0.08,0.12,1995,185,612,903
182281,UNIVERSITY OF NEVADA-LAS VEGAS,1,0,1998,NA,NA,1546,885,661,186,58,128,0.14,0.09,0.12,2070,201,632,910
182281,UNIVERSITY OF NEVADA-LAS VEGAS,1,0,1999,NA,NA,1486,805,681,204,73,131,0.16,0.11,0.14,2145,221,676,886
182281,UNIVERSITY OF NEVADA-LAS VEGAS,1,0,2000,NA,NA,2126,1182,944,240,70,170,0.14,0.07,0.11,2340,238,698,1224
182281,UNIVERSITY OF NEVADA-LAS VEGAS,1,0,2001,NA,NA,2424,1411,1013,324,99,225,0.15,0.1,0.13,2415,258,721,1368
182281,UNIVERSITY OF NEVADA-LAS VEGAS,1,0,2002,NA,NA,2383,1373,1010,293,80,213,0.15,0.08,0.12,2490,289,755,1292
182281,UNIVERSITY OF NEVADA-LAS VEGAS,1,0,2003,NA,NA,2827,1596,1231,338,107,231,0.14,0.09,0.12,2670,327,776,1496
182281,UNIVERSITY OF NEVADA-LAS VEGAS,1,0,2004,NA,NA,3108,1760,1348,428,134,294,0.16,0.1,0.14,2850,361,810,1604
182281,University of Nevada-Las Vegas,1,0,2005,NA,NA,2964,1694,1270,402,134,268,0.15,0.11,0.14,3060,400,851,1140
182281,University of Nevada-Las Vegas,1,0,2006,NA,NA,2532,1410,1122,368,130,238,0.16,0.12,0.15,3278,442,950,1225
182281,University of Nevada-Las Vegas,1,0,2007,NA,NA,2780,1596,1184,406,117,289,0.18,0.1,0.15,3623,496,960,1305
182281,University of Nevada-Las Vegas,1,0,2008,NA,NA,3020,1709,1311,422,142,280,0.16,0.11,0.14,4005,506,904,1318
182281,University of Nevada-Las Vegas,1,0,2009,NA,NA,3083,1659,1424,397,146,251,0.15,0.1,0.13,4485,535,897,1307
182281,University of Nevada-Las Vegas,1,0,2010,NA,NA,2923,1621,1302,341,117,224,0.13,0.09,0.12,5196,528,842,1141
182290,UNIVERSITY OF NEVADA-RENO,1,0,1991,NA,NA,966,482,484,101,43,58,0.12,0.09,0.1,1104,154,390,751
182290,UNIVERSITY OF NEVADA-RENO,1,0,1992,NA,NA,1058,523,535,119,41,78,0.14,0.08,0.11,1308,174,404,855
182290,UNIVERSITY OF NEVADA-RENO,1,0,1993,NA,NA,1140,563,577,155,49,106,0.18,0.08,0.14,1332,186,403,915
182290,UNIVERSITY OF NEVADA-RENO,1,0,1995,NA,NA,1035,591,444,170,52,118,0.19,0.12,0.16,1464,211,386,790
182290,UNIVERSITY OF NEVADA-RENO,1,0,1996,NA,NA,1123,605,518,163,46,117,0.19,0.09,0.15,1650,236,429,871
182290,UNIVERSITY OF NEVADA-RENO,1,0,1997,NA,NA,1165,654,511,171,54,117,0.17,0.11,0.15,1710,249,430,888
182290,UNIVERSITY OF NEVADA-RENO,1,0,1998,NA,NA,1260,675,585,181,60,121,0.17,0.1,0.14,1770,266,424,973
182290,UNIVERSITY OF NEVADA-RENO,1,0,1999,NA,NA,1466,792,674,241,78,163,0.2,0.12,0.16,1704,278,434,1116
182290,UNIVERSITY OF NEVADA-RENO,1,0,2000,NA,NA,1930,1090,840,293,95,198,0.18,0.11,0.15,2340,302,447,1461
182290,UNIVERSITY OF NEVADA-RENO,1,0,2001,NA,NA,1956,1125,831,268,78,190,0.16,0.09,0.14,2415,325,460,1504
182290,UNIVERSITY OF NEVADA-RENO,1,0,2002,NA,NA,2066,1137,929,308,102,206,0.18,0.11,0.15,2490,345,750,1571
182290,UNIVERSITY OF NEVADA-RENO,1,0,2003,NA,NA,2047,1154,893,254,76,178,0.15,0.09,0.12,2670,370,712,1479
182290,UNIVERSITY OF NEVADA-RENO,1,0,2004,NA,NA,2132,1157,975,289,104,185,0.15,0.11,0.14,2850,405,639,1467
182290,University of Nevada-Reno,1,0,2005,NA,NA,2362,1300,1062,383,136,247,0.19,0.13,0.16,3060,430,639,1598
182290,University of Nevada-Reno,1,0,2006,NA,NA,2358,1300,1058,407,146,261,0.2,0.14,0.17,3278,470,656,1576
182290,University of Nevada-Reno,1,0,2007,NA,NA,2226,1166,1060,349,131,218,0.18,0.12,0.16,3623,494,658,1498
182290,University of Nevada-Reno,1,0,2008,NA,NA,2260,1211,1049,467,179,288,0.23,0.17,0.21,4005,518,660,1513
182290,University of Nevada-Reno,1,0,2009,NA,NA,2124,1144,980,467,172,295,0.25,0.18,0.22,4485,530,645,1484
182290,University of Nevada-Reno,1,0,2010,NA,NA,2693,1430,1263,610,233,377,0.26,0.18,0.23,5063,517,631,1785
182634,COLBY-SAWYER COLLEGE,1,0,1991,NA,NA,215,137,78,99,29,70,0.51,0.37,0.46,11900,9,34,213
182634,COLBY-SAWYER COLLEGE,1,0,1992,NA,NA,160,106,54,73,23,50,0.47000000000000003,0.43,0.46,12775,11,34,158
182634,COLBY-SAWYER COLLEGE,1,0,1993,NA,NA,179,115,64,72,24,48,0.41000000000000003,0.38,0.4,13375,12,38,173
182634,COLBY-SAWYER COLLEGE,1,0,1995,NA,NA,240,154,86,115,46,69,0.44,0.53,0.48,14720,15,40,230
182634,COLBY-SAWYER COLLEGE,1,0,1996,NA,NA,227,158,69,91,31,60,0.37,0.45,0.4,15530,20,41,220
182634,COLBY-SAWYER COLLEGE,1,0,1997,NA,NA,240,172,68,111,29,82,0.47000000000000003,0.43,0.46,16310,14,40,214
182634,COLBY-SAWYER COLLEGE,1,0,1998,NA,NA,235,162,73,111,29,82,0.5,0.4,0.47,17270,16,41,221
182634,COLBY-SAWYER COLLEGE,1,0,1999,NA,NA,236,151,85,115,47,68,0.45,0.55,0.49,18060,16,42,224
182634,COLBY-SAWYER COLLEGE,1,0,2000,NA,NA,274,180,94,148,47,101,0.56,0.5,0.54,18960,18,45,262
182634,COLBY-SAWYER COLLEGE,1,0,2001,NA,NA,285,184,101,140,43,97,0.52,0.43,0.49,20130,22,48,254
182634,COLBY-SAWYER COLLEGE,1,0,2002,NA,NA,270,172,98,133,54,79,0.45,0.55,0.49,21140,21,50,261
182634,COLBY-SAWYER COLLEGE,1,0,2003,NA,NA,304,207,97,158,34,124,0.59,0.35,0.52,22200,23,47,294
182634,COLBY-SAWYER COLLEGE,1,0,2004,NA,NA,263,179,84,140,42,98,0.54,0.5,0.53,23310,25,53,255
182634,Colby-Sawyer College,1,0,2005,NA,NA,280,179,101,130,42,88,0.49,0.42,0.46,24700,25,54,271
182634,Colby-Sawyer College,1,0,2006,NA,NA,220,151,69,95,22,73,0.48,0.32,0.43,26350,26,55,200
182634,Colby-Sawyer College,1,0,2007,NA,NA,353,240,113,169,44,125,0.52,0.39,0.48,28010,27,47,306
182634,Colby-Sawyer College,1,0,2008,NA,NA,376,251,125,138,44,94,0.37,0.35,0.37,29620,28,51,323
182634,Colby-Sawyer College,1,0,2009,NA,NA,432,313,119,190,45,145,0.46,0.38,0.44,31090,29,60,357
182634,Colby-Sawyer College,1,0,2010,NA,NA,393,266,127,185,51,134,0.5,0.4,0.47,32640,32,64,271
182795,FRANKLIN PIERCE COLLEGE,1,0,1991,NA,NA,429,192,237,124,57,67,0.34,0.24,0.29,11510,24,73,337
182795,FRANKLIN PIERCE COLLEGE,1,0,1992,NA,NA,469,236,233,178,82,96,0.4,0.35,0.38,12430,26,75,340
182795,FRANKLIN PIERCE COLLEGE,1,0,1993,NA,NA,410,186,224,117,64,53,0.28,0.29,0.29,12820,28,76,377
182795,FRANKLIN PIERCE COLLEGE,1,0,1995,NA,NA,464,220,244,174,75,99,0.45,0.31,0.38,14445,28,61,383
182795,FRANKLIN PIERCE COLLEGE,1,0,1996,NA,NA,438,210,228,181,81,100,0.47000000000000003,0.36,0.41,15375,33,67,313
182795,FRANKLIN PIERCE COLLEGE,1,0,1997,NA,NA,489,257,232,178,69,109,0.42,0.3,0.36,16325,30,69,398
182795,FRANKLIN PIERCE COLLEGE,1,0,1998,NA,NA,429,203,226,145,59,86,0.42,0.26,0.34,17022,29,68,330
182795,FRANKLIN PIERCE COLLEGE,1,0,1999,NA,NA,429,184,245,189,103,86,0.46,0.42,0.44,17250,31,67,363
182795,FRANKLIN PIERCE COLLEGE,1,0,2000,NA,NA,530,262,268,227,101,126,0.48,0.38,0.43,18150,32,66,442
182795,FRANKLIN PIERCE COLLEGE,1,0,2001,NA,NA,477,249,228,153,67,86,0.34,0.29,0.32,18900,34,65,387
182795,FRANKLIN PIERCE COLLEGE,1,0,2002,NA,NA,505,252,253,197,88,109,0.43,0.35,0.39,19560,36,61,417
182795,FRANKLIN PIERCE COLLEGE,1,0,2003,NA,NA,514,244,270,172,74,98,0.4,0.27,0.33,20790,38,69,403
182795,FRANKLIN PIERCE COLLEGE,1,0,2004,NA,NA,568,285,283,232,97,135,0.47000000000000003,0.34,0.41,21900,39,70,452
182795,Franklin Pierce College,1,0,2005,NA,NA,532,270,262,2,0,2,0,0,0,23100,43,71,443
182795,Franklin Pierce College,1,0,2006,NA,NA,553,260,293,226,103,123,0.47000000000000003,0.35,0.41,24300,44,86,438
182795,Franklin Pierce University,1,0,2007,NA,NA,533,239,294,207,100,107,0.44,0.34,0.39,25516,47,92,402
182795,Franklin Pierce University,1,0,2008,NA,NA,474,205,269,185,89,96,0.46,0.33,0.39,27000,49,97,360
182795,Franklin Pierce University,1,0,2009,NA,NA,388,175,213,138,62,76,0.43,0.29,0.36,27700,50,99,307
182795,Franklin Pierce University,1,0,2010,NA,NA,399,179,220,142,50,92,0.51,0.23,0.36,27700,47,99,295
183062,KEENE STATE COLLEGE,1,0,1991,NA,NA,731,444,287,159,41,118,0.26,0.14,0.22,2680,37,191,630
183062,KEENE STATE COLLEGE,1,0,1992,NA,NA,754,447,307,179,50,129,0.28,0.16,0.24,2845,39,160,699
183062,KEENE STATE COLLEGE,1,0,1993,NA,NA,809,488,321,170,43,127,0.26,0.13,0.21,3120,43,180,765
183062,KEENE STATE COLLEGE,1,0,1995,NA,NA,988,588,400,251,86,165,0.28,0.22,0.25,3604,47,179,941
183062,KEENE STATE COLLEGE,1,0,1996,NA,NA,839,499,340,211,68,143,0.28,0.2,0.25,3794,52,185,788
183062,KEENE STATE COLLEGE,1,0,1997,NA,NA,845,501,344,193,71,122,0.24,0.21,0.23,4320,52,182,789
183062,KEENE STATE COLLEGE,1,0,1998,NA,NA,773,470,303,178,53,125,0.26,0.17,0.23,4750,56,175,716
183062,KEENE STATE COLLEGE,1,0,1999,NA,NA,1014,649,365,262,70,192,0.29,0.19,0.26,3830,58,181,964
183062,KEENE STATE COLLEGE,1,0,2000,NA,NA,935,576,359,243,69,174,0.3,0.19,0.26,4060,61,188,909
183062,KEENE STATE COLLEGE,1,0,2001,NA,NA,942,561,381,283,94,189,0.33,0.25,0.3,4220,65,196,895
183062,KEENE STATE COLLEGE,1,0,2002,NA,NA,1170,668,502,333,119,214,0.32,0.24,0.28,4450,64,199,1118
183062,KEENE STATE COLLEGE,1,0,2003,NA,NA,991,598,393,369,126,243,0.4,0.32,0.37,4750,71,183,942
183062,KEENE STATE COLLEGE,1,0,2004,NA,NA,1068,649,419,425,148,277,0.42,0.35,0.4,5060,71,183,1003
183062,Keene State College,1,0,2005,NA,NA,1001,565,436,434,172,262,0.46,0.39,0.43,5410,76,180,943
183062,Keene State College,1,0,2006,NA,NA,1139,718,421,559,194,365,0.5,0.46,0.49,5780,83,181,1083
183062,Keene State College,1,0,2007,NA,NA,1295,762,533,666,252,414,0.54,0.47,0.51,6180,89,185,1235
183062,Keene State College,1,0,2008,NA,NA,1287,777,510,667,238,429,0.55,0.47,0.52,6600,96,185,1226
183062,Keene State College,1,0,2009,NA,NA,1171,712,459,616,228,388,0.54,0.5,0.53,7000,100,194,1093
183062,Keene State College,1,0,2010,NA,NA,1201,718,483,643,252,391,0.54,0.52,0.54,7650,106,197,976
183080,PLYMOUTH STATE COLLEGE,1,0,1991,NA,NA,729,377,352,219,83,136,0.36,0.24,0.3,2716,35,164,655
183080,PLYMOUTH STATE COLLEGE,1,0,1992,NA,NA,775,403,372,206,79,127,0.31,0.21,0.27,2926,38,162,702
183080,PLYMOUTH STATE COLLEGE,1,0,1993,NA,NA,748,364,384,163,63,100,0.27,0.16,0.22,3281,40,164,688
183080,PLYMOUTH STATE COLLEGE,1,0,1995,NA,NA,872,426,446,204,80,124,0.29,0.18,0.23,3754,43,153,820
183080,PLYMOUTH STATE COLLEGE,1,0,1996,NA,NA,894,433,461,196,87,109,0.25,0.19,0.22,3926,45,159,837
183080,PLYMOUTH STATE COLLEGE,1,0,1997,NA,NA,844,396,448,163,75,88,0.22,0.17,0.19,4342,47,168,775
183080,PLYMOUTH STATE COLLEGE,1,0,1998,NA,NA,784,375,409,190,81,109,0.29,0.2,0.24,4780,49,164,715
183080,PLYMOUTH STATE COLLEGE,1,0,1999,NA,NA,772,377,395,204,75,129,0.34,0.19,0.26,3830,50,161,677
183080,PLYMOUTH STATE COLLEGE,1,0,2000,NA,NA,902,454,448,241,97,144,0.31,0.22,0.27,4060,52,163,836
183080,PLYMOUTH STATE COLLEGE,1,0,2001,NA,NA,872,463,409,272,89,183,0.39,0.22,0.31,4220,54,166,804
183080,PLYMOUTH STATE COLLEGE,1,0,2002,NA,NA,940,447,493,279,120,159,0.35000000000000003,0.24,0.3,4450,55,168,856
183080,PLYMOUTH STATE UNIVERSITY,1,0,2003,NA,NA,900,469,431,310,134,176,0.37,0.31,0.34,4750,58,171,811
183080,PLYMOUTH STATE UNIVERSITY,1,0,2004,NA,NA,1052,524,528,356,156,200,0.38,0.3,0.34,5060,62,183,959
183080,Plymouth State University,1,0,2005,NA,NA,999,473,526,401,193,208,0.43,0.37,0.4,5410,67,181,921
183080,Plymouth State University,1,0,2006,NA,NA,1008,446,562,402,191,211,0.47000000000000003,0.34,0.4,5780,75,185,870
183080,Plymouth State University,1,0,2007,NA,NA,1006,444,562,414,206,208,0.46,0.37,0.41,6180,79,187,788
183080,Plymouth State University,1,0,2008,NA,NA,1087,500,587,476,214,262,0.52,0.36,0.44,6600,85,188,889
183080,Plymouth State University,1,0,2009,NA,NA,971,450,521,430,196,234,0.52,0.38,0.44,7000,88,184,835
183080,Plymouth State University,1,0,2010,NA,NA,1056,520,536,456,186,270,0.51,0.35,0.43,7650,90,187,817
183239,SAINT ANSELM COLLEGE,1,0,1991,NA,NA,545,303,242,365,155,210,0.6900000000000001,0.64,0.67,10160,26,114,535
183239,SAINT ANSELM COLLEGE,1,0,1992,NA,NA,493,274,219,325,141,184,0.67,0.64,0.66,10870,31,113,479
183239,SAINT ANSELM COLLEGE,1,0,1993,NA,NA,510,284,226,323,128,195,0.68,0.57,0.63,11840,31,109,496
183239,SAINT ANSELM COLLEGE,1,0,1995,NA,NA,612,369,243,424,163,261,0.7000000000000001,0.67,0.69,13720,34,108,592
183239,SAINT ANSELM COLLEGE,1,0,1996,NA,NA,549,301,248,397,172,225,0.74,0.69,0.72,14550,37,113,527
183239,SAINT ANSELM COLLEGE,1,0,1997,NA,NA,508,283,225,350,134,216,0.76,0.6,0.69,15430,28,115,483
183239,SAINT ANSELM COLLEGE,1,0,1998,NA,NA,528,296,232,392,159,233,0.78,0.69,0.74,16370,30,120,512
183239,SAINT ANSELM COLLEGE,1,0,1999,NA,NA,534,280,254,376,160,216,0.77,0.63,0.7,17300,33,113,509
183239,SAINT ANSELM COLLEGE,1,0,2000,NA,NA,518,280,238,349,142,207,0.73,0.6,0.67,18350,34,116,502
183239,SAINT ANSELM COLLEGE,1,0,2001,NA,NA,535,286,249,363,152,211,0.73,0.61,0.68,19460,37,120,502
183239,SAINT ANSELM COLLEGE,1,0,2002,NA,NA,570,330,240,406,148,258,0.78,0.62,0.71,20390,40,124,531
183239,SAINT ANSELM COLLEGE,1,0,2003,NA,NA,587,336,251,418,172,246,0.73,0.69,0.71,21410,43,126,497
183239,SAINT ANSELM COLLEGE,1,0,2004,NA,NA,516,284,232,370,149,221,0.77,0.64,0.72,22700,45,129,241
183239,Saint Anselm College,1,0,2005,NA,NA,519,296,223,372,145,227,0.76,0.65,0.72,23990,48,132,410
183239,Saint Anselm College,1,0,2006,NA,NA,568,343,225,410,151,259,0.75,0.67,0.72,25430,50,135,471
183239,Saint Anselm College,1,0,2007,NA,NA,568,300,268,404,169,235,0.78,0.63,0.71,26960,53,136,515
183239,Saint Anselm College,1,0,2008,NA,NA,500,286,214,351,143,208,0.72,0.67,0.7,28440,62,136,454
183239,Saint Anselm College,1,0,2009,NA,NA,528,285,243,372,154,218,0.76,0.63,0.7,29720,64,143,448
183239,Saint Anselm College,1,0,2010,NA,NA,535,295,240,369,142,227,0.76,0.59,0.69,30760,62,141,455
183822,BLOOMFIELD COLLEGE,1,0,1991,NA,NA,267,179,88,18,6,12,0.06,0.07,0.07,7450,16,42,67
183822,BLOOMFIELD COLLEGE,1,0,1992,NA,NA,266,170,96,15,6,9,0.05,0.06,0.06,7750,18,45,66
183822,BLOOMFIELD COLLEGE,1,0,1993,NA,NA,270,192,78,20,5,15,0.07,0.06,0.07,8050,20,46,78
183822,BLOOMFIELD COLLEGE,1,0,1995,NA,NA,275,196,79,40,11,29,0.14,0.14,0.15,8850,19,56,63
183822,BLOOMFIELD COLLEGE,1,0,1996,NA,NA,227,150,77,36,6,30,0.2,0.08,0.16,9100,20,54,41
183822,BLOOMFIELD COLLEGE,1,0,1997,NA,NA,312,213,99,26,8,18,0.08,0.08,0.08,9500,19,56,52
183822,BLOOMFIELD COLLEGE,1,0,1998,NA,NA,247,170,77,25,7,18,0.1,0.09,0.1,9900,20,62,20
183822,BLOOMFIELD COLLEGE,1,0,1999,NA,NA,242,155,87,13,4,9,0.05,0.05,0.05,10300,21,64,28
183822,BLOOMFIELD COLLEGE,1,0,2000,NA,NA,236,135,101,13,8,5,0.03,0.08,0.06,10800,23,62,25
183822,BLOOMFIELD COLLEGE,1,0,2001,NA,NA,250,150,100,41,16,25,0.16,0.16,0.16,11300,25,60,47
183822,BLOOMFIELD COLLEGE,1,0,2002,NA,NA,339,216,123,57,15,42,0.19,0.12,0.17,12100,25,60,42
183822,BLOOMFIELD COLLEGE,1,0,2003,NA,NA,341,215,126,39,6,33,0.15,0.05,0.11,12900,28,62,44
183822,BLOOMFIELD COLLEGE,1,0,2004,NA,NA,361,233,128,32,14,18,0.07,0.11,0.09,13700,31,66,53
183822,Bloomfield College,1,0,2005,NA,NA,367,210,157,37,15,22,0.1,0.1,0.1,14850,29,62,60
183822,Bloomfield College,1,0,2006,NA,NA,316,183,133,47,18,29,0.15,0.14,0.15,16100,31,69,49
183822,Bloomfield College,1,0,2007,NA,NA,313,176,137,45,24,21,0.11,0.18,0.14,17500,32,69,47
183822,Bloomfield College,1,0,2008,NA,NA,392,237,155,23,10,13,0.05,0.06,0.06,19080,33,69,46
183822,Bloomfield College,1,0,2009,NA,NA,439,278,161,32,16,16,0.05,0.1,0.07,20000,36,68,38
183822,Bloomfield College,1,0,2010,NA,NA,379,225,154,44,22,22,0.09,0.14,0.12,21200,38,66,33
183974,CENTENARY COLLEGE,1,0,1991,NA,NA,89,66,23,22,3,19,0.28,0.13,0.25,10300,8,31,52
183974,CENTENARY COLLEGE,1,0,1992,NA,NA,113,86,27,19,4,15,0.17,0.15,0.17,10911,9,35,68
183974,CENTENARY COLLEGE,1,0,1993,NA,NA,95,77,18,20,2,18,0.23,0.11,0.21,11600,10,36,50
183974,CENTENARY COLLEGE,1,0,1995,NA,NA,73,53,20,19,3,16,0.3,0.15,0.26,12104,11,38,46
183974,CENTENARY COLLEGE,1,0,1996,NA,NA,86,63,23,21,0,21,0.33,0,0.24,12608,12,40,42
183974,CENTENARY COLLEGE,1,0,1997,NA,NA,104,65,39,24,8,16,0.24,0.21,0.23,13120,10,41,24
183974,CENTENARY COLLEGE,1,0,1998,NA,NA,124,77,47,26,8,18,0.23,0.17,0.21,13730,11,37,41
183974,CENTENARY COLLEGE,1,0,1999,NA,NA,136,98,38,58,17,41,0.41000000000000003,0.45,0.43,13800,12,44,69
183974,CENTENARY COLLEGE,1,0,2000,NA,NA,145,114,31,56,7,49,0.42,0.23,0.39,14500,13,45,96
183974,CENTENARY COLLEGE,1,0,2001,NA,NA,195,141,54,57,6,51,0.36,0.11,0.29,15100,15,47,120
183974,CENTENARY COLLEGE,1,0,2002,NA,NA,236,147,89,97,27,70,0.47000000000000003,0.3,0.41,15700,17,49,165
183974,CENTENARY COLLEGE,1,0,2003,NA,NA,221,126,95,112,47,65,0.51,0.49,0.51,17100,21,47,147
183974,CENTENARY COLLEGE,1,0,2004,NA,NA,258,169,89,123,38,85,0.5,0.43,0.48,18450,25,53,170
183974,Centenary College,1,0,2005,NA,NA,240,160,80,115,35,80,0.5,0.44,0.48,19840,29,62,172
183974,Centenary College,1,0,2006,NA,NA,303,211,92,147,41,106,0.5,0.45,0.49,21230,34,64,211
183974,Centenary College,1,0,2007,NA,NA,275,175,100,154,54,100,0.5700000000000001,0.54,0.56,22930,38,67,204
183974,Centenary College,1,0,2008,NA,NA,310,196,114,188,63,125,0.63,0.55,0.61,23900,42,68,227
183974,Centenary College,1,0,2009,NA,NA,270,165,105,156,50,106,0.64,0.48,0.58,25334,45,69,186
183974,Centenary College,1,0,2010,NA,NA,252,144,108,115,35,80,0.55,0.32,0.46,26854,44,72,161
184348,DREW UNIVERSITY,1,0,1991,NA,NA,269,166,103,188,70,118,0.71,0.68,0.7,16424,46,119,184
184348,DREW UNIVERSITY,1,0,1992,NA,NA,332,203,129,246,92,154,0.75,0.71,0.74,17294,46,120,244
184348,DREW UNIVERSITY,1,0,1993,NA,NA,312,190,122,226,84,142,0.74,0.69,0.72,18058,47,119,224
184348,DREW UNIVERSITY,1,0,1995,NA,NA,433,255,178,312,122,190,0.74,0.69,0.72,19642,52,127,291
184348,DREW UNIVERSITY,1,0,1996,NA,NA,371,203,168,265,118,147,0.72,0.7,0.71,20402,57,130,240
184348,DREW UNIVERSITY,1,0,1997,NA,NA,418,243,175,294,117,177,0.72,0.67,0.7,21396,48,131,300
184348,DREW UNIVERSITY,1,0,1998,NA,NA,337,213,124,226,84,142,0.66,0.68,0.67,22232,51,145,224
184348,DREW UNIVERSITY,1,0,1999,NA,NA,407,225,182,279,118,161,0.71,0.65,0.69,22462,52,141,249
184348,DREW UNIVERSITY,1,0,2000,NA,NA,419,265,154,291,98,193,0.72,0.64,0.69,23472,70,143,283
184348,DREW UNIVERSITY,1,0,2001,NA,NA,395,254,141,261,89,172,0.67,0.63,0.66,24576,74,146,251
184348,DREW UNIVERSITY,1,0,2002,NA,NA,396,231,165,281,110,171,0.74,0.67,0.71,25800,95,147,248
184348,DREW UNIVERSITY,1,0,2003,NA,NA,419,247,172,289,109,180,0.72,0.63,0.69,27360,63,146,276
184348,DREW UNIVERSITY,1,0,2004,NA,NA,418,243,175,264,98,166,0.68,0.56,0.63,29000,65,146,290
184348,Drew University,1,0,2005,NA,NA,391,218,173,240,103,137,0.62,0.6,0.61,30740,69,154,279
184348,Drew University,1,0,2006,NA,NA,479,316,163,315,103,212,0.67,0.63,0.66,32508,74,155,298
184348,Drew University,1,0,2007,NA,NA,452,268,184,293,107,186,0.6900000000000001,0.58,0.65,34230,77,160,266
184348,Drew University,1,0,2008,NA,NA,390,256,134,222,75,147,0.5700000000000001,0.56,0.57,35910,81,160,229
184348,Drew University,1,0,2009,NA,NA,505,296,209,317,114,203,0.68,0.55,0.63,37310,83,161,292
184348,Drew University,1,0,2010,NA,NA,494,311,183,280,96,184,0.59,0.52,0.57,38766,84,164,260
184603,FAIRLEIGH DICKINSON UNIVERSITY (ALL CAMPUSES),1,0,1991,NA,NA,908,436,472,78,32,46,0.1,0.07,0.09,10460,103,326,445
184603,FAIRLEIGH DICKINSON UNIVERSITY (ALL CAMPUSES),1,0,1992,NA,NA,938,466,472,114,53,61,0.13,0.11,0.12,10483,103,306,455
184603,FAIRLEIGH DICKINSON UNIVERSITY-ALL CAMPUSES,1,0,1993,NA,NA,860,422,438,128,46,82,0.19,0.11,0.15,11091,112,303,434
184603,FAIRLEIGH DICKINSON UNIVERSITY-ALL CAMPUSES,1,0,1995,NA,NA,781,396,385,128,57,71,0.17,0.15,0.16,12370,89,285,452
184603,FAIRLEIGH DICKINSON UNIVERSITY-ALL CAMPUSES,1,0,1996,NA,NA,915,494,421,187,76,111,0.22,0.18,0.2,13404,104,265,477
184603,FAIRLEIGH DICKINSON UNIVERSITY-ALL CAMPUSES,1,0,1997,NA,NA,519,265,254,83,27,56,0.21,0.11,0.16,14126,87,264,179
184603,FAIRLEIGH DICKINSON UNIVERSITY-ALL CAMPUSES,1,0,1998,NA,NA,566,307,259,90,30,60,0.19,0.12,0.16,14836,89,260,165
184603,FAIRLEIGH DICKINSON UNIVERSITY-ALL CAMPUSES,1,0,1999,NA,NA,526,281,245,96,31,65,0.23,0.13,0.18,14732,93,262,161
184603,FAIRLEIGH DICKINSON UNIVERSITY-ALL CAMPUSES,1,0,2000,NA,NA,535,300,235,79,32,47,0.15,0.14,0.15,16346,100,268,154
184603,FAIRLEIGH DICKINSON UNIVERSITY-ALL CAMPUSES,1,0,2001,NA,NA,448,260,188,80,27,53,0.2,0.14,0.18,17474,107,275,116
184603,FAIRLEIGH DICKINSON UNIVERSITY-ALL CAMPUSES,1,0,2002,NA,NA,474,281,193,87,34,53,0.18,0.18,0.18,18654,114,277,159
184603,FAIRLEIGH DICKINSON UNIVERSITY-METROPOLITAN CAMPUS,1,0,2003,NA,NA,540,303,237,105,40,65,0.21,0.17,0.19,19854,121,160,189
184603,FAIRLEIGH DICKINSON UNIVERSITY-METROPOLITAN CAMPUS,1,0,2004,NA,NA,504,282,222,150,61,89,0.31,0.27,0.3,21224,131,176,142
184603,Fairleigh Dickinson University-Metropolitan Campus,1,0,2005,NA,NA,425,269,156,100,31,69,0.25,0.2,0.24,22604,140,169,149
184603,Fairleigh Dickinson University-Metropolitan Campus,1,0,2006,NA,NA,452,254,198,119,37,82,0.32,0.19,0.26,24072,151,182,156
184603,Fairleigh Dickinson University-Metropolitan Campus,1,0,2007,NA,NA,400,210,190,117,30,87,0.41000000000000003,0.16,0.29,25624,165,183,131
184603,Fairleigh Dickinson University-Metropolitan Campus,1,0,2008,NA,NA,461,276,185,126,39,87,0.31,0.21,0.27,27136,168,185,122
184603,Fairleigh Dickinson University-Metropolitan Campus,1,0,2009,NA,NA,641,361,280,175,57,118,0.32,0.2,0.27,28194,174,184,129
184603,Fairleigh Dickinson University-Metropolitan Campus,1,0,2010,NA,NA,694,400,294,133,48,85,0.21,0.16,0.19,30140,181,186,131
184612,FELICIAN COLLEGE,1,0,1991,NA,NA,93,79,14,9,3,6,0.07,0.21,0.1,6970,5,38,49
184612,FELICIAN COLLEGE,1,0,1992,NA,NA,116,103,13,16,1,15,0.14,0.08,0.14,7430,6,39,78
184612,FELICIAN COLLEGE,1,0,1993,NA,NA,129,105,24,10,0,10,0.09,0,0.08,7765,7,44,82
184612,FELICIAN COLLEGE,1,0,1995,NA,NA,87,70,17,18,9,9,0.12,0.53,0.21,8790,8,47,53
184612,FELICIAN COLLEGE,1,0,1996,NA,NA,141,92,49,8,3,5,0.05,0.06,0.06,9502,10,48,87
184612,FELICIAN COLLEGE,1,0,1997,NA,NA,112,94,18,9,0,9,0.09,0,0.08,10038,9,51,65
184612,FELICIAN COLLEGE,1,0,1998,NA,NA,151,118,33,20,3,17,0.14,0.09,0.13,10542,11,56,70
184612,FELICIAN COLLEGE,1,0,1999,NA,NA,224,140,84,7,7,0,0,0.08,0.03,10560,14,59,133
184612,FELICIAN COLLEGE,1,0,2000,NA,NA,219,173,46,46,7,39,0.22,0.15,0.21,11010,18,63,129
184612,FELICIAN COLLEGE,1,0,2001,NA,NA,272,188,84,46,9,37,0.19,0.11,0.17,11460,21,68,134
184612,FELICIAN COLLEGE,1,0,2002,NA,NA,208,151,57,45,8,37,0.24,0.14,0.22,12450,19,70,94
184612,FELICIAN COLLEGE,1,0,2003,NA,NA,218,158,60,33,10,23,0.14,0.17,0.15,14500,19,70,111
184612,FELICIAN COLLEGE,1,0,2004,NA,NA,232,170,62,38,13,25,0.14,0.21,0.16,15900,20,73,114
184612,Felician College,1,0,2005,NA,NA,236,163,73,38,13,25,0.15,0.18,0.16,17300,22,83,101
184612,Felician College,1,0,2006,NA,NA,251,172,79,58,20,38,0.22,0.25,0.23,18900,25,81,93
184612,Felician College,1,0,2007,NA,NA,294,213,81,72,18,54,0.25,0.22,0.24,20500,27,95,106
184612,Felician College,1,0,2008,NA,NA,245,170,75,42,9,33,0.19,0.12,0.17,22200,32,102,90
184612,Felician College,1,0,2009,NA,NA,251,172,79,46,17,29,0.16,0.22,0.18,23650,36,112,71
184612,Felician College,1,0,2010,NA,NA,324,236,88,66,21,45,0.19,0.24,0.2,24950,37,114,90
184782,GLASSBORO STATE COLLEGE,1,0,1991,NA,NA,892,511,381,212,77,135,0.26,0.2,0.24,2715,75,278,646
184782,ROWAN COLLEGE OF NEW JERSEY,1,0,1992,NA,NA,771,453,318,154,46,108,0.23,0.14,0.2,2870,80,286,568
184782,ROWAN COLLEGE OF NEW JERSEY,1,0,1993,NA,NA,713,408,305,152,43,109,0.26,0.14,0.21,2843,83,292,489
184782,ROWAN COLLEGE OF NEW JERSEY,1,0,1995,NA,NA,927,516,411,226,69,157,0.3,0.17,0.24,3393,90,324,702
184782,ROWAN COLLEGE OF NEW JERSEY,1,0,1996,NA,NA,1132,609,523,414,173,241,0.39,0.33,0.37,3750,93,320,931
184782,ROWAN UNIVERSITY,1,0,1997,NA,NA,1038,552,486,321,119,202,0.36,0.24,0.31,4240,98,336,814
184782,ROWAN UNIVERSITY,1,0,1998,NA,NA,1118,624,494,414,160,254,0.4,0.32,0.37,4550,111,364,868
184782,ROWAN UNIVERSITY,1,0,1999,NA,NA,1119,587,532,436,183,253,0.43,0.34,0.39,3750,121,360,910
184782,ROWAN UNIVERSITY,1,0,2000,NA,NA,1053,561,492,444,173,271,0.48,0.35,0.42,4140,133,372,819
184782,ROWAN UNIVERSITY,1,0,2001,NA,NA,1276,680,596,498,201,297,0.43,0.34,0.39,4500,141,385,1021
184782,ROWAN UNIVERSITY,1,0,2002,NA,NA,1257,637,620,542,224,318,0.49,0.36,0.43,4950,135,369,1019
184782,ROWAN UNIVERSITY,1,0,2003,NA,NA,1243,600,643,588,265,323,0.53,0.41,0.47,5396,132,403,1032
184782,ROWAN UNIVERSITY,1,0,2004,NA,NA,1247,622,625,546,255,291,0.46,0.41,0.44,5828,146,434,970
184782,Rowan University,1,0,2005,NA,NA,1239,607,632,554,270,284,0.46,0.43,0.45,6294,161,441,987
184782,Rowan University,1,0,2006,NA,NA,1216,602,614,593,271,322,0.53,0.44,0.49,6798,175,436,925
184782,Rowan University,1,0,2007,NA,NA,1226,506,720,561,301,260,0.51,0.42,0.46,7308,188,407,1053
184782,Rowan University,1,0,2008,NA,NA,1174,516,658,502,269,233,0.45,0.41,0.43,7840,201,407,965
184782,Rowan University,1,0,2009,NA,NA,1586,738,848,677,344,333,0.45,0.41,0.43,8074,218,401,1209
184782,Rowan University,1,0,2010,NA,NA,1485,715,770,713,320,393,0.54,0.42,0.48,8396,216,395,1110
185129,JERSEY CITY STATE COLLEGE,1,0,1991,NA,NA,618,322,296,34,17,17,0.05,0.06,0.06,2422,55,245,264
185129,JERSEY CITY STATE COLLEGE,1,0,1992,NA,NA,663,324,339,28,16,12,0.03,0.05,0.04,2678,61,241,294
185129,JERSEY CITY STATE COLLEGE,1,0,1993,NA,NA,514,276,238,27,11,16,0.05,0.05,0.05,2798,61,237,254
185129,JERSEY CITY STATE COLLEGE,1,0,1995,NA,NA,457,246,211,40,11,29,0.11,0.05,0.09,3157,70,243,193
185129,JERSEY CITY STATE COLLEGE,1,0,1996,NA,NA,531,283,248,32,10,22,0.07,0.04,0.06,3528,69,248,196
185129,JERSEY CITY STATE COLLEGE,1,0,1997,NA,NA,455,237,218,34,13,21,0.08,0.06,0.07,3828,75,235,184
185129,NEW JERSEY CITY COLLEGE,1,0,1998,NA,NA,549,305,244,40,13,27,0.08,0.05,0.07,4113,79,237,203
185129,NEW JERSEY CITY UNIVERSITY,1,0,1999,NA,NA,603,331,272,54,18,36,0.1,0.07,0.09,3330,85,240,239
185129,NEW JERSEY CITY UNIVERSITY,1,0,2000,NA,NA,661,357,304,46,20,26,0.07,0.07,0.07,3540,91,242,271
185129,NEW JERSEY CITY UNIVERSITY,1,0,2001,NA,NA,540,304,236,43,14,29,0.09,0.06,0.08,3810,97,245,176
185129,NEW JERSEY CITY UNIVERSITY,1,0,2002,NA,NA,566,293,273,34,9,25,0.08,0.03,0.06,4185,94,238,199
185129,NEW JERSEY CITY UNIVERSITY,1,0,2003,NA,NA,652,380,272,49,15,34,0.08,0.06,0.08,4560,93,233,215
185129,NEW JERSEY CITY UNIVERSITY,1,0,2004,NA,NA,512,300,212,40,12,28,0.09,0.06,0.08,4860,100,241,145
185129,New Jersey City University,1,0,2005,NA,NA,601,334,267,39,17,22,0.06,0.06,0.06,5190,107,251,179
185129,New Jersey City University,1,0,2006,NA,NA,646,379,267,45,13,32,0.08,0.05,0.07,5600,116,242,156
185129,New Jersey City University,1,0,2007,NA,NA,649,340,309,32,16,16,0.04,0.05,0.05,5936,119,248,143
185129,New Jersey City University,1,0,2008,NA,NA,563,306,257,42,19,23,0.07,0.07,0.07,6352,127,238,113
185129,New Jersey City University,1,0,2009,NA,NA,634,358,276,32,12,20,0.05,0.04,0.05,6542,132,246,152
185129,New Jersey City University,1,0,2010,NA,NA,681,380,301,45,21,24,0.06,0.07,0.07,6804,137,242,145
185572,MONMOUTH COLLEGE,1,0,1991,NA,NA,387,216,171,74,23,51,0.23,0.13,0.19,10700,43,152,336
185572,MONMOUTH COLLEGE,1,0,1992,NA,NA,436,230,206,94,39,55,0.23,0.19,0.22,11160,45,142,360
185572,MONMOUTH COLLEGE,1,0,1993,NA,NA,477,220,257,94,43,51,0.23,0.17,0.2,11820,46,125,382
185572,MONMOUTH UNIVERSITY,1,0,1995,NA,NA,764,412,352,234,82,152,0.36,0.23,0.31,13140,62,157,634
185572,MONMOUTH UNIVERSITY,1,0,1996,NA,NA,799,411,388,261,99,162,0.39,0.26,0.33,13800,72,173,653
185572,MONMOUTH UNIVERSITY,1,0,1997,NA,NA,801,432,369,264,87,177,0.4,0.24,0.33,14442,59,187,640
185572,MONMOUTH UNIVERSITY,1,0,1998,NA,NA,834,429,405,253,98,155,0.36,0.24,0.3,15068,65,190,661
185572,MONMOUTH UNIVERSITY,1,0,1999,NA,NA,833,457,376,295,99,196,0.42,0.26,0.35,15138,69,197,644
185572,MONMOUTH UNIVERSITY,1,0,2000,NA,NA,1033,529,504,377,142,235,0.44,0.28,0.36,15758,74,204,863
185572,MONMOUTH UNIVERSITY,1,0,2001,NA,NA,881,484,397,339,125,214,0.44,0.31,0.38,16506,80,211,708
185572,MONMOUTH UNIVERSITY,1,0,2002,NA,NA,948,521,427,351,116,235,0.45,0.27,0.37,17332,81,229,788
185572,MONMOUTH UNIVERSITY,1,0,2003,NA,NA,904,484,420,358,125,233,0.48,0.3,0.4,18198,90,241,757
185572,MONMOUTH UNIVERSITY,1,0,2004,NA,NA,946,514,432,341,120,221,0.43,0.28,0.36,19108,97,237,727
185572,Monmouth University,1,0,2005,NA,NA,942,503,439,436,176,260,0.51,0.4,0.46,20064,101,254,738
185572,Monmouth University,1,0,2006,NA,NA,959,535,424,425,168,257,0.48,0.4,0.44,21248,109,244,747
185572,Monmouth University,1,0,2007,NA,NA,944,538,406,393,165,228,0.42,0.41,0.42,22406,116,251,753
185572,Monmouth University,1,0,2008,NA,NA,960,549,411,473,187,286,0.52,0.45,0.49,23470,125,247,795
185572,Monmouth University,1,0,2009,NA,NA,998,581,417,504,191,313,0.53,0.46,0.51,24386,130,248,818
185572,Monmouth University,1,0,2010,NA,NA,962,579,383,532,196,336,0.58,0.51,0.55,25728,136,253,764
185590,MONTCLAIR STATE COLLEGE,1,0,1991,NA,NA,913,564,349,101,31,70,0.12,0.09,0.11,2612,89,429,544
185590,MONTCLAIR STATE COLLEGE,1,0,1992,NA,NA,913,530,383,106,32,74,0.13,0.08,0.12,2686,98,420,560
185590,MONTCLAIR STATE COLLEGE,1,0,1993,NA,NA,868,531,337,117,34,83,0.15,0.1,0.13,2844,99,419,523
185590,MONTCLAIR STATE UNIVERSITY,1,0,1995,NA,NA,1068,651,417,216,69,147,0.22,0.17,0.2,3162,110,421,662
185590,MONTCLAIR STATE UNIVERSITY,1,0,1996,NA,NA,1194,706,488,243,64,179,0.25,0.13,0.2,3466,116,444,746
185590,MONTCLAIR STATE UNIVERSITY,1,0,1997,NA,NA,1148,709,439,230,62,168,0.23,0.14,0.2,3738,122,472,648
185590,MONTCLAIR STATE UNIVERSITY,1,0,1998,NA,NA,1106,660,446,252,60,192,0.29,0.13,0.23,4120,129,442,637
185590,MONTCLAIR STATE UNIVERSITY,1,0,1999,NA,NA,1319,823,496,308,81,227,0.27,0.16,0.23,3154,136,444,747
185590,MONTCLAIR STATE UNIVERSITY,1,0,2000,NA,NA,1324,827,497,351,96,255,0.3,0.19,0.27,3470,147,442,776
185590,MONTCLAIR STATE UNIVERSITY,1,0,2001,NA,NA,1378,826,552,371,102,269,0.32,0.18,0.27,4071,159,441,785
185590,MONTCLAIR STATE UNIVERSITY,1,0,2002,NA,NA,1470,881,589,410,117,293,0.33,0.2,0.28,4390,152,434,925
185590,MONTCLAIR STATE UNIVERSITY,1,0,2003,NA,NA,1594,934,660,471,134,337,0.36,0.2,0.3,4785,158,453,972
185590,MONTCLAIR STATE UNIVERSITY,1,0,2004,NA,NA,1737,1015,722,534,164,370,0.36,0.23,0.31,5168,168,462,1056
185590,Montclair State University,1,0,2005,NA,NA,1868,1065,803,635,188,447,0.41000000000000003,0.23,0.34,5581,197,474,1146
185590,Montclair State University,1,0,2006,NA,NA,2018,1197,821,702,214,488,0.4,0.26,0.35,6028,232,491,1261
185590,Montclair State University,1,0,2007,NA,NA,2068,1276,792,711,205,506,0.39,0.26,0.34,6390,240,509,1174
185590,Montclair State University,1,0,2008,NA,NA,2257,1365,892,817,230,587,0.43,0.26,0.36,6836,263,524,1190
185590,Montclair State University,1,0,2009,NA,NA,2100,1284,816,757,219,538,0.41000000000000003,0.27,0.36,7042,272,553,1069
185590,Montclair State University,1,0,2010,NA,NA,2169,1248,921,850,304,546,0.43,0.33,0.39,7324,288,569,1079
185828,NEW JERSEY INSTITUTE OF TECHNOLOGY,1,0,1991,NA,NA,541,96,445,30,18,12,0.12,0.04,0.06,4288,105,319,236
185828,NEW JERSEY INSTITUTE OF TECHNOLOGY,1,0,1992,NA,NA,501,75,426,34,25,9,0.12,0.06,0.07,4524,108,327,247
185828,NEW JERSEY INSTITUTE OF TECHNOLOGY,1,0,1993,NA,NA,476,90,386,33,22,11,0.12,0.06,0.07,4790,116,308,226
185828,NEW JERSEY INSTITUTE OF TECHNOLOGY,1,0,1995,NA,NA,552,131,421,60,35,25,0.19,0.08,0.11,5220,130,348,263
185828,NEW JERSEY INSTITUTE OF TECHNOLOGY,1,0,1996,NA,NA,599,116,483,60,39,21,0.18,0.08,0.1,5466,144,354,295
185828,NEW JERSEY INSTITUTE OF TECHNOLOGY,1,0,1997,NA,NA,568,105,463,88,73,15,0.14,0.16,0.15,5802,146,358,276
185828,NEW JERSEY INSTITUTE OF TECHNOLOGY,1,0,1998,NA,NA,563,120,443,93,64,29,0.24,0.14,0.17,6214,156,362,254
185828,NEW JERSEY INSTITUTE OF TECHNOLOGY,1,0,1999,NA,NA,649,114,535,116,88,28,0.24,0.16,0.18,5508,163,380,261
185828,NEW JERSEY INSTITUTE OF TECHNOLOGY,1,0,2000,NA,NA,685,117,568,130,98,32,0.27,0.17,0.19,5758,174,426,285
185828,NEW JERSEY INSTITUTE OF TECHNOLOGY,1,0,2001,NA,NA,706,129,577,102,70,32,0.24,0.12,0.14,6158,190,473,297
185828,NEW JERSEY INSTITUTE OF TECHNOLOGY,1,0,2002,NA,NA,658,113,545,106,81,25,0.22,0.15,0.16,6758,193,408,249
185828,NEW JERSEY INSTITUTE OF TECHNOLOGY,1,0,2003,NA,NA,685,119,566,118,92,26,0.21,0.16,0.17,7332,195,458,283
185828,NEW JERSEY INSTITUTE OF TECHNOLOGY,1,0,2004,NA,NA,663,130,533,108,74,34,0.26,0.14,0.16,7918,197,413,263
185828,New Jersey Institute of Technology,1,0,2005,NA,NA,746,129,617,126,101,25,0.19,0.16,0.17,8472,209,403,295
185828,New Jersey Institute of Technology,1,0,2006,NA,NA,795,146,649,150,102,48,0.32,0.16,0.19,9066,212,389,324
185828,New Jersey Institute of Technology,1,0,2007,NA,NA,730,148,582,171,117,54,0.36,0.2,0.23,9700,224,382,300
185828,New Jersey Institute of Technology,1,0,2008,NA,NA,779,158,621,185,136,49,0.31,0.22,0.24,10500,234,387,326
185828,New Jersey Institute of Technology,1,0,2009,NA,NA,899,169,730,212,151,61,0.36,0.21,0.24,10816,240,406,370
185828,New Jersey Institute of Technology,1,0,2010,NA,NA,828,187,641,209,141,68,0.36,0.22,0.25,11248,238,398,200
186131,PRINCETON UNIVERSITY,1,0,1991,NA,NA,1122,474,648,1002,582,420,0.88,0.9,0.89,16570,451,704,794
186131,PRINCETON UNIVERSITY,1,0,1992,NA,NA,1135,516,619,1023,544,479,0.92,0.88,0.9,17750,496,709,842
186131,PRINCETON UNIVERSITY,1,0,1993,NA,NA,1152,514,638,1032,563,469,0.91,0.88,0.9,18940,514,702,816
186131,PRINCETON UNIVERSITY,1,0,1995,NA,NA,1207,569,638,1105,579,526,0.92,0.91,0.92,20960,509,712,800
186131,PRINCETON UNIVERSITY,1,0,1996,NA,NA,1123,525,598,1032,540,492,0.93,0.9,0.92,22000,534,691,747
186131,PRINCETON UNIVERSITY,1,0,1997,NA,NA,1129,511,618,1033,562,471,0.92,0.91,0.91,22920,501,689,798
186131,PRINCETON UNIVERSITY,1,0,1998,NA,NA,1167,560,607,1000,495,505,0.9,0.82,0.86,23820,501,699,788
186131,PRINCETON UNIVERSITY,1,0,1999,NA,NA,1148,556,592,1030,530,500,0.89,0.9,0.9,24630,536,717,790
186131,PRINCETON UNIVERSITY,1,0,2000,NA,NA,1159,569,590,1031,503,528,0.92,0.85,0.89,25430,581,742,757
186131,PRINCETON UNIVERSITY,1,0,2001,NA,NA,1184,570,614,1051,526,525,0.92,0.86,0.89,26160,639,768,757
186131,PRINCETON UNIVERSITY,1,0,2002,NA,NA,1164,557,607,1049,542,507,0.91,0.89,0.9,27230,692,798,737
186131,PRINCETON UNIVERSITY,1,0,2003,NA,NA,1161,539,622,1044,549,495,0.91,0.88,0.9,28540,725,797,734
186131,PRINCETON UNIVERSITY,1,0,2004,NA,NA,1170,548,622,1054,549,505,0.92,0.88,0.9,29910,789,801,729
186131,Princeton University,1,0,2005,NA,NA,1224,558,666,1066,562,504,0.9,0.84,0.87,31450,835,807,709
186131,Princeton University,1,0,2006,NA,NA,1228,576,652,1078,561,517,0.89,0.86,0.88,33000,927,826,603
186131,Princeton University,1,0,2007,NA,NA,1243,593,650,1091,553,538,0.9,0.85,0.88,33000,981,824,592
186131,Princeton University,1,0,2008,NA,NA,1243,620,623,1121,545,576,0.92,0.87,0.9,34290,1050,848,610
186131,Princeton University,1,0,2009,NA,NA,1297,643,654,1164,568,596,0.92,0.87,0.9,35340,1161,847,635
186131,Princeton University,1,0,2010,NA,NA,1311,649,662,1169,572,597,0.91,0.86,0.89,36640,1235,844,653
186201,RAMAPO COLLEGE OF NEW JERSEY,1,0,1991,NA,NA,423,205,218,55,17,38,0.18,0.08,0.13,2893,37,130,279
186201,RAMAPO COLLEGE OF NEW JERSEY,1,0,1992,NA,NA,419,216,203,77,25,52,0.24,0.12,0.18,3024,41,131,290
186201,RAMAPO COLLEGE OF NEW JERSEY,1,0,1993,NA,NA,361,199,162,62,21,41,0.2,0.13,0.17,3226,45,131,235
186201,RAMAPO COLLEGE OF NEW JERSEY,1,0,1995,NA,NA,319,190,129,67,20,47,0.24,0.16,0.21,3521,44,132,190
186201,RAMAPO COLLEGE OF NEW JERSEY,1,0,1996,NA,NA,413,240,173,101,29,72,0.3,0.17,0.24,3872,49,138,273
186201,RAMAPO COLLEGE OF NEW JERSEY,1,0,1997,NA,NA,453,228,225,125,53,72,0.31,0.24,0.28,4206,50,141,331
186201,RAMAPO COLLEGE OF NEW JERSEY,1,0,1998,NA,NA,472,271,201,169,56,113,0.41000000000000003,0.28,0.36,4616,53,142,343
186201,RAMAPO COLLEGE OF NEW JERSEY,1,0,1999,NA,NA,527,293,234,201,66,135,0.46,0.28,0.38,3822,61,142,380
186201,RAMAPO COLLEGE OF NEW JERSEY,1,0,2000,NA,NA,636,392,244,282,87,195,0.49,0.36,0.44,4166,67,149,496
186201,RAMAPO COLLEGE OF NEW JERSEY,1,0,2001,NA,NA,628,382,246,303,99,204,0.53,0.4,0.48,4416,71,157,474
186201,RAMAPO COLLEGE OF NEW JERSEY,1,0,2002,NA,NA,684,420,264,363,109,254,0.6,0.41,0.53,4836,74,170,522
186201,RAMAPO COLLEGE OF NEW JERSEY,1,0,2003,NA,NA,719,423,296,439,165,274,0.64,0.56,0.61,5270,82,171,570
186201,RAMAPO COLLEGE OF NEW JERSEY,1,0,2004,NA,NA,746,451,295,486,165,321,0.71,0.56,0.65,5640,89,179,580
186201,Ramapo College of New Jersey,1,0,2005,NA,NA,746,460,286,445,137,308,0.66,0.48,0.6,6091,95,187,564
186201,Ramapo College of New Jersey,1,0,2006,NA,NA,811,475,336,488,182,306,0.64,0.54,0.6,6579,103,192,591
186201,Ramapo College of New Jersey,1,0,2007,NA,NA,898,519,379,527,181,346,0.66,0.48,0.59,6904,109,197,694
186201,Ramapo College of New Jersey,1,0,2008,NA,NA,877,513,364,511,177,334,0.65,0.49,0.58,7459,120,199,662
186201,Ramapo College of New Jersey,1,0,2009,NA,NA,933,575,358,559,165,394,0.68,0.46,0.6,7683,128,213,702
186201,Ramapo College of New Jersey,1,0,2010,NA,NA,893,522,371,547,188,359,0.68,0.51,0.61,7805,127,216,674
186283,RIDER COLLEGE,1,0,1991,NA,NA,653,351,302,259,98,161,0.45,0.32,0.4,11010,58,207,516
186283,RIDER COLLEGE,1,0,1992,NA,NA,731,402,329,305,113,192,0.47000000000000003,0.34,0.42,12010,60,207,577
186283,RIDER COLLEGE,1,0,1993,NA,NA,663,376,287,267,104,163,0.43,0.36,0.4,12860,70,208,515
186283,RIDER UNIVERSITY,1,0,1995,NA,NA,612,329,283,242,103,139,0.42,0.36,0.4,13800,76,222,465
186283,RIDER UNIVERSITY,1,0,1996,NA,NA,678,394,284,311,113,198,0.5,0.4,0.46,14400,78,220,504
186283,RIDER UNIVERSITY,1,0,1997,NA,NA,751,435,316,340,135,205,0.47000000000000003,0.43,0.45,15120,64,220,577
186283,RIDER UNIVERSITY,1,0,1998,NA,NA,869,483,386,419,161,258,0.53,0.42,0.48,15880,67,227,666
186283,RIDER UNIVERSITY,1,0,1999,NA,NA,735,386,349,310,128,182,0.47000000000000003,0.37,0.42,16520,71,220,560
186283,RIDER UNIVERSITY,1,0,2000,NA,NA,884,504,380,399,152,247,0.49,0.4,0.45,17180,75,220,680
186283,RIDER UNIVERSITY,1,0,2001,NA,NA,839,472,367,361,143,218,0.46,0.39,0.43,17990,79,220,600
186283,RIDER UNIVERSITY,1,0,2002,NA,NA,958,542,416,439,173,266,0.49,0.42,0.46,19240,82,229,754
186283,RIDER UNIVERSITY,1,0,2003,NA,NA,944,575,369,443,154,289,0.5,0.42,0.47,20590,90,232,735
186283,RIDER UNIVERSITY,1,0,2004,NA,NA,890,514,376,456,190,266,0.51,0.51,0.51,21820,94,235,663
186283,Rider University,1,0,2005,NA,NA,934,526,408,482,183,299,0.56,0.45,0.52,22910,98,231,727
186283,Rider University,1,0,2006,NA,NA,1016,619,397,576,206,370,0.59,0.52,0.57,24220,107,235,799
186283,Rider University,1,0,2007,NA,NA,990,569,421,547,201,346,0.6,0.48,0.55,25650,116,241,750
186283,Rider University,1,0,2008,NA,NA,875,516,359,460,167,293,0.56,0.47,0.53,27140,128,243,608
186283,Rider University,1,0,2009,NA,NA,1027,611,416,557,216,341,0.55,0.52,0.54,28470,135,242,678
186283,Rider University,1,0,2010,NA,NA,1007,601,406,585,227,358,0.59,0.56,0.58,29870,145,249,744
186584,SETON HALL UNIVERSITY,1,0,1991,NA,NA,984,474,510,429,184,245,0.51,0.36,0.44,10450,112,336,668
186584,SETON HALL UNIVERSITY,1,0,1992,NA,NA,985,484,501,384,161,223,0.46,0.32,0.39,10960,123,348,649
186584,SETON HALL UNIVERSITY,1,0,1993,NA,NA,996,522,474,376,142,234,0.44,0.3,0.38,11380,132,348,650
186584,SETON HALL UNIVERSITY,1,0,1995,NA,NA,955,527,428,371,145,226,0.42,0.34,0.39,12250,138,341,561
186584,SETON HALL UNIVERSITY,1,0,1996,NA,NA,968,547,421,349,112,237,0.43,0.27,0.36,12850,142,340,548
186584,SETON HALL UNIVERSITY,1,0,1997,NA,NA,1056,547,509,409,157,252,0.46,0.31,0.39,13600,130,338,627
186584,SETON HALL UNIVERSITY,1,0,1998,NA,NA,1221,657,564,486,173,313,0.47000000000000003,0.31,0.4,15680,133,354,694
186584,SETON HALL UNIVERSITY,1,0,1999,NA,NA,1063,533,530,437,190,247,0.46,0.36,0.41,15480,148,376,588
186584,SETON HALL UNIVERSITY,1,0,2000,NA,NA,1121,581,540,464,186,278,0.47000000000000003,0.34,0.41,16410,162,377,537
186584,SETON HALL UNIVERSITY,1,0,2001,NA,NA,1182,601,581,495,210,285,0.47000000000000003,0.36,0.42,17400,166,379,636
186584,SETON HALL UNIVERSITY,1,0,2002,NA,NA,1157,607,550,523,232,291,0.47000000000000003,0.42,0.45,18780,179,393,620
186584,SETON HALL UNIVERSITY,1,0,2003,NA,NA,1241,616,625,620,301,319,0.51,0.48,0.5,19530,184,404,716
186584,SETON HALL UNIVERSITY,1,0,2004,NA,NA,1234,672,562,626,269,357,0.53,0.48,0.51,20490,195,426,667
186584,Seton Hall University,1,0,2005,NA,NA,1115,582,533,576,236,340,0.58,0.44,0.52,21510,202,441,626
186584,Seton Hall University,1,0,2006,NA,NA,1054,602,452,574,231,343,0.56,0.51,0.54,22770,211,449,547
186584,Seton Hall University,1,0,2007,NA,NA,1256,664,592,631,277,354,0.53,0.47,0.5,25900,215,432,727
186584,Seton Hall University,1,0,2008,NA,NA,1216,688,528,687,282,405,0.58,0.53,0.56,27680,239,452,705
186584,Seton Hall University,1,0,2009,NA,NA,1124,659,465,570,232,338,0.51,0.5,0.51,28520,244,460,580
186584,Seton Hall University,1,0,2010,NA,NA,1302,728,574,708,288,420,0.5700000000000001,0.5,0.54,29940,247,446,704
186876,STOCKTON STATE COLLEGE,1,0,1991,NA,NA,683,364,319,194,64,130,0.35000000000000003,0.2,0.28,2456,44,175,526
186876,STOCKTON STATE COLLEGE,1,0,1992,NA,NA,720,401,319,174,70,104,0.25,0.22,0.24,2657,46,174,598
186876,THE RICHARD STOCKTON COLLEGE OF NEW JERSEY,1,0,1993,NA,NA,709,369,340,193,77,116,0.31,0.23,0.27,2880,48,178,576
186876,THE RICHARD STOCKTON COLLEGE OF NEW JERSEY,1,0,1995,NA,NA,726,438,288,258,86,172,0.39,0.3,0.36,3152,53,176,605
186876,THE RICHARD STOCKTON COLLEGE OF NEW JERSEY,1,0,1996,NA,NA,705,404,301,278,110,168,0.41000000000000003,0.37,0.39,3472,60,186,555
186876,THE RICHARD STOCKTON COLLEGE OF NEW JERSEY,1,0,1997,NA,NA,700,415,285,283,93,190,0.45,0.33,0.4,3776,63,193,555
186876,THE RICHARD STOCKTON COLLEGE OF NEW JERSEY,1,0,1998,NA,NA,744,420,324,321,116,205,0.48,0.36,0.43,4144,67,189,593
186876,THE RICHARD STOCKTON COLLEGE OF NEW JERSEY,1,0,1999,NA,NA,705,409,296,254,86,168,0.41000000000000003,0.29,0.36,3280,70,199,547
186876,THE RICHARD STOCKTON COLLEGE OF NEW JERSEY,1,0,2000,NA,NA,728,431,297,296,96,200,0.46,0.32,0.41,3600,79,202,589
186876,THE RICHARD STOCKTON COLLEGE OF NEW JERSEY,1,0,2001,NA,NA,751,424,327,335,122,213,0.5,0.37,0.45,3952,85,205,612
186876,THE RICHARD STOCKTON COLLEGE OF NEW JERSEY,1,0,2002,NA,NA,794,436,358,338,131,207,0.47000000000000003,0.37,0.43,4352,84,216,674
186876,THE RICHARD STOCKTON COLLEGE OF NEW JERSEY,1,0,2003,NA,NA,816,439,377,319,119,200,0.45,0.32,0.39,4736,97,219,698
186876,THE RICHARD STOCKTON COLLEGE OF NEW JERSEY,1,0,2004,NA,NA,819,435,384,331,127,204,0.46,0.33,0.4,5091,93,227,686
186876,The Richard Stockton College of New Jersey,1,0,2005,NA,NA,808,460,348,346,104,242,0.52,0.3,0.43,5498,98,242,653
186876,The Richard Stockton College of New Jersey,1,0,2006,NA,NA,791,425,366,319,123,196,0.46,0.34,0.4,5938,116,252,631
186876,The Richard Stockton College of New Jersey,1,0,2007,NA,NA,794,480,314,335,93,242,0.5,0.3,0.42,6353,127,259,613
186876,The Richard Stockton College of New Jersey,1,0,2008,NA,NA,840,458,382,425,156,269,0.58,0.41,0.51,6861,139,264,641
186876,The Richard Stockton College of New Jersey,1,0,2009,NA,NA,865,483,382,459,175,284,0.58,0.46,0.53,7067,149,263,646
186876,The Richard Stockton College of New Jersey,1,0,2010,NA,NA,858,518,340,433,137,296,0.5700000000000001,0.4,0.5,7349,150,271,651
187134,TRENTON STATE COLLEGE,1,0,1991,NA,NA,860,560,300,445,108,337,0.6,0.36,0.52,3079,77,318,684
187134,TRENTON STATE COLLEGE,1,0,1992,NA,NA,1068,712,356,628,174,454,0.63,0.49,0.59,3761,82,316,847
187134,TRENTON STATE COLLEGE,1,0,1993,NA,NA,1064,628,436,576,186,390,0.62,0.43,0.54,3857,87,313,792
187134,THE COLLEGE OF NEW JERSEY,1,0,1995,NA,NA,1087,670,417,638,212,426,0.63,0.51,0.59,4241,100,316,777
187134,THE COLLEGE OF NEW JERSEY,1,0,1996,NA,NA,1009,675,334,648,187,461,0.68,0.56,0.64,4522,105,311,714
187134,THE COLLEGE OF NEW JERSEY,1,0,1997,NA,NA,1396,847,549,870,305,565,0.66,0.56,0.62,4843,107,324,1037
187134,THE COLLEGE OF NEW JERSEY,1,0,1998,NA,NA,1206,714,492,760,278,482,0.67,0.57,0.63,5318,115,325,846
187134,THE COLLEGE OF NEW JERSEY,1,0,1999,NA,NA,1207,697,510,776,281,495,0.71,0.55,0.64,4445,122,328,901
187134,THE COLLEGE OF NEW JERSEY,1,0,2000,NA,NA,1205,714,491,799,287,512,0.71,0.58,0.66,4654,126,331,927
187134,THE COLLEGE OF NEW JERSEY,1,0,2001,NA,NA,1258,750,508,852,302,550,0.73,0.59,0.68,5022,138,334,988
187134,THE COLLEGE OF NEW JERSEY,1,0,2002,NA,NA,1231,738,493,834,288,546,0.73,0.58,0.68,5625,121,324,914
187134,THE COLLEGE OF NEW JERSEY,1,0,2003,NA,NA,1176,679,497,855,327,528,0.77,0.66,0.73,6131,129,325,898
187134,THE COLLEGE OF NEW JERSEY,1,0,2004,NA,NA,1230,681,549,876,357,519,0.76,0.65,0.71,6621,129,333,941
187134,The College of New Jersey,1,0,2005,NA,NA,1236,685,551,914,383,531,0.77,0.7,0.74,7051,138,341,917
187134,The College of New Jersey,1,0,2006,NA,NA,1270,756,514,919,339,580,0.76,0.66,0.72,7615,156,332,817
187134,The College of New Jersey,1,0,2007,NA,NA,1297,774,523,940,334,606,0.78,0.64,0.72,8072,156,335,852
187134,The College of New Jersey,1,0,2008,NA,NA,1295,763,532,939,356,583,0.76,0.67,0.73,8718,164,343,815
187134,The College of New Jersey,1,0,2009,NA,NA,1283,718,565,918,366,552,0.76,0.65,0.72,8980,174,348,828
187134,The College of New Jersey,1,0,2010,NA,NA,1421,800,621,1065,443,622,0.77,0.71,0.75,9340,184,348,944
187444,WILLIAM PATERSON COLLEGE OF NEW JERSEY,1,0,1991,NA,NA,967,551,416,100,19,81,0.14,0.05,0.1,2544,65,296,718
187444,WILLIAM PATERSON COLLEGE OF NEW JERSEY,1,0,1992,NA,NA,962,536,426,94,24,70,0.13,0.06,0.1,2832,72,307,688
187444,WILLIAM PATERSON COLLEGE OF NEW JERSEY,1,0,1993,NA,NA,1091,608,483,89,14,75,0.12,0.03,0.08,2928,78,311,755
187444,WILLIAM PATERSON COLLEGE OF NEW JERSEY,1,0,1995,NA,NA,831,476,355,87,23,64,0.13,0.06,0.1,3120,82,314,518
187444,WILLIAM PATERSON COLLEGE OF NEW JERSEY,1,0,1996,NA,NA,918,523,395,148,41,107,0.2,0.1,0.16,3380,85,306,568
187444,WILLIAM PATERSON UNIVERSITY OF NEW JERSEY,1,0,1997,NA,NA,1032,563,469,154,51,103,0.18,0.11,0.15,3786,90,323,610
187444,WILLIAM PATERSON UNIVERSITY OF NEW JERSEY,1,0,1998,NA,NA,1133,663,470,145,39,106,0.15,0.08,0.13,4150,95,340,696
187444,WILLIAM PATERSON UNIVERSITY OF NEW JERSEY,1,0,1999,NA,NA,1105,614,491,177,56,121,0.19,0.11,0.16,3319,107,352,678
187444,WILLIAM PATERSON UNIVERSITY OF NEW JERSEY,1,0,2000,NA,NA,1160,610,550,188,73,115,0.18,0.13,0.16,3554,121,357,675
187444,WILLIAM PATERSON UNIVERSITY OF NEW JERSEY,1,0,2001,NA,NA,1247,697,550,185,59,126,0.18,0.11,0.15,3838,125,362,799
187444,WILLIAM PATERSON UNIVERSITY OF NEW JERSEY,1,0,2002,NA,NA,1286,715,571,208,59,149,0.2,0.1,0.16,4218,118,359,747
187444,WILLIAM PATERSON UNIVERSITY OF NEW JERSEY,1,0,2003,NA,NA,1269,711,558,262,86,176,0.24,0.15,0.21,4594,128,354,741
187444,WILLIAM PATERSON UNIVERSITY OF NEW JERSEY,1,0,2004,NA,NA,1430,801,629,245,85,160,0.19,0.14,0.17,4961,136,371,813
187444,William Paterson University of New Jersey,1,0,2005,NA,NA,1296,652,644,235,89,146,0.22,0.14,0.18,5358,147,377,685
187444,William Paterson University of New Jersey,1,0,2006,NA,NA,1218,669,549,170,62,108,0.16,0.11,0.14,5782,153,366,613
187444,William Paterson University of New Jersey,1,0,2007,NA,NA,1299,642,657,211,89,122,0.19,0.14,0.16,6072,155,373,671
187444,William Paterson University of New Jersey,1,0,2008,NA,NA,1204,617,587,215,75,140,0.22,0.13,0.18,6375,172,379,589
187444,William Paterson University of New Jersey,1,0,2009,NA,NA,1435,703,732,284,129,155,0.22,0.18,0.2,6567,177,371,726
187444,William Paterson University of New Jersey,1,0,2010,NA,NA,1509,774,735,443,160,283,0.36,0.22,0.29,6830,182,380,751
187985,UNIVERSITY OF NEW MEXICO-MAIN CAMPUS,1,0,1991,NA,NA,1716,915,801,147,61,86,0.09,0.08,0.09,1554,486,818,957
187985,UNIVERSITY OF NEW MEXICO-MAIN CAMPUS,1,0,1992,NA,NA,1700,946,754,148,53,95,0.1,0.07,0.09,1656,582,817,917
187985,UNIVERSITY OF NEW MEXICO-MAIN CAMPUS,1,0,1993,NA,NA,1910,1067,843,171,52,119,0.11,0.06,0.09,1788,606,837,1024
187985,UNIVERSITY OF NEW MEXICO-MAIN CAMPUS,1,0,1995,NA,NA,1712,956,756,221,76,145,0.15,0.1,0.13,1996,740,861,897
187985,UNIVERSITY OF NEW MEXICO-MAIN CAMPUS,1,0,1996,NA,NA,1600,875,725,217,67,150,0.17,0.09,0.14,2071,741,839,813
187985,UNIVERSITY OF NEW MEXICO-MAIN CAMPUS,1,0,1997,NA,NA,2047,1132,915,244,71,173,0.15,0.08,0.12,2164,754,854,1119
187985,UNIVERSITY OF NEW MEXICO-MAIN CAMPUS,1,0,1998,NA,NA,2617,1475,1142,281,96,185,0.12,0.08,0.11,2242,793,862,1290
187985,UNIVERSITY OF NEW MEXICO-MAIN CAMPUS,1,0,1999,NA,NA,2715,1517,1198,276,85,191,0.12,0.07,0.1,1942,820,862,1397
187985,UNIVERSITY OF NEW MEXICO-MAIN CAMPUS,1,0,2000,NA,NA,2587,1474,1113,311,106,205,0.13,0.1,0.12,2259,892,869,1286
187985,UNIVERSITY OF NEW MEXICO-MAIN CAMPUS,1,0,2001,NA,NA,2364,1323,1041,280,103,177,0.13,0.1,0.12,2490,926,877,1127
187985,UNIVERSITY OF NEW MEXICO-MAIN CAMPUS,1,0,2002,NA,NA,2758,1565,1193,314,100,214,0.13,0.08,0.11,2621,1020,870,1344
187985,UNIVERSITY OF NEW MEXICO-MAIN CAMPUS,1,0,2003,NA,NA,2940,1660,1280,300,76,224,0.13,0.06,0.1,2740,1022,884,1349
187985,UNIVERSITY OF NEW MEXICO-MAIN CAMPUS,1,0,2004,NA,NA,3018,1720,1298,370,98,272,0.15,0.08,0.12,3112,1103,874,1352
187985,University of New Mexico-Main Campus,1,0,2005,NA,NA,3010,1717,1293,372,130,242,0.14,0.1,0.12,3360,1149,905,1367
187985,University of New Mexico-Main Campus,1,0,2006,NA,NA,2955,1619,1336,356,124,232,0.14,0.09,0.12,3475,1234,889,1332
187985,University of New Mexico-Main Campus,1,0,2007,NA,NA,2850,1637,1213,415,147,268,0.16,0.12,0.15,3640,1307,918,1260
187985,University of New Mexico-Main Campus,1,0,2008,NA,NA,3148,1737,1411,459,161,298,0.17,0.11,0.15,3817,1473,933,1309
187985,University of New Mexico-Main Campus,1,0,2009,NA,NA,3344,1762,1582,516,193,323,0.18,0.12,0.15,4007,1626,958,1255
187985,University of New Mexico-Main Campus,1,0,2010,NA,NA,3488,1951,1537,574,204,370,0.18,0.13,0.16,4348,1699,942,1274
188030,NEW MEXICO STATE UNIVERSITY MAIN CAMPUS,1,0,1991,NA,NA,1656,846,810,127,45,82,0.09,0.06,0.08,1594,220,575,945
188030,NEW MEXICO STATE UNIVERSITY MAIN CAMPUS,1,0,1992,NA,NA,1598,830,768,152,58,94,0.11,0.08,0.1,1708,233,586,871
188030,NEW MEXICO STATE UNIVERSITY-MAIN CAMPUS,1,0,1993,NA,NA,1602,780,822,153,64,89,0.11,0.08,0.1,1824,242,582,867
188030,NEW MEXICO STATE UNIVERSITY-MAIN CAMPUS,1,0,1995,NA,NA,1419,726,693,146,51,95,0.13,0.07,0.1,2088,256,597,743
188030,NEW MEXICO STATE UNIVERSITY-MAIN CAMPUS,1,0,1996,NA,NA,1510,807,703,188,51,137,0.16,0.07,0.12,2196,253,595,803
188030,NEW MEXICO STATE UNIVERSITY-MAIN CAMPUS,1,0,1997,NA,NA,1694,901,793,201,70,131,0.14,0.09,0.12,2196,268,583,843
188030,NEW MEXICO STATE UNIVERSITY-MAIN CAMPUS,1,0,1998,NA,NA,2077,1070,1007,254,77,177,0.16,0.08,0.12,2346,271,562,1074
188030,NEW MEXICO STATE UNIVERSITY-MAIN CAMPUS,1,0,1999,NA,NA,2210,1223,987,272,88,184,0.15,0.09,0.12,1740,288,568,1081
188030,NEW MEXICO STATE UNIVERSITY-MAIN CAMPUS,1,0,2000,NA,NA,1959,1082,877,238,83,155,0.14,0.09,0.12,1956,302,562,160
188030,NEW MEXICO STATE UNIVERSITY-MAIN CAMPUS,1,0,2001,NA,NA,2051,1075,976,250,76,174,0.16,0.08,0.12,2148,320,556,769
188030,NEW MEXICO STATE UNIVERSITY-MAIN CAMPUS,1,0,2002,NA,NA,1977,1111,866,257,78,179,0.16,0.09,0.13,2328,334,575,826
188030,NEW MEXICO STATE UNIVERSITY-MAIN CAMPUS,1,0,2003,NA,NA,2016,1087,929,257,90,167,0.15,0.1,0.13,2418,349,590,840
188030,NEW MEXICO STATE UNIVERSITY-MAIN CAMPUS,1,0,2004,NA,NA,2061,1125,936,260,92,168,0.14,0.1,0.13,2828,359,597,831
188030,New Mexico State University-Main Campus,1,0,2005,NA,NA,1945,1092,853,289,96,193,0.17,0.11,0.15,2868,395,657,785
188030,New Mexico State University-Main Campus,1,0,2006,NA,NA,2073,1105,968,286,80,206,0.18,0.08,0.14,3124,424,649,854
188030,New Mexico State University-Main Campus,1,0,2007,NA,NA,2105,1123,982,329,94,235,0.2,0.1,0.16,3274,449,679,802
188030,New Mexico State University-Main Campus,1,0,2008,NA,NA,2171,1175,996,337,130,207,0.17,0.13,0.16,3540,475,690,794
188030,New Mexico State University-Main Campus,1,0,2009,NA,NA,2446,1306,1140,328,116,212,0.16,0.1,0.13,3720,496,716,849
188030,New Mexico State University-Main Campus,1,0,2010,NA,NA,2255,1181,1074,381,151,230,0.19,0.14,0.17,4128,491,699,700
188429,ADELPHI UNIVERSITY,1,0,1991,NA,NA,658,417,241,259,74,185,0.44,0.31,0.39,10420,75,280,352
188429,ADELPHI UNIVERSITY,1,0,1992,NA,NA,591,356,235,153,40,113,0.31,0.17,0.26,11420,79,267,291
188429,ADELPHI UNIVERSITY,1,0,1993,NA,NA,464,282,182,154,48,106,0.37,0.26,0.33,12250,76,267,237
188429,ADELPHI UNIVERSITY,1,0,1995,NA,NA,370,212,158,140,52,88,0.41000000000000003,0.33,0.38,13350,83,220,207
188429,ADELPHI UNIVERSITY,1,0,1996,NA,NA,316,204,112,128,40,88,0.43,0.36,0.41,14000,98,176,182
188429,ADELPHI UNIVERSITY,1,0,1997,NA,NA,289,174,115,130,49,81,0.46,0.43,0.45,14000,70,204,150
188429,ADELPHI UNIVERSITY,1,0,1998,NA,NA,525,343,182,214,67,147,0.42,0.37,0.41,14250,67,196,251
188429,ADELPHI UNIVERSITY,1,0,1999,NA,NA,532,366,166,233,64,169,0.46,0.39,0.44,14920,70,196,316
188429,ADELPHI UNIVERSITY,1,0,2000,NA,NA,616,416,200,314,82,232,0.55,0.41,0.51,15520,75,195,349
188429,ADELPHI UNIVERSITY,1,0,2001,NA,NA,664,469,195,367,89,278,0.59,0.46,0.55,16270,78,195,373
188429,ADELPHI UNIVERSITY,1,0,2002,NA,NA,666,463,203,373,97,276,0.59,0.48,0.56,16980,84,215,365
188429,ADELPHI UNIVERSITY,1,0,2003,NA,NA,772,514,258,402,117,285,0.55,0.45,0.52,17800,91,228,395
188429,ADELPHI UNIVERSITY,1,0,2004,NA,NA,801,549,252,463,119,344,0.62,0.47,0.58,17700,103,242,367
188429,Adelphi University,1,0,2005,NA,NA,754,505,249,416,121,295,0.58,0.49,0.55,18620,110,257,327
188429,Adelphi University,1,0,2006,NA,NA,826,587,239,446,108,338,0.5700000000000001,0.45,0.54,19800,124,280,488
188429,Adelphi University,1,0,2007,NA,NA,883,603,280,464,134,330,0.54,0.48,0.53,21000,135,283,517
188429,Adelphi University,1,0,2008,NA,NA,944,614,330,510,146,364,0.59,0.44,0.54,22725,142,295,554
188429,Adelphi University,1,0,2009,NA,NA,985,690,295,539,131,408,0.59,0.44,0.55,24100,155,308,577
188429,Adelphi University,1,0,2010,NA,NA,909,634,275,521,133,388,0.61,0.48,0.57,25465,162,311,499
188641,ALFRED UNIVERSITY,1,0,1991,NA,NA,256,110,146,132,67,65,0.59,0.46,0.52,14110,39,119,231
188641,ALFRED UNIVERSITY,1,0,1992,NA,NA,300,136,164,151,73,78,0.5700000000000001,0.45,0.5,14998,43,111,269
188641,ALFRED UNIVERSITY,1,0,1993,NA,NA,314,148,166,165,74,91,0.61,0.45,0.53,15648,48,113,273
188641,ALFRED UNIVERSITY,1,0,1995,NA,NA,326,158,168,153,56,97,0.61,0.33,0.47,17948,53,114,287
188641,ALFRED UNIVERSITY,1,0,1996,NA,NA,330,166,164,178,76,102,0.61,0.46,0.54,18972,56,117,295
188641,ALFRED UNIVERSITY,1,0,1997,NA,NA,467,205,262,204,99,105,0.51,0.38,0.44,19916,45,114,424
188641,ALFRED UNIVERSITY,1,0,1998,NA,NA,554,275,279,272,118,154,0.56,0.42,0.49,20212,50,111,492
188641,ALFRED UNIVERSITY,1,0,1999,NA,NA,549,277,272,242,98,144,0.51,0.36,0.44,18498,54,115,478
188641,ALFRED UNIVERSITY,1,0,2000,NA,NA,504,280,224,246,81,165,0.58,0.36,0.49,18498,57,115,386
188641,ALFRED UNIVERSITY,1,0,2001,NA,NA,500,243,257,232,97,135,0.55,0.38,0.46,18498,62,115,369
188641,ALFRED UNIVERSITY,1,0,2002,NA,NA,474,223,251,247,111,136,0.6,0.44,0.52,19918,69,125,348
188641,ALFRED UNIVERSITY,1,0,2003,NA,NA,472,250,222,237,89,148,0.59,0.4,0.5,19918,70,188,364
188641,ALFRED UNIVERSITY,1,0,2004,NA,NA,505,226,279,218,99,119,0.52,0.35,0.43,20106,68,172,367
188641,Alfred University,1,0,2005,NA,NA,429,188,241,186,85,101,0.53,0.35,0.43,20515,72,213,306
188641,Alfred University,1,0,2006,NA,NA,490,257,233,229,86,143,0.55,0.37,0.47,21284,66,177,332
188641,Alfred University,1,0,2007,NA,NA,518,239,279,231,107,124,0.51,0.38,0.45,22312,65,167,345
188641,Alfred University,1,0,2008,NA,NA,502,219,283,193,99,94,0.42,0.35,0.38,23428,68,158,344
188641,Alfred University,1,0,2009,NA,NA,465,234,231,204,85,119,0.5,0.37,0.44,24366,68,160,313
188641,Alfred University,1,0,2010,NA,NA,526,240,286,225,91,134,0.55,0.32,0.43,25096,65,156,372
190044,CLARKSON UNIVERSITY,1,0,1991,NA,NA,634,134,500,338,266,72,0.53,0.53,0.53,13675,67,182,554
190044,CLARKSON UNIVERSITY,1,0,1992,NA,NA,549,138,411,294,210,84,0.6,0.51,0.54,14510,69,179,479
190044,CLARKSON UNIVERSITY,1,0,1993,NA,NA,557,120,437,285,221,64,0.53,0.51,0.51,15060,65,161,502
190044,CLARKSON UNIVERSITY,1,0,1995,NA,NA,645,170,475,305,221,84,0.49,0.47,0.47,17113,65,148,573
190044,CLARKSON UNIVERSITY,1,0,1996,NA,NA,664,176,488,349,253,96,0.54,0.52,0.53,17500,68,144,577
190044,CLARKSON UNIVERSITY,1,0,1997,NA,NA,612,136,476,378,297,81,0.59,0.62,0.62,18593,56,154,546
190044,CLARKSON UNIVERSITY,1,0,1998,NA,NA,616,138,478,292,216,76,0.55,0.45,0.47,19418,58,156,553
190044,CLARKSON UNIVERSITY,1,0,1999,NA,NA,706,225,481,407,264,143,0.63,0.55,0.58,19825,60,149,645
190044,CLARKSON UNIVERSITY,1,0,2000,NA,NA,638,149,489,325,242,83,0.55,0.49,0.51,20600,63,156,568
190044,CLARKSON UNIVERSITY,1,0,2001,NA,NA,722,164,558,382,290,92,0.56,0.52,0.53,21400,70,164,631
190044,CLARKSON UNIVERSITY,1,0,2002,NA,NA,723,164,559,391,296,95,0.5700000000000001,0.53,0.54,22235,70,154,673
190044,CLARKSON UNIVERSITY,1,0,2003,NA,NA,720,193,527,372,257,115,0.59,0.49,0.52,23100,76,169,641
190044,CLARKSON UNIVERSITY,1,0,2004,NA,NA,658,142,516,364,275,89,0.62,0.53,0.55,24100,83,169,610
190044,Clarkson University,1,0,2005,NA,NA,630,173,457,380,274,106,0.61,0.6,0.6,25185,83,175,579
190044,Clarkson University,1,0,2006,NA,NA,646,176,470,354,246,108,0.61,0.52,0.55,26650,84,174,556
190044,Clarkson University,1,0,2007,NA,NA,682,189,493,418,289,129,0.68,0.59,0.61,28470,87,183,582
190044,Clarkson University,1,0,2008,NA,NA,734,204,530,407,274,133,0.65,0.52,0.55,30320,87,186,615
190044,Clarkson University,1,0,2009,NA,NA,774,220,554,405,262,143,0.65,0.47,0.52,32220,93,194,645
190044,Clarkson University,1,0,2010,NA,NA,712,182,530,399,279,120,0.65,0.53,0.56,34070,98,201,612
190099,COLGATE UNIVERSITY,1,0,1991,NA,NA,694,330,364,554,265,289,0.87,0.73,0.8,16150,65,194,587
190099,COLGATE UNIVERSITY,1,0,1992,NA,NA,690,368,322,589,257,332,0.9,0.8,0.85,17415,67,200,586
190099,COLGATE UNIVERSITY,1,0,1993,NA,NA,726,378,348,603,269,334,0.88,0.77,0.83,18620,74,198,625
190099,COLGATE UNIVERSITY,1,0,1995,NA,NA,722,361,361,604,290,314,0.86,0.8,0.84,20650,85,192,632
190099,COLGATE UNIVERSITY,1,0,1996,NA,NA,718,351,367,592,282,310,0.88,0.77,0.82,21675,92,190,600
190099,COLGATE UNIVERSITY,1,0,1997,NA,NA,711,364,347,599,276,323,0.88,0.8,0.84,22765,78,188,593
190099,COLGATE UNIVERSITY,1,0,1998,NA,NA,751,407,344,641,283,358,0.87,0.82,0.85,23880,80,193,620
190099,COLGATE UNIVERSITY,1,0,1999,NA,NA,750,397,353,662,306,356,0.89,0.87,0.88,24575,84,230,619
190099,COLGATE UNIVERSITY,1,0,2000,NA,NA,711,339,372,600,308,292,0.86,0.83,0.84,25565,92,241,601
190099,COLGATE UNIVERSITY,1,0,2001,NA,NA,740,392,348,631,282,349,0.89,0.81,0.85,26845,97,253,597
190099,COLGATE UNIVERSITY,1,0,2002,NA,NA,728,386,342,629,292,337,0.87,0.85,0.86,28165,104,247,565
190099,COLGATE UNIVERSITY,1,0,2003,NA,NA,725,355,370,615,301,314,0.88,0.81,0.85,29740,111,246,562
190099,COLGATE UNIVERSITY,1,0,2004,NA,NA,738,396,342,616,277,339,0.85,0.81,0.83,31230,119,246,544
190099,Colgate University,1,0,2005,NA,NA,729,368,361,640,311,329,0.89,0.86,0.88,32885,123,250,571
190099,Colgate University,1,0,2006,NA,NA,743,417,326,630,278,352,0.84,0.85,0.85,34795,130,264,552
190099,Colgate University,1,0,2007,NA,NA,744,382,362,644,297,347,0.9,0.82,0.87,37405,139,257,552
190099,Colgate University,1,0,2008,NA,NA,737,386,351,661,307,354,0.91,0.87,0.9,39275,146,267,553
190099,Colgate University,1,0,2009,NA,NA,750,400,350,644,299,345,0.86,0.85,0.86,40690,150,269,556
190099,Colgate University,1,0,2010,NA,NA,849,466,383,721,312,409,0.87,0.81,0.85,41585,155,280,568
190150,COLUMBIA UNIVERSITY IN THE CITY OF NEW YORK,1,0,1991,NA,NA,1085,464,621,851,481,370,0.79,0.77,0.78,16318,891,888,572
190150,COLUMBIA UNIVERSITY IN THE CITY OF NEW YORK,1,0,1992,NA,NA,1113,458,655,880,511,369,0.8,0.78,0.79,16918,984,2240,478
190150,COLUMBIA UNIVERSITY IN THE CITY OF NEW YORK,1,0,1993,NA,NA,1626,997,629,1243,482,761,0.76,0.77,0.76,17948,1019,2240,848
190150,COLUMBIA UNIVERSITY IN THE CITY OF NEW YORK,1,0,1995,NA,NA,1157,505,652,918,501,417,0.8200000000000001,0.77,0.79,20292,1152,2438,561
190150,COLUMBIA UNIVERSITY IN THE CITY OF NEW YORK,1,0,1996,NA,NA,1260,576,684,1041,542,499,0.86,0.79,0.83,21444,1207,2461,595
190150,COLUMBIA UNIVERSITY IN THE CITY OF NEW YORK,1,0,1997,NA,NA,1271,583,688,1036,547,489,0.8300000000000001,0.8,0.82,22652,1216,1130,583
190150,COLUMBIA UNIVERSITY IN THE CITY OF NEW YORK,1,0,1998,NA,NA,1283,619,664,1061,545,516,0.8300000000000001,0.82,0.83,23244,1281,1163,589
190150,COLUMBIA UNIVERSITY IN THE CITY OF NEW YORK,1,0,1999,NA,NA,1298,573,725,1068,586,482,0.84,0.81,0.82,24150,1418,1217,625
190150,COLUMBIA UNIVERSITY IN THE CITY OF NEW YORK,1,0,2000,NA,NA,1339,610,729,1136,602,534,0.87,0.83,0.85,25044,1573,1290,630
190150,COLUMBIA UNIVERSITY IN THE CITY OF NEW YORK,1,0,2001,NA,NA,1330,607,723,1108,612,496,0.81,0.85,0.83,25790,1722,1364,661
190150,COLUMBIA UNIVERSITY IN THE CITY OF NEW YORK,1,0,2002,NA,NA,1386,636,750,1168,630,538,0.84,0.84,0.84,27190,1895,1466,678
190150,COLUMBIA UNIVERSITY IN THE CITY OF NEW YORK,1,0,2003,NA,NA,1355,626,729,1131,606,525,0.8300000000000001,0.83,0.83,28686,2037,1508,611
190150,COLUMBIA UNIVERSITY IN THE CITY OF NEW YORK,1,0,2004,NA,NA,1366,632,734,1133,604,529,0.8300000000000001,0.82,0.83,30260,2190,1521,604
190150,Columbia University in the City of New York,1,0,2005,NA,NA,1403,660,743,1189,621,568,0.86,0.84,0.85,31924,2409,1289,644
190150,Columbia University in the City of New York,1,0,2006,NA,NA,1353,646,707,1191,604,587,0.9,0.85,0.88,33664,2540,1317,564
190150,Columbia University in the City of New York,1,0,2007,NA,NA,1371,671,700,1173,586,587,0.87,0.84,0.86,35516,2688,1388,567
190150,Columbia University in the City of New York,1,0,2008,NA,NA,1374,653,721,1208,613,595,0.91,0.85,0.88,37470,2894,1425,549
190150,Columbia University in the City of New York,1,0,2009,NA,NA,1432,701,731,1260,629,631,0.9,0.86,0.88,39296,3061,1422,491
190150,Columbia University in the City of New York,1,0,2010,NA,NA,1392,676,716,1188,595,593,0.87,0.83,0.85,41160,3158,1439,495
190248,CONCORDIA COLLEGE,1,0,1991,NA,NA,85,43,42,29,10,19,0.44,0.24,0.34,8370,7,38,73
190248,CONCORDIA COLLEGE,1,0,1992,NA,NA,106,62,44,28,8,20,0.32,0.18,0.26,9370,8,33,79
190248,CONCORDIA COLLEGE,1,0,1993,NA,NA,81,40,41,27,12,15,0.37,0.29,0.33,9990,9,32,61
190248,CONCORDIA COLLEGE,1,0,1995,NA,NA,118,63,55,29,13,16,0.25,0.24,0.25,10696,10,32,81
190248,CONCORDIA COLLEGE,1,0,1996,NA,NA,94,43,51,19,7,12,0.27,0.14,0.2,11400,10,32,69
190248,CONCORDIA COLLEGE,1,0,1997,NA,NA,113,71,42,41,13,28,0.39,0.31,0.36,11990,9,30,90
190248,CONCORDIA COLLEGE,1,0,1998,NA,NA,114,68,46,40,17,23,0.33,0.37,0.35,12650,9,29,75
190248,CONCORDIA COLLEGE,1,0,1999,NA,NA,111,72,39,33,6,27,0.37,0.15,0.3,13350,10,28,66
190248,CONCORDIA COLLEGE,1,0,2000,NA,NA,122,68,54,55,23,32,0.47000000000000003,0.43,0.45,14350,10,26,82
190248,CONCORDIA COLLEGE,1,0,2001,NA,NA,132,88,44,50,9,41,0.46,0.2,0.38,15550,11,24,97
190248,CONCORDIA COLLEGE,1,0,2002,NA,NA,135,75,60,43,16,27,0.36,0.27,0.32,16800,11,26,86
190248,CONCORDIA COLLEGE,1,0,2003,NA,NA,137,85,52,37,12,25,0.29,0.23,0.27,17640,12,25,80
190248,CONCORDIA COLLEGE,1,0,2004,NA,NA,143,61,82,38,13,25,0.4,0.16,0.27,18700,12,24,84
190248,Concordia College,1,0,2005,NA,NA,140,83,57,49,12,37,0.44,0.21,0.35,19800,13,26,92
190248,Concordia College,1,0,2006,NA,NA,171,90,81,57,26,31,0.34,0.32,0.33,20700,13,26,109
190248,Concordia College,1,0,2007,NA,NA,127,76,51,35,9,26,0.34,0.18,0.28,21950,15,28,68
190248,Concordia College,1,0,2008,NA,NA,104,58,46,40,12,28,0.48,0.26,0.38,22930,16,34,51
190248,Concordia College-New York,1,0,2009,NA,NA,101,54,47,27,7,20,0.37,0.15,0.27,23950,17,33,45
190248,Concordia College-New York,1,0,2010,NA,NA,138,76,62,62,22,40,0.52,0.35,0.45,24670,17,35,67
190415,CORNELL UNIVERSITY-ENDOWED COLLEGES,1,0,1991,NA,NA,2949,1345,1604,2336,1218,1118,0.8300000000000001,0.76,0.79,16214,510,923,1705
190415,CORNELL UNIVERSITY-ENDOWED COLLEGES,1,0,1992,NA,NA,2893,1382,1511,2354,1179,1175,0.85,0.78,0.81,17276,523,940,1597
190415,CORNELL UNIVERSITY-ENDOWED COLLEGES,1,0,1993,NA,NA,3172,1423,1749,2612,1400,1212,0.85,0.8,0.82,18226,547,914,1802
190415,CORNELL UNIVERSITY-ENDOWED COLLEGES,1,0,1995,NA,NA,2070,842,1228,1625,931,694,0.8200000000000001,0.76,0.79,20066,634,911,1196
190415,CORNELL UNIVERSITY-ENDOWED COLLEGES,1,0,1996,NA,NA,2001,870,1131,1570,872,698,0.8,0.77,0.78,20974,664,891,1108
190415,CORNELL UNIVERSITY-ENDOWED COLLEGES,1,0,1997,NA,NA,2998,1405,1593,2551,1307,1244,0.88,0.82,0.85,21914,582,906,1750
190415,CORNELL UNIVERSITY-ENDOWED COLLEGES,1,0,1998,NA,NA,3084,1452,1632,2633,1358,1275,0.87,0.83,0.85,22868,619,911,1920
190415,CORNELL UNIVERSITY-ENDOWED COLLEGES,1,0,1999,NA,NA,3158,1497,1661,2660,1341,1319,0.88,0.81,0.84,23760,653,897,1939
190415,CORNELL UNIVERSITY-ENDOWED COLLEGES,1,0,2000,NA,NA,3047,1438,1609,2569,1308,1261,0.87,0.81,0.84,24760,705,911,1814
190415,CORNELL UNIVERSITY-ENDOWED COLLEGES,1,0,2001,NA,NA,2984,1471,1513,2524,1246,1278,0.86,0.82,0.85,25970,705,925,1815
190415,CORNELL UNIVERSITY-ENDOWED COLLEGES,1,0,2002,NA,NA,2999,1530,1469,2605,1253,1352,0.88,0.85,0.87,27270,763,933,1878
190415,CORNELL UNIVERSITY-ENDOWED COLLEGES,1,0,2003,NA,NA,3131,1533,1598,2672,1322,1350,0.88,0.83,0.85,28630,1263,1692,1782
190415,CORNELL UNIVERSITY-ENDOWED COLLEGES,1,0,2004,NA,NA,3051,1494,1557,2621,1289,1332,0.89,0.83,0.86,30000,1333,1748,1724
190415,Cornell University,1,0,2005,NA,NA,3071,1541,1530,2664,1286,1378,0.89,0.84,0.87,31300,1409,1742,1838
190415,Cornell University,1,0,2006,NA,NA,3186,1538,1648,2779,1375,1404,0.91,0.83,0.87,32800,1520,1787,1576
190415,Cornell University,1,0,2007,NA,NA,3005,1454,1551,2601,1285,1316,0.9,0.83,0.87,34600,1547,1799,1363
190415,Cornell University,1,0,2008,NA,NA,3132,1573,1559,2718,1307,1411,0.89,0.84,0.87,36300,1680,1819,1514
190415,Cornell University,1,0,2009,NA,NA,3174,1597,1577,2742,1327,1415,0.88,0.84,0.86,37750,1689,1775,1471
190415,Cornell University,1,0,2010,NA,NA,3172,1579,1593,2763,1325,1438,0.91,0.83,0.87,39450,1616,1737,1467
190512,CUNY BERNARD BARUCH COLLEGE,1,0,1991,NA,NA,1170,746,424,56,19,37,0.04,0.04,0.05,1950,97,433,194
190512,CUNY BERNARD BARUCH COLLEGE,1,0,1992,NA,NA,1359,830,529,52,20,32,0.03,0.04,0.04,2552,104,398,260
190512,CUNY BERNARD M BARUCH COLLEGE,1,0,1993,NA,NA,1300,798,502,63,25,38,0.04,0.05,0.05,2562,111,438,284
190512,CUNY BERNARD M BARUCH COLLEGE,1,0,1995,NA,NA,1445,839,606,149,55,94,0.11,0.09,0.1,3320,123,413,323
190512,CUNY BERNARD M BARUCH COLLEGE,1,0,1996,NA,NA,1365,797,568,196,82,114,0.14,0.14,0.14,3320,119,404,349
190512,CUNY BERNARD M BARUCH COLLEGE,1,0,1997,NA,NA,1109,608,501,202,75,127,0.2,0.15,0.18,3330,126,396,261
190512,CUNY BERNARD M BARUCH COLLEGE,1,0,1998,NA,NA,946,493,453,231,83,148,0.3,0.18,0.24,3330,127,409,276
190512,CUNY BERNARD M BARUCH COLLEGE,1,0,1999,NA,NA,1133,593,540,312,124,188,0.31,0.23,0.28,3200,107,405,358
190512,CUNY BERNARD M BARUCH COLLEGE,1,0,2000,NA,NA,1295,701,594,351,137,214,0.3,0.23,0.27,3200,144,441,417
190512,CUNY BERNARD M BARUCH COLLEGE,1,0,2001,NA,NA,1688,921,767,554,231,323,0.35000000000000003,0.3,0.33,3200,143,477,571
190512,CUNY BERNARD M BARUCH COLLEGE,1,0,2002,NA,NA,1654,830,824,554,217,337,0.4,0.26,0.33,3200,126,424,615
190512,CUNY BERNARD M BARUCH COLLEGE,1,0,2003,NA,NA,1659,819,840,544,214,330,0.4,0.25,0.33,4000,138,473,564
190512,CUNY BERNARD M BARUCH COLLEGE,1,0,2004,NA,NA,1693,865,828,569,233,336,0.38,0.28,0.34,4000,143,486,575
190512,CUNY Bernard M Baruch College,1,0,2005,NA,NA,1625,784,841,577,266,311,0.39,0.32,0.36,4000,150,473,513
190512,CUNY Bernard M Baruch College,1,0,2006,NA,NA,1493,650,843,497,248,249,0.38,0.29,0.33,4000,163,486,448
190512,CUNY Bernard M Baruch College,1,0,2007,NA,NA,1470,695,775,578,259,319,0.45,0.33,0.39,4000,180,501,492
190512,CUNY Bernard M Baruch College,1,0,2008,NA,NA,1497,693,804,530,250,280,0.4,0.31,0.35,4000,195,509,469
190512,CUNY Bernard M Baruch College,1,0,2009,NA,NA,1430,619,811,598,294,304,0.49,0.36,0.42,4600,238,498,444
190512,CUNY Bernard M Baruch College,1,0,2010,NA,NA,1255,527,728,483,242,241,0.45,0.33,0.38,4600,249,522,378
190549,CUNY BROOKLYN COLLEGE,1,0,1991,NA,NA,1475,843,632,135,42,93,0.11,0.07,0.09,2005,100,551,828
190549,CUNY BROOKLYN COLLEGE,1,0,1992,NA,NA,1341,765,576,122,40,82,0.1,0.07,0.09,2607,108,534,728
190549,CUNY BROOKLYN COLLEGE,1,0,1993,NA,NA,1269,748,521,143,40,103,0.13,0.08,0.11,2629,113,557,646
190549,CUNY BROOKLYN COLLEGE,1,0,1995,NA,NA,1167,685,482,182,60,122,0.17,0.12,0.16,3387,125,490,549
190549,CUNY BROOKLYN COLLEGE,1,0,1996,NA,NA,1211,739,472,183,49,134,0.18,0.1,0.15,3387,121,479,591
190549,CUNY BROOKLYN COLLEGE,1,0,1997,NA,NA,1344,774,570,194,75,119,0.15,0.13,0.14,3393,120,473,636
190549,CUNY BROOKLYN COLLEGE,1,0,1998,NA,NA,1029,615,414,184,56,128,0.2,0.14,0.18,3393,126,461,521
190549,CUNY BROOKLYN COLLEGE,1,0,1999,NA,NA,982,591,391,166,55,111,0.18,0.14,0.17,3200,131,465,504
190549,CUNY BROOKLYN COLLEGE,1,0,2000,NA,NA,1238,717,521,218,79,139,0.19,0.15,0.18,3200,130,491,589
190549,CUNY BROOKLYN COLLEGE,1,0,2001,NA,NA,1017,591,426,209,64,145,0.24,0.15,0.21,3200,141,517,528
190549,CUNY BROOKLYN COLLEGE,1,0,2002,NA,NA,1194,679,515,235,78,157,0.23,0.15,0.2,3200,141,466,579
190549,CUNY BROOKLYN COLLEGE,1,0,2003,NA,NA,1296,679,617,220,73,147,0.21,0.12,0.17,4000,146,509,653
190549,CUNY BROOKLYN COLLEGE,1,0,2004,NA,NA,1170,653,517,268,90,178,0.27,0.17,0.23,4000,150,514,545
190549,CUNY Brooklyn College,1,0,2005,NA,NA,1372,757,615,294,109,185,0.24,0.18,0.21,4000,153,510,588
190549,CUNY Brooklyn College,1,0,2006,NA,NA,1354,766,588,355,120,235,0.3,0.2,0.26,4000,171,515,579
190549,CUNY Brooklyn College,1,0,2007,NA,NA,1300,743,557,305,103,202,0.27,0.18,0.23,4000,196,530,531
190549,CUNY Brooklyn College,1,0,2008,NA,NA,1330,792,538,319,107,212,0.26,0.2,0.24,4000,201,533,522
190549,CUNY Brooklyn College,1,0,2009,NA,NA,952,541,411,223,94,129,0.23,0.23,0.23,4600,228,557,388
190549,CUNY Brooklyn College,1,0,2010,NA,NA,1143,661,482,284,95,189,0.28,0.2,0.25,4600,250,519,505
190558,CUNY COLLEGE OF STATEN ISLAND,1,0,1991,NA,NA,1153,599,554,16,4,12,0.02,0.01,0.01,1949,59,257,843
190558,CUNY COLLEGE OF STATEN ISLAND,1,0,1992,NA,NA,1126,593,533,17,3,14,0.02,0.01,0.02,2558,64,237,811
190558,CUNY COLLEGE OF STATEN ISLAND,1,0,1993,NA,NA,1100,579,521,23,9,14,0.02,0.02,0.02,2558,70,293,784
190558,CUNY COLLEGE OF STATEN ISLAND,1,0,1995,NA,NA,1426,728,698,33,17,16,0.02,0.02,0.02,3316,80,264,1007
190558,CUNY COLLEGE OF STATEN ISLAND,1,0,1996,NA,NA,1434,727,707,32,9,23,0.03,0.01,0.02,3316,77,265,956
190558,CUNY COLLEGE OF STATEN ISLAND,1,0,1997,NA,NA,1418,729,689,32,7,25,0.03,0.01,0.02,3316,81,274,944
190558,CUNY COLLEGE OF STATEN ISLAND,1,0,1998,NA,NA,1510,786,724,36,14,22,0.02,0.02,0.02,3316,86,273,956
190558,CUNY COLLEGE OF STATEN ISLAND,1,0,1999,NA,NA,1532,782,750,63,21,42,0.05,0.03,0.04,3200,90,288,942
190558,CUNY COLLEGE OF STATEN ISLAND,1,0,2000,NA,NA,1488,796,692,44,10,34,0.04,0.01,0.03,3200,91,309,982
190558,CUNY COLLEGE OF STATEN ISLAND,1,0,2001,NA,NA,1600,817,783,57,22,35,0.04,0.03,0.04,3200,96,331,1045
190558,CUNY COLLEGE OF STATEN ISLAND,1,0,2002,NA,NA,1743,905,838,66,25,41,0.04,0.03,0.04,3200,97,290,1131
190558,CUNY COLLEGE OF STATEN ISLAND,1,0,2003,NA,NA,1885,1013,872,67,17,50,0.04,0.02,0.04,4000,103,334,1210
190558,CUNY COLLEGE OF STATEN ISLAND,1,0,2004,NA,NA,2020,1147,873,67,12,55,0.04,0.01,0.03,4000,107,343,1243
190558,CUNY College of Staten Island,1,0,2005,NA,NA,1888,1048,840,62,31,31,0.02,0.04,0.03,4000,113,333,1120
190558,CUNY College of Staten Island,1,0,2006,NA,NA,2072,1124,948,108,41,67,0.05,0.04,0.05,4000,123,328,1265
190558,CUNY College of Staten Island,1,0,2007,NA,NA,2273,1272,1001,122,48,74,0.05,0.05,0.05,4000,133,345,1342
190558,CUNY College of Staten Island,1,0,2008,NA,NA,2282,1209,1073,112,47,65,0.05,0.04,0.05,4000,144,347,1340
190558,CUNY College of Staten Island,1,0,2009,NA,NA,2407,1245,1162,127,52,75,0.06,0.04,0.05,4600,172,350,1430
190558,CUNY College of Staten Island,1,0,2010,NA,NA,2237,1184,1053,146,52,94,0.07,0.05,0.07,4600,192,366,1299
190567,CUNY CITY COLLEGE,1,0,1991,NA,NA,1126,505,621,19,11,8,0.01,0.02,0.02,1945,123,623,68
190567,CUNY CITY COLLEGE,1,0,1992,NA,NA,1071,454,617,18,12,6,0.01,0.02,0.02,2547,131,541,53
190567,CUNY CITY COLLEGE,1,0,1993,NA,NA,1167,507,660,25,13,12,0.02,0.02,0.02,2547,136,587,94
190567,CUNY CITY COLLEGE,1,0,1995,NA,NA,865,449,416,31,18,13,0.02,0.04,0.04,3304,139,530,55
190567,CUNY CITY COLLEGE,1,0,1996,NA,NA,768,352,416,28,14,14,0.03,0.03,0.04,3309,126,501,39
190567,CUNY CITY COLLEGE,1,0,1997,NA,NA,947,464,483,44,17,27,0.05,0.04,0.05,3309,123,474,49
190567,CUNY CITY COLLEGE,1,0,1998,NA,NA,901,462,439,31,11,20,0.04,0.03,0.03,3309,129,453,51
190567,CUNY CITY COLLEGE,1,0,1999,NA,NA,773,341,432,45,16,29,0.08,0.04,0.06,3200,133,456,64
190567,CUNY CITY COLLEGE,1,0,2000,NA,NA,852,399,453,27,8,19,0.04,0.02,0.03,3200,88,474,69
190567,CUNY CITY COLLEGE,1,0,2001,NA,NA,705,310,395,54,17,37,0.11,0.04,0.08,3200,168,492,72
190567,CUNY CITY COLLEGE,1,0,2002,NA,NA,961,435,526,65,28,37,0.08,0.05,0.07,3200,172,478,134
190567,CUNY CITY COLLEGE,1,0,2003,NA,NA,1124,547,577,62,20,42,0.07,0.03,0.06,4000,185,512,138
190567,CUNY CITY COLLEGE,1,0,2004,NA,NA,1168,531,637,106,45,61,0.11,0.07,0.09,4000,189,532,137
190567,CUNY City College,1,0,2005,NA,NA,1278,592,686,78,39,39,0.06,0.06,0.06,4000,202,530,164
190567,CUNY City College,1,0,2006,NA,NA,1529,760,769,114,43,71,0.09,0.06,0.07,4000,209,521,224
190567,CUNY City College,1,0,2007,NA,NA,1771,916,855,166,65,101,0.11,0.08,0.09,4000,225,530,270
190567,CUNY City College,1,0,2008,NA,NA,1744,919,825,182,67,115,0.12,0.08,0.1,4000,257,567,271
190567,CUNY City College,1,0,2009,NA,NA,1753,909,844,195,75,120,0.13,0.09,0.11,4600,324,574,323
190567,CUNY City College,1,0,2010,NA,NA,1368,685,683,171,58,113,0.16,0.08,0.12,4600,343,588,241
190594,CUNY HUNTER COLLEGE,1,0,1991,NA,NA,808,617,191,30,3,27,0.04,0.02,0.04,1953,126,548,163
190594,CUNY HUNTER COLLEGE,1,0,1992,NA,NA,936,710,226,35,10,25,0.03,0.04,0.04,2555,127,529,200
190594,CUNY HUNTER COLLEGE,1,0,1993,NA,NA,1308,1011,297,62,7,55,0.05,0.02,0.05,2555,140,572,284
190594,CUNY HUNTER COLLEGE,1,0,1995,NA,NA,1091,807,284,82,13,69,0.08,0.05,0.08,3313,149,544,356
190594,CUNY HUNTER COLLEGE,1,0,1996,NA,NA,1456,1008,448,127,28,99,0.09,0.06,0.09,3323,130,525,456
190594,CUNY HUNTER COLLEGE,1,0,1997,NA,NA,1630,1137,493,136,26,110,0.09,0.05,0.08,3329,130,512,551
190594,CUNY HUNTER COLLEGE,1,0,1998,NA,NA,1468,1026,442,134,29,105,0.1,0.07,0.09,3329,142,526,486
190594,CUNY HUNTER COLLEGE,1,0,1999,NA,NA,1806,1281,525,176,36,140,0.1,0.07,0.1,3200,146,522,585
190594,CUNY HUNTER COLLEGE,1,0,2000,NA,NA,1741,1227,514,188,43,145,0.11,0.08,0.11,3200,149,556,619
190594,CUNY HUNTER COLLEGE,1,0,2001,NA,NA,1877,1284,593,234,41,193,0.15,0.07,0.12,3200,172,591,670
190594,CUNY HUNTER COLLEGE,1,0,2002,NA,NA,1445,1010,435,256,50,206,0.2,0.11,0.18,3200,173,632,573
190594,CUNY HUNTER COLLEGE,1,0,2003,NA,NA,1661,1113,548,280,63,217,0.19,0.11,0.17,4000,191,612,641
190594,CUNY HUNTER COLLEGE,1,0,2004,NA,NA,1824,1235,589,312,81,231,0.18,0.14,0.17,4000,192,641,683
190594,CUNY Hunter College,1,0,2005,NA,NA,1776,1199,577,356,97,259,0.21,0.17,0.2,4000,205,633,692
190594,CUNY Hunter College,1,0,2006,NA,NA,1813,1202,611,349,86,263,0.21,0.14,0.19,4000,239,632,658
190594,CUNY Hunter College,1,0,2007,NA,NA,1854,1226,628,402,89,313,0.25,0.14,0.22,4000,244,668,699
190594,CUNY Hunter College,1,0,2008,NA,NA,1988,1273,715,445,108,337,0.26,0.15,0.22,4000,268,686,698
190594,CUNY Hunter College,1,0,2009,NA,NA,1983,1241,742,487,115,372,0.29,0.15,0.25,4600,307,694,708
190594,CUNY Hunter College,1,0,2010,NA,NA,1740,1141,599,413,100,313,0.27,0.17,0.24,4600,337,705,661
190637,CUNY LEHMAN COLLEGE,1,0,1991,NA,NA,711,470,241,15,8,7,0.01,0.03,0.02,1960,61,330,74
190637,CUNY LEHMAN COLLEGE,1,0,1992,NA,NA,692,468,224,21,6,15,0.03,0.03,0.03,2562,65,305,60
190637,CUNY LEHMAN COLLEGE,1,0,1993,NA,NA,663,455,208,15,1,14,0.03,0,0.02,2562,72,324,56
190637,CUNY LEHMAN COLLEGE,1,0,1995,NA,NA,506,345,161,32,7,25,0.07,0.04,0.06,3320,79,286,43
190637,CUNY LEHMAN COLLEGE,1,0,1996,NA,NA,605,422,183,45,8,37,0.08,0.04,0.07,3320,74,272,47
190637,CUNY LEHMAN COLLEGE,1,0,1997,NA,NA,736,519,217,45,11,34,0.06,0.05,0.06,3320,78,276,56
190637,CUNY LEHMAN COLLEGE,1,0,1998,NA,NA,581,398,183,28,8,20,0.05,0.04,0.05,3320,81,280,48
190637,CUNY LEHMAN COLLEGE,1,0,1999,NA,NA,604,416,188,44,19,25,0.06,0.1,0.07,3200,82,281,51
190637,CUNY LEHMAN COLLEGE,1,0,2000,NA,NA,542,367,175,45,11,34,0.09,0.06,0.08,3200,86,287,41
190637,CUNY LEHMAN COLLEGE,1,0,2001,NA,NA,642,441,201,77,18,59,0.13,0.09,0.12,3200,94,294,39
190637,CUNY LEHMAN COLLEGE,1,0,2002,NA,NA,729,485,244,73,21,52,0.1,0.09,0.1,3200,98,287,49
190637,CUNY LEHMAN COLLEGE,1,0,2003,NA,NA,790,529,261,85,20,65,0.12,0.08,0.11,4000,104,308,59
190637,CUNY LEHMAN COLLEGE,1,0,2004,NA,NA,852,571,281,100,27,73,0.12,0.1,0.12,4000,108,337,64
190637,CUNY Lehman College,1,0,2005,NA,NA,788,551,237,110,33,77,0.13,0.14,0.14,4000,117,330,52
190637,CUNY Lehman College,1,0,2006,NA,NA,911,674,237,131,24,107,0.15,0.1,0.14,4000,125,344,64
190637,CUNY Lehman College,1,0,2007,NA,NA,874,610,264,129,35,94,0.15,0.13,0.15,4000,137,363,59
190637,CUNY Lehman College,1,0,2008,NA,NA,987,654,333,139,40,99,0.15,0.12,0.14,4000,148,373,63
190637,CUNY Lehman College,1,0,2009,NA,NA,754,461,293,111,34,77,0.16,0.12,0.15,4600,172,374,55
190637,CUNY Lehman College,1,0,2010,NA,NA,619,386,233,116,33,83,0.21,0.14,0.19,4600,186,384,45
190664,CUNY QUEENS COLLEGE,1,0,1991,NA,NA,1603,889,714,165,49,116,0.13,0.07,0.1,2033,111,579,848
190664,QUEENS COLLEGE,1,0,1992,NA,NA,1448,819,629,146,35,111,0.13,0.06,0.1,2635,117,551,808
190664,QUEENS COLLEGE,1,0,1993,NA,NA,1526,831,695,180,55,125,0.15,0.08,0.12,2635,130,631,809
190664,QUEENS COLLEGE,1,0,1995,NA,NA,1444,805,639,228,81,147,0.18,0.13,0.16,3392,143,541,777
190664,QUEENS COLLEGE,1,0,1996,NA,NA,1040,621,419,225,56,169,0.27,0.13,0.22,3393,123,516,547
190664,CUNY QUEENS COLLEGE,1,0,1997,NA,NA,1153,675,478,227,65,162,0.24,0.14,0.2,3393,125,521,578
190664,CUNY QUEENS COLLEGE,1,0,1998,NA,NA,1133,711,422,235,59,176,0.24,0.14,0.21,3393,133,514,558
190664,CUNY QUEENS COLLEGE,1,0,1999,NA,NA,876,528,348,200,50,150,0.28,0.14,0.23,3200,138,516,448
190664,CUNY QUEENS COLLEGE,1,0,2000,NA,NA,1085,639,446,254,65,189,0.29,0.15,0.23,3200,139,551,496
190664,CUNY QUEENS COLLEGE,1,0,2001,NA,NA,1204,704,500,325,100,225,0.31,0.2,0.27,3200,139,587,557
190664,CUNY QUEENS COLLEGE,1,0,2002,NA,NA,1178,693,485,325,90,235,0.33,0.19,0.28,3200,151,545,596
190664,CUNY QUEENS COLLEGE,1,0,2003,NA,NA,1290,790,500,327,88,239,0.3,0.18,0.25,4000,161,566,626
190664,CUNY QUEENS COLLEGE,1,0,2004,NA,NA,1352,815,537,352,102,250,0.3,0.19,0.26,4000,165,593,629
190664,CUNY Queens College,1,0,2005,NA,NA,1470,884,586,381,101,280,0.31,0.17,0.26,4000,178,577,708
190664,CUNY Queens College,1,0,2006,NA,NA,1627,991,636,418,113,305,0.3,0.18,0.26,4000,188,582,762
190664,CUNY Queens College,1,0,2007,NA,NA,1755,1064,691,440,112,328,0.3,0.16,0.25,4000,207,628,776
190664,CUNY Queens College,1,0,2008,NA,NA,1642,961,681,445,125,320,0.33,0.18,0.27,4000,227,630,667
190664,CUNY Queens College,1,0,2009,NA,NA,1684,944,740,473,153,320,0.33,0.21,0.28,4600,270,636,781
190664,CUNY Queens College,1,0,2010,NA,NA,1471,821,650,452,133,319,0.38,0.2,0.31,4600,296,641,679
190691,CUNY YORK COLLEGE,1,0,1991,NA,NA,431,276,155,22,10,12,0.04,0.06,0.05,1932,33,131,17
190691,CUNY YORK COLLEGE,1,0,1992,NA,NA,640,392,248,22,12,10,0.02,0.05,0.03,2534,36,117,27
190691,CUNY YORK COLLEGE,1,0,1993,NA,NA,607,359,248,29,13,16,0.04,0.05,0.05,2534,41,147,28
190691,CUNY YORK COLLEGE,1,0,1995,NA,NA,486,294,192,22,7,15,0.05,0.04,0.05,3291,48,141,27
190691,CUNY YORK COLLEGE,1,0,1996,NA,NA,543,368,175,47,16,31,0.08,0.09,0.09,3292,45,130,29
190691,CUNY YORK COLLEGE,1,0,1997,NA,NA,500,323,177,38,12,26,0.08,0.07,0.08,3292,46,139,26
190691,CUNY YORK COLLEGE,1,0,1998,NA,NA,383,235,148,22,8,14,0.05,0.05,0.06,3292,48,142,27
190691,CUNY YORK COLLEGE,1,0,1999,NA,NA,425,261,164,31,11,20,0.07,0.07,0.07,3200,49,147,23
190691,CUNY YORK COLLEGE,1,0,2000,NA,NA,458,314,144,29,6,23,0.07,0.04,0.06,3200,51,157,30
190691,CUNY YORK COLLEGE,1,0,2001,NA,NA,464,320,144,35,11,24,0.07,0.08,0.08,3200,56,168,28
190691,CUNY YORK COLLEGE,1,0,2002,NA,NA,563,385,178,34,8,26,0.06,0.04,0.06,3200,58,154,27
190691,CUNY YORK COLLEGE,1,0,2003,NA,NA,565,366,199,30,8,22,0.06,0.04,0.05,4000,62,164,37
190691,CUNY YORK COLLEGE,1,0,2004,NA,NA,727,453,274,27,8,19,0.04,0.03,0.04,4000,59,172,45
190691,CUNY York College,1,0,2005,NA,NA,746,481,265,27,5,22,0.04,0.02,0.04,4000,63,180,40
190691,CUNY York College,1,0,2006,NA,NA,668,428,240,27,10,17,0.03,0.04,0.04,4000,70,174,46
190691,CUNY York College,1,0,2007,NA,NA,983,636,347,50,11,39,0.06,0.03,0.05,4000,78,183,53
190691,CUNY York College,1,0,2008,NA,NA,1024,673,351,80,26,54,0.08,0.07,0.08,4000,82,205,77
190691,CUNY York College,1,0,2009,NA,NA,1028,627,401,50,12,38,0.06,0.03,0.05,4600,102,220,88
190691,CUNY York College,1,0,2010,NA,NA,1085,652,433,71,16,55,0.08,0.04,0.07,4600,115,233,82
190725,DAEMEN COLLEGE,1,0,1991,NA,NA,244,164,80,40,14,26,0.15,0.17,0.16,7980,17,65,207
190725,DAEMEN COLLEGE,1,0,1992,NA,NA,302,205,97,45,9,36,0.17,0.09,0.15,8330,20,66,244
190725,DAEMEN COLLEGE,1,0,1993,NA,NA,405,271,134,58,19,39,0.14,0.14,0.14,8730,18,69,358
190725,DAEMEN COLLEGE,1,0,1995,NA,NA,398,269,129,77,20,57,0.21,0.16,0.19,9780,18,75,362
190725,DAEMEN COLLEGE,1,0,1996,NA,NA,372,259,113,69,11,58,0.22,0.1,0.19,10330,21,74,336
190725,DAEMEN COLLEGE,1,0,1997,NA,NA,416,313,103,87,22,65,0.2,0.21,0.21,10980,17,77,360
190725,DAEMEN COLLEGE,1,0,1998,NA,NA,345,262,83,80,20,60,0.22,0.24,0.23,11100,18,72,293
190725,DAEMEN COLLEGE,1,0,1999,NA,NA,293,230,63,70,17,53,0.23,0.27,0.24,11800,19,72,222
190725,DAEMEN COLLEGE,1,0,2000,NA,NA,317,254,63,77,13,64,0.25,0.21,0.24,12500,18,72,247
190725,DAEMEN COLLEGE,1,0,2001,NA,NA,340,278,62,88,12,76,0.27,0.19,0.26,13200,19,73,243
190725,DAEMEN COLLEGE,1,0,2002,NA,NA,316,246,70,84,16,68,0.27,0.23,0.27,13850,21,77,254
190725,DAEMEN COLLEGE,1,0,2003,NA,NA,356,252,104,108,23,85,0.33,0.22,0.3,14700,23,77,269
190725,DAEMEN COLLEGE,1,0,2004,NA,NA,264,198,66,62,11,51,0.25,0.17,0.23,15570,26,80,191
190725,Daemen College,1,0,2005,NA,NA,366,288,78,91,12,79,0.27,0.15,0.25,16350,27,83,300
190725,Daemen College,1,0,2006,NA,NA,368,284,84,100,22,78,0.27,0.26,0.27,17240,29,85,315
190725,Daemen College,1,0,2007,NA,NA,361,268,93,99,19,80,0.29,0.2,0.27,18300,30,89,299
190725,Daemen College,1,0,2008,NA,NA,405,309,96,110,24,86,0.27,0.25,0.27,19400,32,99,324
190725,Daemen College,1,0,2009,NA,NA,400,306,94,103,29,74,0.24,0.31,0.26,20250,34,105,320
190725,Daemen College,1,0,2010,NA,NA,441,325,116,148,36,112,0.34,0.31,0.34,20950,36,110,314
191241,FORDHAM UNIVERSITY,1,0,1991,NA,NA,952,507,445,641,292,349,0.68,0.66,0.67,11100,149,521,677
191241,FORDHAM UNIVERSITY,1,0,1992,NA,NA,1039,546,493,623,294,329,0.6,0.6,0.6,12170,160,513,693
191241,FORDHAM UNIVERSITY,1,0,1993,NA,NA,989,532,457,587,271,316,0.59,0.59,0.59,13375,164,498,629
191241,FORDHAM UNIVERSITY,1,0,1995,NA,NA,1120,620,500,794,323,471,0.75,0.65,0.71,14900,186,508,777
191241,FORDHAM UNIVERSITY,1,0,1996,NA,NA,1206,694,512,822,338,484,0.6900000000000001,0.66,0.68,15800,201,525,789
191241,FORDHAM UNIVERSITY,1,0,1997,NA,NA,1459,849,610,1075,445,630,0.74,0.73,0.74,16800,171,569,971
191241,FORDHAM UNIVERSITY,1,0,1998,NA,NA,1532,912,620,1111,422,689,0.75,0.68,0.73,18435,185,603,992
191241,FORDHAM UNIVERSITY,1,0,1999,NA,NA,1538,891,647,1105,443,662,0.74,0.68,0.72,19200,205,594,1008
191241,FORDHAM UNIVERSITY,1,0,2000,NA,NA,1632,975,657,1183,468,715,0.73,0.71,0.72,20200,215,597,1008
191241,FORDHAM UNIVERSITY,1,0,2001,NA,NA,1610,950,660,1218,470,748,0.78,0.71,0.76,21210,235,601,1022
191241,FORDHAM UNIVERSITY,1,0,2002,NA,NA,1694,1020,674,1263,478,785,0.76,0.71,0.75,22913,248,595,1042
191241,FORDHAM UNIVERSITY,1,0,2003,NA,NA,1687,961,726,1265,547,718,0.74,0.75,0.75,24001,288,625,1045
191241,FORDHAM UNIVERSITY,1,0,2004,NA,NA,1674,997,677,1269,486,783,0.78,0.72,0.76,26085,302,645,986
191241,Fordham University,1,0,2005,NA,NA,1734,983,751,1282,548,734,0.74,0.73,0.74,27769,324,654,1069
191241,Fordham University,1,0,2006,NA,NA,1697,929,768,1300,578,722,0.77,0.75,0.77,29715,347,667,1083
191241,Fordham University,1,0,2007,NA,NA,1760,910,850,1338,645,693,0.76,0.76,0.76,31375,369,686,1056
191241,Fordham University,1,0,2008,NA,NA,1852,991,861,1385,629,756,0.76,0.73,0.75,34099,396,723,1078
191241,Fordham University,1,0,2009,NA,NA,1811,926,885,1358,647,711,0.76,0.73,0.75,35717,421,699,1169
191241,Fordham University,1,0,2010,NA,NA,1865,1021,844,1388,607,781,0.76,0.72,0.74,37050,433,703,1223
191515,HAMILTON COLLEGE,1,0,1991,NA,NA,462,207,255,384,204,180,0.86,0.8,0.83,16650,45,135,391
191515,HAMILTON COLLEGE,1,0,1992,NA,NA,461,223,238,373,178,195,0.87,0.75,0.81,17650,48,148,385
191515,HAMILTON COLLEGE,1,0,1993,NA,NA,452,195,257,361,192,169,0.86,0.75,0.8,18650,50,149,378
191515,HAMILTON COLLEGE,1,0,1995,NA,NA,488,237,251,392,194,198,0.8300000000000001,0.77,0.8,20700,57,152,435
191515,HAMILTON COLLEGE,1,0,1996,NA,NA,497,239,258,392,196,196,0.8200000000000001,0.76,0.79,21700,62,147,446
191515,HAMILTON COLLEGE,1,0,1997,NA,NA,457,239,218,381,172,209,0.87,0.79,0.83,22700,53,138,400
191515,HAMILTON COLLEGE,1,0,1998,NA,NA,464,238,226,372,170,202,0.84,0.75,0.8,23600,56,148,396
191515,HAMILTON COLLEGE,1,0,1999,NA,NA,500,254,246,408,190,218,0.85,0.77,0.82,25000,61,151,418
191515,HAMILTON COLLEGE,1,0,2000,NA,NA,467,251,216,386,172,214,0.85,0.8,0.83,26000,64,159,383
191515,HAMILTON COLLEGE,1,0,2001,NA,NA,465,233,232,386,185,201,0.86,0.8,0.83,27250,70,168,389
191515,HAMILTON COLLEGE,1,0,2002,NA,NA,492,252,240,418,195,223,0.88,0.81,0.85,28610,70,196,403
191515,HAMILTON COLLEGE,1,0,2003,NA,NA,464,234,230,383,185,198,0.84,0.8,0.83,30000,85,202,370
191515,HAMILTON COLLEGE,1,0,2004,NA,NA,457,236,221,385,180,205,0.86,0.81,0.84,31500,86,202,281
191515,Hamilton College,1,0,2005,NA,NA,496,248,248,417,198,219,0.88,0.8,0.84,33150,93,191,342
191515,Hamilton College,1,0,2006,NA,NA,501,267,234,424,195,229,0.85,0.83,0.85,34780,96,200,360
191515,Hamilton College,1,0,2007,NA,NA,468,247,221,419,193,226,0.91,0.87,0.9,36500,102,194,338
191515,Hamilton College,1,0,2008,NA,NA,461,257,204,396,164,232,0.9,0.8,0.86,38220,107,200,309
191515,Hamilton College,1,0,2009,NA,NA,466,241,225,407,180,227,0.9400000000000001,0.8,0.87,39370,111,191,291
191515,Hamilton College,1,0,2010,NA,NA,467,252,215,414,185,229,0.9,0.86,0.89,40870,114,194,279
191533,HARTWICK COLLEGE,1,0,1991,NA,NA,370,217,153,201,74,127,0.58,0.48,0.54,13350,31,122,341
191533,HARTWICK COLLEGE,1,0,1992,NA,NA,446,228,218,248,108,140,0.61,0.5,0.56,14350,31,117,410
191533,HARTWICK COLLEGE,1,0,1993,NA,NA,429,217,212,201,80,121,0.55,0.38,0.47,16400,33,123,383
191533,HARTWICK COLLEGE,1,0,1995,NA,NA,453,229,224,227,88,139,0.6,0.39,0.5,19300,37,103,396
191533,HARTWICK COLLEGE,1,0,1996,NA,NA,482,257,225,228,93,135,0.52,0.41,0.47,20805,42,112,411
191533,HARTWICK COLLEGE,1,0,1997,NA,NA,388,197,191,209,94,115,0.58,0.49,0.54,21065,50,109,283
191533,HARTWICK COLLEGE,1,0,1998,NA,NA,440,227,213,204,82,122,0.53,0.38,0.46,23090,39,104,305
191533,HARTWICK COLLEGE,1,0,1999,NA,NA,407,210,197,192,75,117,0.55,0.38,0.47,23745,40,108,287
191533,HARTWICK COLLEGE,1,0,2000,NA,NA,425,245,180,188,61,127,0.51,0.34,0.44,24760,43,106,290
191533,HARTWICK COLLEGE,1,0,2001,NA,NA,433,232,201,200,73,127,0.54,0.36,0.46,25715,43,105,272
191533,HARTWICK COLLEGE,1,0,2002,NA,NA,375,224,151,165,56,109,0.48,0.37,0.44,26615,42,104,255
191533,HARTWICK COLLEGE,1,0,2003,NA,NA,447,236,211,210,77,133,0.56,0.36,0.47,27400,41,101,279
191533,HARTWICK COLLEGE,1,0,2004,NA,NA,409,219,190,189,80,109,0.49,0.42,0.46,25830,40,105,254
191533,Hartwick College,1,0,2005,NA,NA,405,212,193,182,77,105,0.49,0.4,0.45,26480,41,108,256
191533,Hartwick College,1,0,2006,NA,NA,464,270,194,235,88,147,0.54,0.45,0.51,27450,43,112,302
191533,Hartwick College,1,0,2007,NA,NA,452,256,196,243,92,151,0.58,0.47,0.54,30125,43,107,290
191533,Hartwick College,1,0,2008,NA,NA,444,250,194,224,91,133,0.53,0.47,0.5,31330,46,108,292
191533,Hartwick College,1,0,2009,NA,NA,402,239,163,202,66,136,0.56,0.4,0.5,32550,46,103,253
191533,Hartwick College,1,0,2010,NA,NA,487,270,217,241,104,137,0.5,0.48,0.49,33850,42,104,344
191630,HOBART WILLIAM SMITH COLLEGES,0,1,1991,2000,0,503,211,292,334,174,160,0.75,0.6,0.66,16396,42,130,419
191630,HOBART WILLIAM SMITH COLLEGES,0,1,1992,2000,0,564,261,303,349,167,182,0.6900000000000001,0.55,0.62,17291,46,141,481
191630,HOBART WILLIAM SMITH COLLEGES,0,1,1993,2000,0,493,236,257,325,146,179,0.75,0.57,0.66,18309,49,134,435
191630,HOBART WILLIAM SMITH COLLEGES,0,1,1995,2000,0,458,244,214,318,137,181,0.74,0.64,0.69,20393,52,132,399
191630,HOBART WILLIAM SMITH COLLEGES,0,1,1996,2000,0,530,267,263,356,161,195,0.73,0.61,0.67,21381,54,131,445
191630,HOBART WILLIAM SMITH COLLEGES,0,1,1997,2000,0,549,284,265,354,174,180,0.63,0.66,0.64,22380,40,132,448
191630,HOBART WILLIAM SMITH COLLEGES,0,1,1998,2000,0,488,280,208,347,129,218,0.77,0.62,0.71,23448,43,132,416
191630,HOBART WILLIAM SMITH COLLEGES,0,1,1999,2000,0,502,255,247,307,133,174,0.68,0.54,0.61,23865,44,135,440
191630,HOBART WILLIAM SMITH COLLEGES,1,0,2000,2000,1,521,282,239,353,144,209,0.74,0.6,0.68,24700,46,142,445
191630,HOBART WILLIAM SMITH COLLEGES,1,0,2001,2000,1,548,313,235,368,137,231,0.73,0.58,0.67,25664,49,149,473
191630,HOBART WILLIAM SMITH COLLEGES,1,0,2002,2000,1,532,283,249,367,151,216,0.76,0.61,0.69,26818,52,152,457
191630,HOBART WILLIAM SMITH COLLEGES,1,0,2003,2000,1,516,267,249,383,176,207,0.77,0.71,0.74,28400,55,169,448
191630,HOBART WILLIAM SMITH COLLEGES,1,0,2004,2000,1,482,255,227,337,142,195,0.76,0.63,0.7,30076,59,172,428
191630,Hobart William Smith Colleges,1,0,2005,2000,1,545,283,262,377,159,218,0.77,0.61,0.69,31850,62,174,475
191630,Hobart William Smith Colleges,1,0,2006,2000,1,597,319,278,428,182,246,0.77,0.65,0.72,33730,67,183,534
191630,Hobart William Smith Colleges,1,0,2007,2000,1,600,338,262,444,172,272,0.8,0.66,0.74,35720,72,173,419
191630,Hobart William Smith Colleges,1,0,2008,2000,1,544,288,256,404,179,225,0.78,0.7,0.74,37820,78,176,262
191630,Hobart William Smith Colleges,1,0,2009,2000,1,545,315,230,416,161,255,0.8,0.7,0.76,39144,88,181,311
191630,Hobart William Smith Colleges,1,0,2010,2000,1,618,339,279,448,182,266,0.78,0.65,0.72,40592,85,179,442
191649,HOFSTRA UNIVERSITY,1,0,1991,NA,NA,1338,747,591,567,190,377,0.5,0.32,0.42,9790,157,420,628
191649,HOFSTRA UNIVERSITY,1,0,1992,NA,NA,1403,769,634,571,196,375,0.48,0.31,0.41,10490,162,418,656
191649,HOFSTRA UNIVERSITY,1,0,1993,NA,NA,1349,705,644,524,191,333,0.47000000000000003,0.3,0.39,11080,168,418,902
191649,HOFSTRA UNIVERSITY,1,0,1995,NA,NA,1518,830,688,559,201,358,0.43,0.29,0.37,12360,181,429,970
191649,HOFSTRA UNIVERSITY,1,0,1996,NA,NA,1735,996,739,653,217,436,0.43,0.29,0.38,12966,191,432,664
191649,HOFSTRA UNIVERSITY,1,0,1997,NA,NA,1743,928,815,648,221,427,0.46,0.27,0.37,13544,186,448,924
191649,HOFSTRA UNIVERSITY,1,0,1998,NA,NA,1749,907,842,593,217,376,0.41000000000000003,0.26,0.34,14000,200,462,972
191649,HOFSTRA UNIVERSITY,1,0,1999,NA,NA,1876,1015,861,675,242,433,0.42,0.28,0.36,13750,204,473,1105
191649,HOFSTRA UNIVERSITY,1,0,2000,NA,NA,1937,1036,901,703,266,437,0.42,0.3,0.36,14280,218,468,1101
191649,HOFSTRA UNIVERSITY,1,0,2001,NA,NA,1974,1037,937,685,248,437,0.42,0.26,0.35,14920,236,464,1232
191649,HOFSTRA UNIVERSITY,1,0,2002,NA,NA,1764,912,852,693,254,439,0.48,0.3,0.39,15740,230,489,1181
191649,HOFSTRA UNIVERSITY,1,0,2003,NA,NA,1855,979,876,768,290,478,0.48,0.33,0.41,17410,248,508,1181
191649,HOFSTRA UNIVERSITY,1,0,2004,NA,NA,1713,885,828,750,303,447,0.5,0.37,0.44,19010,251,518,1102
191649,Hofstra University,1,0,2005,NA,NA,1759,961,798,763,281,482,0.5,0.35,0.43,20500,262,527,1065
191649,Hofstra University,1,0,2006,NA,NA,1706,865,841,768,335,433,0.5,0.4,0.45,22200,286,532,1067
191649,Hofstra University,1,0,2007,NA,NA,1716,907,809,850,344,506,0.55,0.43,0.5,25700,297,544,1131
191649,Hofstra University,1,0,2008,NA,NA,1637,864,773,816,344,472,0.54,0.45,0.5,27600,314,551,1137
191649,Hofstra University,1,0,2009,NA,NA,1554,834,720,755,297,458,0.54,0.41,0.49,29080,333,544,1045
191649,Hofstra University,1,0,2010,NA,NA,1435,819,616,764,289,475,0.58,0.47,0.53,30750,333,533,884
191676,HOUGHTON COLLEGE,1,0,1991,NA,NA,244,152,92,119,46,73,0.48,0.5,0.49,8676,16,75,219
191676,HOUGHTON COLLEGE,1,0,1992,NA,NA,296,195,101,141,44,97,0.49,0.44,0.48,9230,18,74,264
191676,HOUGHTON COLLEGE,1,0,1993,NA,NA,287,182,105,147,50,97,0.53,0.48,0.51,9720,19,77,254
191676,HOUGHTON COLLEGE,1,0,1995,NA,NA,293,213,80,171,52,119,0.55,0.65,0.58,10890,23,77,263
191676,HOUGHTON COLLEGE,1,0,1996,NA,NA,288,194,94,164,47,117,0.6,0.5,0.57,12060,24,77,252
191676,HOUGHTON COLLEGE,1,0,1997,NA,NA,310,198,112,179,65,114,0.5700000000000001,0.58,0.58,12764,19,78,277
191676,HOUGHTON COLLEGE,1,0,1998,NA,NA,309,204,105,180,50,130,0.63,0.48,0.58,12776,20,78,272
191676,HOUGHTON COLLEGE,1,0,1999,NA,NA,294,186,108,166,56,110,0.59,0.52,0.56,14590,20,78,273
191676,HOUGHTON COLLEGE,1,0,2000,NA,NA,358,226,132,217,75,142,0.62,0.57,0.61,15180,23,83,330
191676,HOUGHTON COLLEGE,1,0,2001,NA,NA,355,229,126,222,77,145,0.63,0.61,0.63,16290,26,88,328
191676,HOUGHTON COLLEGE,1,0,2002,NA,NA,289,201,88,187,54,133,0.66,0.61,0.65,17160,27,86,262
191676,HOUGHTON COLLEGE,1,0,2003,NA,NA,299,203,96,179,53,126,0.62,0.55,0.6,17984,29,85,272
191676,HOUGHTON COLLEGE,1,0,2004,NA,NA,320,212,108,186,56,130,0.61,0.52,0.58,18660,31,89,290
191676,Houghton College,1,0,2005,NA,NA,321,211,110,180,57,123,0.58,0.52,0.56,19420,32,89,299
191676,Houghton College,1,0,2006,NA,NA,306,195,111,177,58,119,0.61,0.52,0.58,20400,32,92,276
191676,Houghton College,1,0,2007,NA,NA,264,174,90,171,54,117,0.67,0.6,0.65,21620,33,92,239
191676,Houghton College,1,0,2008,NA,NA,327,211,116,193,56,137,0.64,0.48,0.59,22990,35,94,284
191676,Houghton College,1,0,2009,NA,NA,282,199,83,186,53,133,0.66,0.64,0.66,24440,35,88,245
191676,Houghton College,1,0,2010,NA,NA,253,178,75,154,46,108,0.6,0.61,0.61,25360,34,91,221
191931,IONA COLLEGE,1,0,1991,NA,NA,1046,526,520,290,122,168,0.31,0.23,0.28,9000,59,207,646
191931,IONA COLLEGE,1,0,1992,NA,NA,1012,522,490,322,136,186,0.35000000000000003,0.28,0.32,9500,70,204,663
191931,IONA COLLEGE,1,0,1993,NA,NA,951,455,496,260,117,143,0.31,0.24,0.27,10210,65,192,641
191931,IONA COLLEGE,1,0,1995,NA,NA,609,288,321,203,73,130,0.45,0.23,0.33,11330,61,175,369
191931,IONA COLLEGE,1,0,1996,NA,NA,662,320,342,260,100,160,0.5,0.29,0.39,12200,56,167,422
191931,IONA COLLEGE,1,0,1997,NA,NA,695,312,383,263,98,165,0.52,0.26,0.38,13420,48,170,439
191931,IONA COLLEGE,1,0,1998,NA,NA,696,302,394,279,117,162,0.53,0.3,0.4,14000,48,170,501
191931,IONA COLLEGE,1,0,1999,NA,NA,790,349,441,335,147,188,0.53,0.33,0.42,14700,52,169,540
191931,IONA COLLEGE,1,0,2000,NA,NA,723,351,372,337,132,205,0.58,0.35,0.47,15500,58,164,518
191931,IONA COLLEGE,1,0,2001,NA,NA,768,376,392,360,144,216,0.5700000000000001,0.37,0.47,16500,55,160,503
191931,IONA COLLEGE,1,0,2002,NA,NA,731,379,352,337,123,214,0.56,0.35,0.46,17326,55,168,492
191931,IONA COLLEGE,1,0,2003,NA,NA,811,434,377,409,152,257,0.59,0.4,0.5,17750,60,171,553
191931,IONA COLLEGE,1,0,2004,NA,NA,854,458,396,448,175,273,0.59,0.44,0.52,18990,64,178,617
191931,Iona College,1,0,2005,NA,NA,776,419,357,375,150,225,0.53,0.42,0.48,20110,67,173,537
191931,Iona College,1,0,2006,NA,NA,903,504,399,506,181,325,0.64,0.45,0.56,21518,73,175,622
191931,Iona College,1,0,2007,NA,NA,906,486,420,476,195,281,0.5700000000000001,0.46,0.53,23024,79,174,623
191931,Iona College,1,0,2008,NA,NA,921,498,423,469,167,302,0.6,0.39,0.51,24406,79,176,620
191931,Iona College,1,0,2009,NA,NA,792,480,312,448,150,298,0.62,0.48,0.57,25600,82,181,518
191931,Iona College,1,0,2010,NA,NA,871,504,367,525,202,323,0.64,0.55,0.6,26850,86,185,556
191968,ITHACA COLLEGE,1,0,1991,NA,NA,1638,831,807,1036,477,559,0.67,0.59,0.63,11946,108,399,1519
191968,ITHACA COLLEGE,1,0,1992,NA,NA,1566,832,734,978,425,553,0.66,0.58,0.62,12870,117,414,1455
191968,ITHACA COLLEGE,1,0,1993,NA,NA,1365,721,644,813,345,468,0.64,0.54,0.6,13642,120,414,1266
191968,ITHACA COLLEGE,1,0,1995,NA,NA,1625,878,747,1052,440,612,0.6900000000000001,0.59,0.65,15250,124,391,1472
191968,ITHACA COLLEGE,1,0,1996,NA,NA,1426,820,606,908,355,553,0.67,0.59,0.64,16130,130,371,1302
191968,ITHACA COLLEGE,1,0,1997,NA,NA,1417,801,616,909,362,547,0.68,0.59,0.64,16900,101,374,1286
191968,ITHACA COLLEGE,1,0,1998,NA,NA,1337,759,578,909,379,530,0.6900000000000001,0.66,0.68,17662,109,385,1232
191968,ITHACA COLLEGE,1,0,1999,NA,NA,1586,885,701,1022,418,604,0.68,0.6,0.64,18410,111,393,1411
191968,ITHACA COLLEGE,1,0,2000,NA,NA,1675,940,735,1149,474,675,0.71,0.64,0.69,19192,118,406,1468
191968,ITHACA COLLEGE,1,0,2001,NA,NA,1755,1002,753,1230,501,729,0.72,0.67,0.7,20104,125,419,1569
191968,ITHACA COLLEGE,1,0,2002,NA,NA,1515,896,619,1083,441,642,0.71,0.71,0.71,21102,133,446,1354
191968,ITHACA COLLEGE,1,0,2003,NA,NA,1581,912,669,1118,456,662,0.72,0.68,0.71,22264,142,467,1332
191968,ITHACA COLLEGE,1,0,2004,NA,NA,1458,831,627,1013,411,602,0.72,0.66,0.69,23690,149,451,1242
191968,Ithaca College,1,0,2005,NA,NA,1679,885,794,1117,521,596,0.67,0.66,0.67,25194,156,454,1436
191968,Ithaca College,1,0,2006,NA,NA,1519,819,700,1059,466,593,0.72,0.67,0.7,26832,163,474,1180
191968,Ithaca College,1,0,2007,NA,NA,1794,1055,739,1241,488,753,0.71,0.66,0.69,28670,174,468,1422
191968,Ithaca College,1,0,2008,NA,NA,1441,862,579,1017,397,620,0.71,0.69,0.71,30606,187,472,972
191968,Ithaca College,1,0,2009,NA,NA,2024,1144,880,1390,571,819,0.71,0.65,0.69,32060,188,465,1452
191968,Ithaca College,1,0,2010,NA,NA,1614,869,745,1071,442,629,0.72,0.59,0.66,33630,192,481,1132
192192,KEUKA COLLEGE,1,0,1991,NA,NA,139,112,27,65,15,50,0.44,0.56,0.47,7900,9,41,128
192192,KEUKA COLLEGE,1,0,1992,NA,NA,160,121,39,53,12,41,0.33,0.31,0.33,8770,11,40,154
192192,KEUKA COLLEGE,1,0,1993,NA,NA,172,124,48,47,13,34,0.27,0.27,0.27,9100,11,44,155
192192,KEUKA COLLEGE,1,0,1995,NA,NA,200,154,46,69,10,59,0.38,0.22,0.34,9960,14,52,189
192192,KEUKA COLLEGE,1,0,1996,NA,NA,234,168,66,61,17,44,0.26,0.26,0.26,10490,15,46,217
192192,KEUKA COLLEGE,1,0,1997,NA,NA,141,112,29,69,12,57,0.5,0.41,0.49,11040,13,48,139
192192,KEUKA COLLEGE,1,0,1998,NA,NA,226,180,46,75,15,60,0.33,0.33,0.33,12185,15,46,214
192192,KEUKA COLLEGE,1,0,1999,NA,NA,268,192,76,90,23,67,0.34,0.3,0.34,12730,14,48,236
192192,KEUKA COLLEGE,1,0,2000,NA,NA,281,183,98,83,28,55,0.3,0.29,0.3,13490,15,49,218
192192,KEUKA COLLEGE,1,0,2001,NA,NA,253,188,65,88,14,74,0.39,0.22,0.35,14050,15,51,225
192192,KEUKA COLLEGE,1,0,2002,NA,NA,195,138,57,81,21,60,0.43,0.37,0.42,14890,17,52,167
192192,KEUKA COLLEGE,1,0,2003,NA,NA,239,168,71,107,29,78,0.46,0.41,0.45,15790,18,48,209
192192,KEUKA COLLEGE,1,0,2004,NA,NA,245,170,75,120,29,91,0.53,0.39,0.49,16820,19,50,208
192192,Keuka College,1,0,2005,NA,NA,268,179,89,111,31,80,0.44,0.35,0.41,17800,20,52,229
192192,Keuka College,1,0,2006,NA,NA,232,147,85,106,44,62,0.42,0.52,0.46,18850,23,51,195
192192,Keuka College,1,0,2007,NA,NA,274,192,82,98,28,70,0.36,0.34,0.36,19960,26,53,217
192192,Keuka College,1,0,2008,NA,NA,270,200,70,98,21,77,0.38,0.3,0.36,21140,29,55,220
192192,Keuka College,1,0,2009,NA,NA,254,175,79,57,24,33,0.18,0.3,0.22,22040,30,62,210
192192,Keuka College,1,0,2010,NA,NA,270,196,74,141,32,109,0.55,0.43,0.52,23130,31,75,210
192323,LE MOYNE COLLEGE,1,0,1991,NA,NA,404,212,192,261,118,143,0.67,0.61,0.65,9290,27,122,354
192323,LE MOYNE COLLEGE,1,0,1992,NA,NA,371,215,156,254,105,149,0.6900000000000001,0.67,0.68,9620,31,117,328
192323,LE MOYNE COLLEGE,1,0,1993,NA,NA,415,213,202,254,107,147,0.6900000000000001,0.53,0.61,10640,31,119,362
192323,LE MOYNE COLLEGE,1,0,1995,NA,NA,397,236,161,258,98,160,0.67,0.61,0.65,12015,36,126,329
192323,LE MOYNE COLLEGE,1,0,1996,NA,NA,434,255,179,305,115,190,0.74,0.64,0.7,12750,37,122,395
192323,LE MOYNE COLLEGE,1,0,1997,NA,NA,453,292,161,299,101,198,0.67,0.63,0.66,13520,31,125,389
192323,LE MOYNE COLLEGE,1,0,1998,NA,NA,471,279,192,309,114,195,0.6900000000000001,0.59,0.66,14230,33,121,406
192323,LE MOYNE COLLEGE,1,0,1999,NA,NA,471,264,207,304,121,183,0.6900000000000001,0.58,0.65,14580,34,126,389
192323,LE MOYNE COLLEGE,1,0,2000,NA,NA,510,291,219,298,119,179,0.61,0.54,0.58,15370,37,129,413
192323,LE MOYNE COLLEGE,1,0,2001,NA,NA,502,292,210,311,122,189,0.64,0.58,0.62,16350,40,132,428
192323,LE MOYNE COLLEGE,1,0,2002,NA,NA,561,333,228,388,144,244,0.73,0.63,0.69,17410,42,142,458
192323,LE MOYNE COLLEGE,1,0,2003,NA,NA,503,310,193,323,115,208,0.67,0.6,0.64,18440,46,153,422
192323,LE MOYNE COLLEGE,1,0,2004,NA,NA,473,277,196,305,115,190,0.68,0.59,0.64,19640,48,152,384
192323,Le Moyne College,1,0,2005,NA,NA,519,308,211,320,123,197,0.63,0.58,0.62,20770,49,154,425
192323,Le Moyne College,1,0,2006,NA,NA,544,330,214,329,120,209,0.63,0.56,0.6,21860,53,161,451
192323,Le Moyne College,1,0,2007,NA,NA,577,348,229,362,125,237,0.68,0.55,0.63,23040,56,157,483
192323,Le Moyne College,1,0,2008,NA,NA,541,335,206,331,114,217,0.64,0.55,0.61,24280,59,157,456
192323,Le Moyne College,1,0,2009,NA,NA,605,394,211,344,102,242,0.61,0.48,0.57,25110,60,156,495
192323,Le Moyne College,1,0,2010,NA,NA,615,372,243,355,130,225,0.6,0.53,0.58,26350,61,155,511
192439,LONG ISLAND UNIVERSITY BROOKLYN CAMPUS,1,0,1991,NA,NA,665,436,229,30,12,18,0.04,0.05,0.05,9280,57,554,91
192439,LONG ISLAND UNIVERSITY BROOKLYN CAMPUS,1,0,1992,NA,NA,837,552,285,34,15,19,0.03,0.05,0.04,10670,71,547,156
192439,LONG ISLAND UNIVERSITY-BROOKLYN CAMPUS,1,0,1993,NA,NA,918,633,285,36,13,23,0.03,0.05,0.04,10670,84,561,158
192439,LONG ISLAND UNIVERSITY-BROOKLYN CAMPUS,1,0,1995,NA,NA,1043,700,343,55,17,38,0.05,0.05,0.05,12215,100,568,185
192439,LONG ISLAND UNIVERSITY-BROOKLYN CAMPUS,1,0,1996,NA,NA,956,654,302,51,17,34,0.05,0.06,0.05,12840,96,574,165
192439,LONG ISLAND UNIVERSITY-BROOKLYN CAMPUS,1,0,1997,NA,NA,915,595,320,33,13,20,0.03,0.04,0.04,13570,78,261,147
192439,LONG ISLAND UNIVERSITY-BROOKLYN CAMPUS,1,0,1998,NA,NA,1061,689,372,44,8,36,0.05,0.02,0.04,14310,85,292,130
192439,LONG ISLAND UNIVERSITY-BROOKLYN CAMPUS,1,0,1999,NA,NA,1010,719,291,38,12,26,0.03,0.04,0.04,14340,88,290,152
192439,LONG ISLAND UNIVERSITY-BROOKLYN CAMPUS,1,0,2000,NA,NA,863,578,285,36,9,27,0.04,0.03,0.04,16100,93,283,112
192439,LONG ISLAND UNIVERSITY-BROOKLYN CAMPUS,1,0,2001,NA,NA,825,574,251,55,20,35,0.06,0.08,0.07,17220,103,276,97
192439,LONG ISLAND UNIVERSITY-BROOKLYN CAMPUS,1,0,2002,NA,NA,776,561,215,48,9,39,0.06,0.04,0.06,18250,113,295,85
192439,LONG ISLAND UNIVERSITY-BROOKLYN CAMPUS,1,0,2003,NA,NA,680,480,200,45,10,35,0.07,0.05,0.07,19510,121,304,89
192439,LONG ISLAND UNIVERSITY-BROOKLYN CAMPUS,1,0,2004,NA,NA,912,629,283,39,12,27,0.04,0.04,0.04,21150,127,305,152
192439,Long Island University-Brooklyn Campus,1,0,2005,NA,NA,959,643,316,51,10,41,0.06,0.03,0.05,22048,135,308,175
192439,Long Island University-Brooklyn Campus,1,0,2006,NA,NA,1079,730,349,56,14,42,0.05,0.04,0.05,23328,146,311,200
192439,Long Island University-Brooklyn Campus,1,0,2007,NA,NA,1021,721,300,61,16,45,0.06,0.05,0.06,24672,165,314,166
192439,Long Island University-Brooklyn Campus,1,0,2008,NA,NA,992,706,286,73,18,55,0.07,0.06,0.07,26048,174,304,187
192439,Long Island University-Brooklyn Campus,1,0,2009,NA,NA,1005,692,313,81,19,62,0.08,0.06,0.08,27328,167,307,179
192439,Long Island University-Brooklyn Campus,1,0,2010,NA,NA,883,618,265,58,13,45,0.07,0.05,0.07,25088,174,310,154
192703,MANHATTAN COLLEGE,1,0,1991,NA,NA,548,258,290,298,137,161,0.62,0.47,0.54,11100,48,174,406
192703,MANHATTAN COLLEGE,1,0,1992,NA,NA,577,250,327,244,120,124,0.49,0.37,0.42,11900,56,170,429
192703,MANHATTAN COLLEGE,1,0,1993,NA,NA,546,254,292,307,152,155,0.61,0.52,0.56,12700,57,172,385
192703,MANHATTAN COLLEGE,1,0,1995,NA,NA,572,256,316,321,160,161,0.62,0.51,0.56,14220,54,163,396
192703,MANHATTAN COLLEGE,1,0,1996,NA,NA,557,258,299,313,143,170,0.65,0.48,0.56,14900,54,156,372
192703,MANHATTAN COLLEGE,1,0,1997,NA,NA,527,235,292,269,134,135,0.5700000000000001,0.46,0.51,15500,57,158,363
192703,MANHATTAN COLLEGE,1,0,1998,NA,NA,547,274,273,328,159,169,0.61,0.58,0.6,16100,46,160,358
192703,MANHATTAN COLLEGE,1,0,1999,NA,NA,645,289,356,386,195,191,0.66,0.55,0.6,15500,49,161,473
192703,MANHATTAN COLLEGE,1,0,2000,NA,NA,623,315,308,361,153,208,0.66,0.5,0.58,16000,51,164,442
192703,MANHATTAN COLLEGE,1,0,2001,NA,NA,597,276,321,344,162,182,0.65,0.5,0.58,16500,55,168,441
192703,MANHATTAN COLLEGE,1,0,2002,NA,NA,769,401,368,501,228,273,0.68,0.62,0.65,17100,58,162,549
192703,MANHATTAN COLLEGE,1,0,2003,NA,NA,638,342,296,400,173,227,0.66,0.58,0.63,17800,63,167,502
192703,MANHATTAN COLLEGE,1,0,2004,NA,NA,657,343,314,420,182,238,0.6900000000000001,0.58,0.64,18600,65,169,521
192703,Manhattan College,1,0,2005,NA,NA,700,368,332,456,198,258,0.7000000000000001,0.6,0.65,19400,67,172,555
192703,Manhattan College,1,0,2006,NA,NA,710,353,357,466,234,232,0.65,0.66,0.66,20350,72,171,562
192703,Manhattan College,1,0,2007,NA,NA,708,356,352,427,201,226,0.63,0.57,0.6,21640,75,170,571
192703,Manhattan College,1,0,2008,NA,NA,726,351,375,475,226,249,0.7000000000000001,0.6,0.65,22940,79,180,524
192703,Manhattan College,1,0,2009,NA,NA,693,343,350,412,183,229,0.66,0.52,0.59,25100,86,176,493
192703,Manhattan College,1,0,2010,NA,NA,658,300,358,375,190,185,0.61,0.53,0.57,25335,89,201,465
192749,MANHATTANVILLE COLLEGE,1,0,1991,NA,NA,192,143,49,96,22,74,0.51,0.45,0.5,12760,24,81,123
192749,MANHATTANVILLE COLLEGE,1,0,1992,NA,NA,183,139,44,106,23,83,0.59,0.52,0.58,13605,28,77,103
192749,MANHATTANVILLE COLLEGE,1,0,1993,NA,NA,214,133,81,86,30,56,0.42,0.37,0.4,14450,29,65,132
192749,MANHATTANVILLE COLLEGE,1,0,1995,NA,NA,161,115,46,87,18,69,0.6,0.39,0.54,15500,25,58,89
192749,MANHATTANVILLE COLLEGE,1,0,1996,NA,NA,271,181,90,117,33,84,0.46,0.37,0.43,16120,26,56,148
192749,MANHATTANVILLE COLLEGE,1,0,1997,NA,NA,294,202,92,148,40,108,0.53,0.43,0.5,17300,22,56,146
192749,MANHATTANVILLE COLLEGE,1,0,1998,NA,NA,338,225,113,126,35,91,0.4,0.31,0.37,18130,24,58,184
192749,MANHATTANVILLE COLLEGE,1,0,1999,NA,NA,387,266,121,195,57,138,0.51,0.47,0.5,18130,27,63,230
192749,MANHATTANVILLE COLLEGE,1,0,2000,NA,NA,403,277,126,213,58,155,0.55,0.46,0.53,18860,32,67,241
192749,MANHATTANVILLE COLLEGE,1,0,2001,NA,NA,404,277,127,226,65,161,0.58,0.51,0.56,19620,36,71,243
192749,MANHATTANVILLE COLLEGE,1,0,2002,NA,NA,420,287,133,212,50,162,0.56,0.38,0.5,20600,37,82,249
192749,MANHATTANVILLE COLLEGE,1,0,2003,NA,NA,422,295,127,223,68,155,0.52,0.54,0.53,22150,38,88,240
192749,MANHATTANVILLE COLLEGE,1,0,2004,NA,NA,450,312,138,261,78,183,0.58,0.57,0.58,23620,41,88,259
192749,Manhattanville College,1,0,2005,NA,NA,506,327,179,264,73,191,0.58,0.41,0.52,24920,46,88,316
192749,Manhattanville College,1,0,2006,NA,NA,507,329,178,274,91,183,0.55,0.51,0.54,26920,48,92,289
192749,Manhattanville College,1,0,2007,NA,NA,463,315,148,249,59,190,0.6,0.4,0.54,28540,56,99,229
192749,Manhattanville College,1,0,2008,NA,NA,476,326,150,270,82,188,0.5700000000000001,0.55,0.57,30400,62,100,223
192749,Manhattanville College,1,0,2009,NA,NA,490,298,192,250,86,164,0.55,0.45,0.51,31490,62,101,202
192749,Manhattanville College,1,0,2010,NA,NA,428,274,154,181,57,124,0.45,0.37,0.42,33030,62,103,199
192819,MARIST COLLEGE,1,0,1991,NA,NA,881,489,392,441,166,275,0.56,0.42,0.5,9205,53,142,806
192819,MARIST COLLEGE,1,0,1992,NA,NA,820,451,369,514,201,313,0.6900000000000001,0.54,0.63,9826,61,143,697
192819,MARIST COLLEGE,1,0,1993,NA,NA,806,460,346,371,134,237,0.51,0.39,0.46,10397,65,151,692
192819,MARIST COLLEGE,1,0,1995,NA,NA,926,527,399,472,181,291,0.55,0.45,0.51,11590,73,157,513
192819,MARIST COLLEGE,1,0,1996,NA,NA,839,482,357,510,187,323,0.67,0.52,0.61,12450,65,159,706
192819,MARIST COLLEGE,1,0,1997,NA,NA,973,532,441,570,232,338,0.63,0.53,0.59,13098,55,162,755
192819,MARIST COLLEGE,1,0,1998,NA,NA,834,430,404,547,240,307,0.71,0.59,0.66,13818,58,157,691
192819,MARIST COLLEGE,1,0,1999,NA,NA,975,548,427,665,260,405,0.73,0.61,0.68,14374,63,162,803
192819,MARIST COLLEGE,1,0,2000,NA,NA,993,589,404,690,272,418,0.7000000000000001,0.67,0.69,15366,69,170,860
192819,MARIST COLLEGE,1,0,2001,NA,NA,908,484,424,632,281,351,0.72,0.66,0.7,16364,77,178,764
192819,MARIST COLLEGE,1,0,2002,NA,NA,956,576,380,693,252,441,0.76,0.66,0.72,17444,83,182,781
192819,MARIST COLLEGE,1,0,2003,NA,NA,961,528,433,732,310,422,0.79,0.72,0.76,18432,89,197,807
192819,MARIST COLLEGE,1,0,2004,NA,NA,955,536,419,699,282,417,0.77,0.67,0.73,19540,91,199,728
192819,Marist College,1,0,2005,NA,NA,1017,585,432,697,258,439,0.75,0.6,0.69,20712,93,201,810
192819,Marist College,1,0,2006,NA,NA,1038,573,465,737,309,428,0.74,0.66,0.71,22066,101,204,852
192819,Marist College,1,0,2007,NA,NA,1019,561,458,713,295,418,0.74,0.64,0.7,23560,108,218,754
192819,Marist College,1,0,2008,NA,NA,1018,611,407,697,249,448,0.73,0.61,0.68,25100,121,222,781
192819,Marist College,1,0,2009,NA,NA,1041,577,464,708,279,429,0.74,0.6,0.68,26105,127,219,836
192819,Marist College,1,0,2010,NA,NA,1088,612,476,814,331,483,0.78,0.7,0.75,27150,130,228,886
192925,MEDAILLE COLLEGE,1,0,1991,NA,NA,143,79,64,23,6,17,0.21,0.09,0.16,7180,9,41,82
192925,MEDAILLE COLLEGE,1,0,1992,NA,NA,185,86,99,21,4,17,0.19,0.04,0.11,7750,12,40,110
192925,MEDAILLE COLLEGE,1,0,1993,NA,NA,202,94,108,38,16,22,0.23,0.15,0.19,8350,13,43,124
192925,MEDAILLE COLLEGE,1,0,1995,NA,NA,78,50,28,15,5,10,0.2,0.18,0.19,9560,12,41,60
192925,MEDAILLE COLLEGE,1,0,1996,NA,NA,81,58,23,6,2,4,0.06,0.09,0.07,9990,11,41,55
192925,MEDAILLE COLLEGE,1,0,1997,NA,NA,164,102,62,19,6,13,0.12,0.1,0.12,10470,9,38,121
192925,MEDAILLE COLLEGE,1,0,1998,NA,NA,153,113,40,45,15,30,0.26,0.38,0.29,10950,10,43,101
192925,MEDAILLE COLLEGE,1,0,1999,NA,NA,143,104,39,31,6,25,0.24,0.15,0.22,11190,11,43,115
192925,MEDAILLE COLLEGE,1,0,2000,NA,NA,208,153,55,36,10,26,0.16,0.18,0.17,11700,12,52,148
192925,MEDAILLE COLLEGE,1,0,2001,NA,NA,208,166,42,53,12,41,0.24,0.29,0.25,12240,14,61,161
192925,MEDAILLE COLLEGE,1,0,2002,NA,NA,308,204,104,69,25,44,0.21,0.24,0.22,12720,17,63,199
192925,MEDAILLE COLLEGE,1,0,2003,NA,NA,241,146,95,100,42,58,0.39,0.44,0.41,13350,20,70,184
192925,MEDAILLE COLLEGE,1,0,2004,NA,NA,296,179,117,85,36,49,0.27,0.31,0.29,14010,24,76,233
192925,Medaille College,1,0,2005,NA,NA,203,126,77,62,27,35,0.27,0.35,0.31,15030,30,90,165
192925,Medaille College,1,0,2006,NA,NA,320,198,122,87,38,49,0.24,0.31,0.27,15780,38,97,239
192925,Medaille College,1,0,2007,NA,NA,409,255,154,131,56,75,0.29,0.36,0.32,16590,40,91,308
192925,Medaille College,1,0,2008,NA,NA,408,253,155,105,49,56,0.22,0.32,0.26,17420,40,90,283
192925,Medaille College,1,0,2009,NA,NA,402,257,145,104,35,69,0.26,0.24,0.26,19590,39,81,272
192925,Medaille College,1,0,2010,NA,NA,377,234,143,112,46,66,0.28,0.32,0.3,20570,38,73,259
193016,MERCY COLLEGE - MAIN CAMPUS,1,0,1991,NA,NA,619,329,290,19,5,14,0.04,0.02,0.03,6990,31,150,153
193016,MERCY COLLEGE-MAIN CAMPUS,1,0,1992,NA,NA,867,534,333,19,7,12,0.02,0.02,0.02,7200,41,147,230
193016,MERCY COLLEGE-MAIN CAMPUS,1,0,1993,NA,NA,733,403,330,16,6,10,0.02,0.02,0.02,7380,40,149,124
193016,MERCY COLLEGE-MAIN CAMPUS,1,0,1995,NA,NA,1002,623,379,4,2,2,0,0.01,0,6600,49,146,429
193016,MERCY COLLEGE-MAIN CAMPUS,1,0,1996,NA,NA,551,336,215,62,12,50,0.14,0.06,0.11,7200,50,150,143
193016,MERCY COLLEGE-MAIN CAMPUS,1,0,1997,NA,NA,1052,692,360,46,16,30,0.04,0.04,0.04,7600,53,153,271
193016,MERCY COLLEGE-MAIN CAMPUS,1,0,1998,NA,NA,907,582,325,53,14,39,0.06,0.04,0.06,7800,59,178,161
193016,MERCY COLLEGE-MAIN CAMPUS,1,0,1999,NA,NA,953,630,323,68,18,50,0.07,0.06,0.07,7950,58,181,115
193016,MERCY COLLEGE-MAIN CAMPUS,1,0,2000,NA,NA,637,421,216,69,10,59,0.14,0.05,0.11,8500,62,195,94
193016,MERCY COLLEGE-MAIN CAMPUS,1,0,2001,NA,NA,618,412,206,61,10,51,0.12,0.05,0.1,8950,70,209,95
193016,MERCY COLLEGE-MAIN CAMPUS,1,0,2002,NA,NA,680,425,255,69,14,55,0.12,0.05,0.1,10000,76,230,140
193016,MERCY COLLEGE-MAIN CAMPUS,1,0,2003,NA,NA,611,379,232,58,10,48,0.12,0.04,0.09,10700,83,228,132
193016,MERCY COLLEGE-MAIN CAMPUS,1,0,2004,NA,NA,649,421,228,79,18,61,0.14,0.08,0.12,11230,91,223,165
193016,Mercy College-Main Campus,1,0,2005,NA,NA,485,324,161,53,11,42,0.12,0.07,0.11,11792,89,175,102
193016,Mercy College-Main Campus,1,0,2006,NA,NA,614,390,224,79,22,57,0.14,0.1,0.13,12370,94,183,152
193016,Mercy College-Main Campus,1,0,2007,NA,NA,532,343,189,111,21,90,0.26,0.11,0.21,13730,94,180,185
193016,Mercy College,1,0,2008,NA,NA,677,441,236,92,14,78,0.17,0.06,0.14,14990,95,169,178
193016,Mercy College,1,0,2009,NA,NA,880,552,328,157,39,118,0.21,0.12,0.18,15990,94,193,248
193016,Mercy College,1,0,2010,NA,NA,1086,708,378,212,45,167,0.23,0.12,0.2,16490,103,199,247
193292,MOLLOY COLLEGE,1,0,1991,NA,NA,123,100,23,55,6,49,0.49,0.26,0.45,7800,13,89,102
193292,MOLLOY COLLEGE,1,0,1992,NA,NA,1417,1055,362,65,7,58,0.05,0.02,0.05,8390,23,102,929
193292,MOLLOY COLLEGE,1,0,1993,NA,NA,175,139,36,74,8,66,0.47000000000000003,0.22,0.42,8700,24,116,138
193292,MOLLOY COLLEGE,1,0,1995,NA,NA,135,108,27,30,5,25,0.23,0.19,0.22,9700,21,136,109
193292,MOLLOY COLLEGE,1,0,1996,NA,NA,183,125,58,21,5,16,0.12,0.09,0.11,10000,22,147,139
193292,MOLLOY COLLEGE,1,0,1997,NA,NA,156,112,44,46,6,40,0.35000000000000003,0.14,0.29,10400,24,70,127
193292,MOLLOY COLLEGE,1,0,1998,NA,NA,180,117,63,72,21,51,0.43,0.33,0.4,11270,25,148,146
193292,MOLLOY COLLEGE,1,0,1999,NA,NA,209,156,53,84,11,73,0.46,0.21,0.4,11900,26,137,159
193292,MOLLOY COLLEGE,1,0,2000,NA,NA,195,133,62,56,13,43,0.32,0.21,0.29,12500,22,132,140
193292,MOLLOY COLLEGE,1,0,2001,NA,NA,210,145,65,66,16,50,0.34,0.25,0.31,13190,22,128,153
193292,MOLLOY COLLEGE,1,0,2002,NA,NA,229,168,61,77,19,58,0.34,0.31,0.34,13940,24,134,151
193292,MOLLOY COLLEGE,1,0,2003,NA,NA,262,185,77,89,29,60,0.32,0.38,0.34,14430,27,137,181
193292,MOLLOY COLLEGE,1,0,2004,NA,NA,311,231,80,105,17,88,0.38,0.21,0.34,15150,30,142,206
193292,Molloy College,1,0,2005,NA,NA,274,190,84,109,31,78,0.41000000000000003,0.37,0.4,15760,39,147,194
193292,Molloy College,1,0,2006,NA,NA,269,196,73,90,22,68,0.34,0.3,0.33,16560,44,158,172
193292,Molloy College,1,0,2007,NA,NA,370,282,88,140,31,109,0.38,0.35,0.38,17640,50,162,246
193292,Molloy College,1,0,2008,NA,NA,393,288,105,156,32,124,0.43,0.3,0.4,18700,53,163,271
193292,Molloy College,1,0,2009,NA,NA,414,307,107,189,42,147,0.47000000000000003,0.39,0.46,19970,58,169,269
193292,Molloy College,1,0,2010,NA,NA,387,257,130,180,59,121,0.47000000000000003,0.45,0.47,21170,63,173,271
193353,MOUNT SAINT MARY COLLEGE,1,0,1991,NA,NA,248,188,60,96,16,80,0.42,0.27,0.39,7020,13,48,208
193353,MOUNT SAINT MARY COLLEGE,1,0,1992,NA,NA,254,180,74,97,25,72,0.4,0.34,0.38,7810,15,48,218
193353,MOUNT SAINT MARY COLLEGE,1,0,1993,NA,NA,239,164,75,90,29,61,0.37,0.39,0.38,8110,18,51,195
193353,MOUNT SAINT MARY COLLEGE,1,0,1995,NA,NA,258,196,62,114,24,90,0.45,0.39,0.44,8955,19,53,207
193353,MOUNT SAINT MARY COLLEGE,1,0,1996,NA,NA,266,199,67,105,20,85,0.42,0.3,0.39,9495,20,54,226
193353,MOUNT SAINT MARY COLLEGE,1,0,1997,NA,NA,260,177,83,121,43,78,0.44,0.52,0.47,10215,17,53,202
193353,MOUNT SAINT MARY COLLEGE,1,0,1998,NA,NA,304,230,74,122,27,95,0.41000000000000003,0.36,0.4,10855,18,52,239
193353,MOUNT SAINT MARY COLLEGE,1,0,1999,NA,NA,323,247,76,156,25,131,0.53,0.33,0.48,11100,19,53,253
193353,MOUNT SAINT MARY COLLEGE,1,0,2000,NA,NA,328,251,77,124,15,109,0.43,0.19,0.38,11580,21,56,266
193353,MOUNT SAINT MARY COLLEGE,1,0,2001,NA,NA,343,239,104,143,33,110,0.46,0.32,0.42,12270,23,59,282
193353,MOUNT SAINT MARY COLLEGE,1,0,2002,NA,NA,361,261,100,151,33,118,0.45,0.33,0.42,12930,26,62,291
193353,MOUNT SAINT MARY COLLEGE,1,0,2003,NA,NA,347,246,101,137,31,106,0.43,0.31,0.39,13830,29,67,285
193353,MOUNT SAINT MARY COLLEGE,1,0,2004,NA,NA,419,314,105,180,45,135,0.42,0.43,0.43,15180,31,67,345
193353,Mount Saint Mary College,1,0,2005,NA,NA,356,247,109,154,45,109,0.44,0.41,0.43,16410,35,71,285
193353,Mount Saint Mary College,1,0,2006,NA,NA,400,295,105,162,41,121,0.41000000000000003,0.39,0.41,17730,36,73,308
193353,Mount Saint Mary College,1,0,2007,NA,NA,364,252,112,150,31,119,0.47000000000000003,0.28,0.41,18900,38,74,307
193353,Mount Saint Mary College,1,0,2008,NA,NA,432,318,114,191,50,141,0.44,0.44,0.44,20040,43,76,334
193353,Mount Saint Mary College,1,0,2009,NA,NA,474,362,112,217,42,175,0.48,0.38,0.46,21210,45,81,383
193353,Mount Saint Mary College,1,0,2010,NA,NA,443,301,142,187,60,127,0.42,0.42,0.42,22350,48,85,340
193399,COLLEGE OF MOUNT SAINT VINCENT,1,0,1991,NA,NA,188,147,41,91,20,71,0.48,0.49,0.48,9810,12,50,107
193399,COLLEGE OF MOUNT SAINT VINCENT,1,0,1992,NA,NA,185,153,32,88,12,76,0.49,0.38,0.48,10460,14,51,100
193399,COLLEGE OF MOUNT SAINT VINCENT,1,0,1993,NA,NA,174,136,38,71,9,62,0.45,0.24,0.41,11190,14,49,104
193399,COLLEGE OF MOUNT SAINT VINCENT,1,0,1995,NA,NA,217,164,53,107,27,80,0.48,0.51,0.49,12450,19,71,115
193399,COLLEGE OF MOUNT SAINT VINCENT,1,0,1996,NA,NA,208,162,46,111,26,85,0.52,0.57,0.53,13060,19,56,95
193399,COLLEGE OF MOUNT SAINT VINCENT,1,0,1997,NA,NA,225,168,57,95,18,77,0.45,0.32,0.42,13580,21,61,97
193399,COLLEGE OF MOUNT SAINT VINCENT,1,0,1998,NA,NA,266,200,66,124,26,98,0.49,0.39,0.47,14360,21,61,92
193399,COLLEGE OF MOUNT SAINT VINCENT,1,0,1999,NA,NA,240,167,73,76,18,58,0.34,0.25,0.32,14910,19,65,82
193399,COLLEGE OF MOUNT SAINT VINCENT,1,0,2000,NA,NA,236,174,62,83,16,67,0.38,0.26,0.35,16030,19,68,77
193399,COLLEGE OF MOUNT SAINT VINCENT,1,0,2001,NA,NA,286,214,72,111,21,90,0.42,0.29,0.39,17030,21,72,101
193399,COLLEGE OF MOUNT SAINT VINCENT,1,0,2002,NA,NA,326,239,87,128,21,107,0.44,0.24,0.39,17880,21,69,140
193399,COLLEGE OF MOUNT SAINT VINCENT,1,0,2003,NA,NA,336,272,64,136,13,123,0.45,0.2,0.4,18600,22,70,155
193399,COLLEGE OF MOUNT SAINT VINCENT,1,0,2004,NA,NA,355,229,126,166,53,113,0.49,0.42,0.47,19100,25,73,177
193399,College of Mount Saint Vincent,1,0,2005,NA,NA,343,247,96,136,32,104,0.42,0.33,0.4,19950,26,74,168
193399,College of Mount Saint Vincent,1,0,2006,NA,NA,390,294,96,159,37,122,0.41000000000000003,0.39,0.41,21000,27,72,153
193399,College of Mount Saint Vincent,1,0,2007,NA,NA,394,272,122,144,39,105,0.38,0.32,0.37,22150,29,73,152
193399,College of Mount Saint Vincent,1,0,2008,NA,NA,374,267,107,146,34,112,0.41000000000000003,0.32,0.39,23270,33,74,151
193399,College of Mount Saint Vincent,1,0,2009,NA,NA,390,275,115,131,30,101,0.36,0.26,0.34,24400,34,73,132
193399,College of Mount Saint Vincent,1,0,2010,NA,NA,377,249,128,147,41,106,0.42,0.32,0.39,25600,35,73,115
193584,NAZARETH COLLEGE OF ROCHESTER,1,0,1991,NA,NA,246,177,69,124,27,97,0.54,0.39,0.5,8940,23,102,228
193584,NAZARETH COLLEGE OF ROCHESTER,1,0,1992,NA,NA,211,159,52,129,24,105,0.66,0.46,0.61,9790,27,105,195
193584,NAZARETH COLLEGE OF ROCHESTER,1,0,1993,NA,NA,266,192,74,142,29,113,0.58,0.39,0.53,10390,27,105,252
193584,NAZARETH COLLEGE OF ROCHESTER,1,0,1995,NA,NA,302,227,75,182,36,146,0.64,0.48,0.6,11380,31,104,284
193584,NAZARETH COLLEGE OF ROCHESTER,1,0,1996,NA,NA,337,242,95,208,55,153,0.63,0.58,0.62,12130,33,106,310
193584,NAZARETH COLLEGE OF ROCHESTER,1,0,1997,NA,NA,351,257,94,214,59,155,0.6,0.63,0.61,12966,28,111,327
193584,NAZARETH COLLEGE OF ROCHESTER,1,0,1998,NA,NA,321,246,75,199,38,161,0.65,0.51,0.62,13526,30,111,296
193584,NAZARETH COLLEGE OF ROCHESTER,1,0,1999,NA,NA,334,244,90,205,51,154,0.63,0.57,0.61,13620,32,120,304
193584,NAZARETH COLLEGE OF ROCHESTER,1,0,2000,NA,NA,402,304,98,244,56,188,0.61,0.57,0.61,14230,34,126,368
193584,NAZARETH COLLEGE OF ROCHESTER,1,0,2001,NA,NA,358,274,84,239,50,189,0.68,0.6,0.67,14940,37,132,329
193584,NAZARETH COLLEGE OF ROCHESTER,1,0,2002,NA,NA,385,292,93,230,49,181,0.61,0.53,0.6,15910,40,134,335
193584,NAZARETH COLLEGE OF ROCHESTER,1,0,2003,NA,NA,383,284,99,236,54,182,0.64,0.55,0.62,17020,44,137,325
193584,NAZARETH COLLEGE OF ROCHESTER,1,0,2004,NA,NA,449,335,114,285,60,225,0.67,0.53,0.63,18040,46,136,377
193584,Nazareth College of Rochester,1,0,2005,NA,NA,451,342,109,303,56,247,0.72,0.51,0.67,19214,49,135,392
193584,Nazareth College of Rochester,1,0,2006,NA,NA,481,364,117,293,62,231,0.63,0.53,0.61,20656,52,144,419
193584,Nazareth College of Rochester,1,0,2007,NA,NA,456,335,121,268,60,208,0.62,0.5,0.59,21844,56,152,374
193584,Nazareth College,1,0,2008,NA,NA,471,361,110,306,62,244,0.67,0.56,0.65,23046,60,156,381
193584,Nazareth College,1,0,2009,NA,NA,491,387,104,315,68,247,0.63,0.65,0.64,24082,64,156,386
193584,Nazareth College,1,0,2010,NA,NA,467,353,114,273,60,213,0.6,0.53,0.58,25046,68,160,331
193645,COLLEGE OF NEW ROCHELLE,1,0,1991,NA,NA,645,563,82,93,2,91,0.16,0.02,0.14,10050,34,75,86
193645,COLLEGE OF NEW ROCHELLE,1,0,1992,NA,NA,935,777,158,85,7,78,0.1,0.04,0.09,10200,41,71,72
193645,COLLEGE OF NEW ROCHELLE,1,0,1993,NA,NA,821,677,144,89,14,75,0.11,0.1,0.11,10600,37,67,88
193645,COLLEGE OF NEW ROCHELLE,1,0,1995,NA,NA,718,595,123,120,13,107,0.17,0.11,0.17,12200,45,67,65
193645,COLLEGE OF NEW ROCHELLE,1,0,1996,NA,NA,931,787,144,129,13,116,0.14,0.09,0.14,11000,48,68,41
193645,COLLEGE OF NEW ROCHELLE,1,0,1997,NA,NA,758,643,115,165,18,147,0.22,0.16,0.22,11000,38,72,53
193645,COLLEGE OF NEW ROCHELLE,1,0,1998,NA,NA,852,738,114,161,11,150,0.2,0.1,0.19,11300,42,79,58
193645,COLLEGE OF NEW ROCHELLE,1,0,1999,NA,NA,814,670,144,152,16,136,0.2,0.11,0.19,11600,41,74,58
193645,THE COLLEGE OF NEW ROCHELLE,1,0,2000,NA,NA,755,662,93,159,13,146,0.22,0.14,0.21,11900,44,90,48
193645,THE COLLEGE OF NEW ROCHELLE,1,0,2001,NA,NA,774,650,124,169,13,156,0.24,0.1,0.22,12320,45,107,39
193645,THE COLLEGE OF NEW ROCHELLE,1,0,2002,NA,NA,850,733,117,151,12,139,0.18,0.1,0.18,13000,47,112,16
193645,THE COLLEGE OF NEW ROCHELLE,1,0,2003,NA,NA,769,668,101,121,5,116,0.17,0.05,0.16,14400,48,117,39
193645,THE COLLEGE OF NEW ROCHELLE,1,0,2004,NA,NA,952,815,137,152,11,141,0.17,0.08,0.16,16500,53,122,32
193645,The College of New Rochelle,1,0,2005,NA,NA,943,883,60,168,1,167,0.18,0.02,0.18,17950,54,107,32
193645,The College of New Rochelle,1,0,2006,NA,NA,821,757,64,133,6,127,0.16,0.09,0.16,20800,56,106,33
193645,The College of New Rochelle,1,0,2007,NA,NA,805,733,72,126,2,124,0.16,0.03,0.16,23200,57,110,25
193645,The College of New Rochelle,1,0,2008,NA,NA,504,461,43,86,2,84,0.18,0.05,0.17,24592,59,108,26
193645,The College of New Rochelle,1,0,2009,NA,NA,530,465,65,86,8,78,0.16,0.12,0.16,25576,60,102,15
193645,The College of New Rochelle,1,0,2010,NA,NA,635,566,69,140,10,130,0.22,0.14,0.22,27110,56,108,19
193654,NEW SCHOOL FOR SOCIAL RESEARCH,1,0,1991,NA,NA,265,182,83,81,25,56,0.3,0.3,0.31,12200,74,117,105
193654,NEW SCHOOL FOR SOCIAL RESEARCH,1,0,1992,NA,NA,423,275,148,155,41,114,0.41000000000000003,0.28,0.37,12600,80,114,171
193654,NEW SCHOOL FOR SOCIAL RESEARCH,1,0,1993,NA,NA,441,282,159,142,50,92,0.32,0.31,0.32,14210,86,123,174
193654,NEW SCHOOL FOR SOCIAL RESEARCH,1,0,1995,NA,NA,445,275,170,178,54,124,0.45,0.32,0.4,16070,104,148,161
193654,NEW SCHOOL FOR SOCIAL RESEARCH,1,0,1996,NA,NA,401,272,129,132,27,105,0.38,0.21,0.33,17660,109,140,159
193654,NEW SCHOOL FOR SOCIAL RESEARCH,1,0,1997,NA,NA,465,308,157,205,56,149,0.48,0.36,0.44,18200,105,131,182
193654,NEW SCHOOL FOR SOCIAL RESEARCH,1,0,1998,NA,NA,581,394,187,240,51,189,0.47000000000000003,0.27,0.41,19370,112,133,213
193654,NEW SCHOOL UNIVERSITY,1,0,1999,NA,NA,573,399,174,234,55,179,0.44,0.32,0.41,20410,122,144,219
193654,NEW SCHOOL UNIVERSITY,1,0,2000,NA,NA,595,402,193,245,69,176,0.43,0.36,0.41,20600,128,150,245
193654,NEW SCHOOL UNIVERSITY,1,0,2001,NA,NA,617,422,195,269,74,195,0.46,0.38,0.44,22630,140,156,263
193654,NEW SCHOOL UNIVERSITY,1,0,2002,NA,NA,605,415,190,328,89,239,0.5700000000000001,0.47,0.54,23900,152,145,255
193654,NEW SCHOOL UNIVERSITY,1,0,2003,NA,NA,581,409,172,288,81,207,0.5,0.47,0.5,25330,167,159,248
193654,NEW SCHOOL UNIVERSITY,1,0,2004,NA,NA,815,612,203,371,86,285,0.46,0.42,0.46,26820,182,196,339
193654,The New School,1,0,2005,NA,NA,789,558,231,355,86,269,0.48,0.37,0.45,28560,196,226,336
193654,The New School,1,0,2006,NA,NA,883,622,261,409,110,299,0.48,0.42,0.46,28853,219,269,375
193654,The New School,1,0,2007,NA,NA,999,740,259,482,118,364,0.49,0.46,0.48,30550,232,306,416
193654,The New School,1,0,2008,NA,NA,1058,746,312,482,113,369,0.49,0.36,0.46,32695,256,334,400
193654,The New School,1,0,2009,NA,NA,1136,836,300,533,113,420,0.5,0.38,0.47,34081,265,370,422
193654,The New School,1,0,2010,NA,NA,1166,859,307,603,139,464,0.54,0.45,0.52,35607,281,415,441
193900,NEW YORK UNIVERSITY,1,0,1991,NA,NA,2338,1279,1059,1173,508,665,0.51,0.48,0.5,15620,1175,1225,1303
193900,NEW YORK UNIVERSITY,1,0,1992,NA,NA,2669,1511,1158,1355,571,784,0.51,0.49,0.51,16650,1277,1222,1278
193900,NEW YORK UNIVERSITY,1,0,1993,NA,NA,2752,1592,1160,1395,546,849,0.53,0.47,0.51,17640,1339,1231,1423
193900,NEW YORK UNIVERSITY,1,0,1995,NA,NA,3156,1851,1305,1652,681,971,0.52,0.52,0.52,19748,1539,2346,1569
193900,NEW YORK UNIVERSITY,1,0,1996,NA,NA,3393,2002,1391,1838,770,1068,0.53,0.55,0.54,20756,1637,2238,1489
193900,NEW YORK UNIVERSITY,1,0,1997,NA,NA,3557,2054,1503,1963,775,1188,0.5700000000000001,0.52,0.55,21730,1599,2353,1409
193900,NEW YORK UNIVERSITY,1,0,1998,NA,NA,3722,2224,1498,2028,805,1223,0.54,0.54,0.54,22586,1297,2808,1432
193900,NEW YORK UNIVERSITY,1,0,1999,NA,NA,3845,2323,1522,2245,868,1377,0.59,0.57,0.58,22256,1402,2414,1535
193900,NEW YORK UNIVERSITY,1,0,2000,NA,NA,3966,2424,1542,2416,966,1450,0.59,0.63,0.61,23090,1498,2596,1571
193900,NEW YORK UNIVERSITY,1,0,2001,NA,NA,4136,2525,1611,2574,1016,1558,0.61,0.63,0.62,23986,1687,2778,1844
193900,NEW YORK UNIVERSITY,1,0,2002,NA,NA,4126,2577,1549,2564,963,1601,0.62,0.62,0.62,24950,1849,1790,2160
193900,NEW YORK UNIVERSITY,1,0,2003,NA,NA,4203,2563,1640,2664,1069,1595,0.62,0.65,0.63,26766,2021,1906,1867
193900,NEW YORK UNIVERSITY,1,0,2004,NA,NA,4568,2792,1776,2860,1121,1739,0.62,0.63,0.63,28328,2049,2010,2331
193900,New York University,1,0,2005,NA,NA,4639,2853,1786,2941,1168,1773,0.62,0.65,0.63,29890,2236,2043,2439
193900,New York University,1,0,2006,NA,NA,4704,2895,1809,2879,1141,1738,0.6,0.63,0.61,31534,2402,2152,2445
193900,New York University,1,0,2007,NA,NA,4884,3064,1820,2973,1082,1891,0.61,0.59,0.61,33268,2603,2231,2462
193900,New York University,1,0,2008,NA,NA,4786,2738,2048,2740,1134,1606,0.58,0.55,0.57,35230,2841,2311,2182
193900,New York University,1,0,2009,NA,NA,5367,3037,2330,3359,1449,1910,0.62,0.62,0.63,36586,3050,2377,2245
193900,New York University,1,0,2010,NA,NA,5434,3100,2334,3417,1477,1940,0.62,0.63,0.63,37866,3196,2462,2301
193973,NIAGARA UNIVERSITY,1,0,1991,NA,NA,447,272,175,176,53,123,0.45,0.3,0.39,9030,31,116,367
193973,NIAGARA UNIVERSITY,1,0,1992,NA,NA,517,334,183,184,60,124,0.37,0.33,0.36,9523,34,110,445
193973,NIAGARA UNIVERSITY,1,0,1993,NA,NA,432,259,173,202,68,134,0.51,0.39,0.47,10070,34,108,359
193973,NIAGARA UNIVERSITY,1,0,1995,NA,NA,424,264,160,204,67,137,0.51,0.42,0.48,11560,37,116,327
193973,NIAGARA UNIVERSITY,1,0,1996,NA,NA,552,314,238,253,107,146,0.46,0.45,0.46,12256,41,118,458
193973,NIAGARA UNIVERSITY,1,0,1997,NA,NA,705,417,288,299,102,197,0.47000000000000003,0.35,0.42,12890,34,118,576
193973,NIAGARA UNIVERSITY,1,0,1998,NA,NA,543,332,211,271,93,178,0.53,0.44,0.5,13406,35,119,449
193973,NIAGARA UNIVERSITY,1,0,1999,NA,NA,575,345,230,315,127,188,0.54,0.55,0.55,13400,37,120,500
193973,NIAGARA UNIVERSITY,1,0,2000,NA,NA,628,371,257,350,122,228,0.61,0.47,0.56,14000,38,124,527
193973,NIAGARA UNIVERSITY,1,0,2001,NA,NA,598,362,236,322,117,205,0.56,0.5,0.54,14700,40,128,497
193973,NIAGARA UNIVERSITY,1,0,2002,NA,NA,735,440,295,409,148,261,0.59,0.5,0.56,15900,45,134,604
193973,NIAGARA UNIVERSITY,1,0,2003,NA,NA,686,417,269,403,152,251,0.6,0.57,0.59,16700,51,131,568
193973,NIAGARA UNIVERSITY,1,0,2004,NA,NA,725,467,258,443,141,302,0.64,0.55,0.61,17700,53,131,604
193973,Niagara University,1,0,2005,NA,NA,730,444,286,435,160,275,0.61,0.56,0.6,19000,57,136,626
193973,Niagara University,1,0,2006,NA,NA,705,421,284,437,169,268,0.63,0.6,0.62,20400,61,142,606
193973,Niagara University,1,0,2007,NA,NA,737,435,302,440,164,276,0.63,0.54,0.6,21400,63,149,476
193973,Niagara University,1,0,2008,NA,NA,738,454,284,435,146,289,0.63,0.51,0.59,22500,69,153,582
193973,Niagara University,1,0,2009,NA,NA,671,404,267,378,141,237,0.58,0.53,0.56,23700,72,148,547
193973,Niagara University,1,0,2010,NA,NA,668,377,291,397,163,234,0.62,0.56,0.59,24600,71,156,521
194161,NYACK COLLEGE,1,0,1991,NA,NA,108,77,31,26,4,22,0.28,0.13,0.24,7100,9,48,61
194161,NYACK COLLEGE,1,0,1992,NA,NA,104,60,44,37,14,23,0.38,0.32,0.36,7910,11,47,60
194161,NYACK COLLEGE,1,0,1993,NA,NA,109,69,40,30,8,22,0.31,0.2,0.28,8400,13,44,72
194161,NYACK COLLEGE,1,0,1995,NA,NA,160,92,68,56,21,35,0.38,0.31,0.35,9450,15,43,72
194161,NYACK COLLEGE,1,0,1996,NA,NA,208,129,79,69,23,46,0.35000000000000003,0.29,0.33,10360,15,43,143
194161,NYACK COLLEGE,1,0,1997,NA,NA,208,114,94,46,17,29,0.25,0.18,0.22,11100,15,50,126
194161,NYACK COLLEGE,1,0,1998,NA,NA,258,159,99,73,20,53,0.33,0.2,0.28,11650,17,56,133
194161,NYACK COLLEGE,1,0,1999,NA,NA,322,182,140,107,39,68,0.37,0.28,0.33,11440,18,61,149
194161,NYACK COLLEGE,1,0,2000,NA,NA,373,233,140,105,35,70,0.3,0.25,0.28,11990,21,69,141
194161,NYACK COLLEGE,1,0,2001,NA,NA,320,206,114,103,35,68,0.33,0.31,0.32,12480,26,78,131
194161,NYACK COLLEGE,1,0,2002,NA,NA,295,183,112,109,40,69,0.37,0.36,0.37,12990,29,84,133
194161,NYACK COLLEGE,1,0,2003,NA,NA,267,166,101,79,26,53,0.31,0.26,0.3,13500,31,86,122
194161,NYACK COLLEGE,1,0,2004,NA,NA,260,162,98,78,29,49,0.3,0.3,0.3,13990,33,91,96
194161,Nyack College,1,0,2005,NA,NA,256,137,119,60,21,39,0.28,0.18,0.23,14750,37,102,105
194161,Nyack College,1,0,2006,NA,NA,308,178,130,85,30,55,0.3,0.23,0.28,15400,39,102,113
194161,Nyack College,1,0,2007,NA,NA,304,172,132,74,22,52,0.3,0.17,0.24,15800,41,97,99
194161,Nyack College,1,0,2008,NA,NA,253,140,113,61,22,39,0.27,0.19,0.24,17500,43,90,83
194161,Nyack College,1,0,2009,NA,NA,260,151,109,68,26,42,0.27,0.24,0.26,18500,42,100,69
194161,Nyack College,1,0,2010,NA,NA,314,181,133,67,28,39,0.21,0.21,0.21,19500,43,110,82
194310,PACE UNIVERSITY-NEW YORK,1,0,1991,NA,NA,510,290,220,178,56,122,0.42,0.25,0.35,9494,140,449,366
194310,PACE UNIVERSITY-NEW YORK,1,0,1992,NA,NA,543,357,186,151,42,109,0.3,0.23,0.28,10100,152,431,192
194310,PACE UNIVERSITY-NEW YORK,1,0,1993,NA,NA,659,430,229,228,64,164,0.38,0.28,0.35,10780,155,437,256
194310,PACE UNIVERSITY-NEW YORK,1,0,1995,NA,NA,1139,681,458,420,139,281,0.41000000000000003,0.3,0.37,12120,180,451,498
194310,PACE UNIVERSITY-NEW YORK,1,0,1996,NA,NA,1388,788,600,487,180,307,0.38,0.3,0.35,13080,192,210,670
194310,PACE UNIVERSITY-NEW YORK,1,0,1997,NA,NA,1476,859,617,588,203,385,0.44,0.33,0.4,13820,70,200,723
194310,PACE UNIVERSITY-NEW YORK,1,0,1998,NA,NA,1536,911,625,602,220,382,0.41000000000000003,0.35,0.39,14690,168,200,697
194310,PACE UNIVERSITY-NEW YORK,1,0,1999,NA,NA,1500,895,605,604,205,399,0.44,0.34,0.4,15130,179,209,646
194310,PACE UNIVERSITY-NEW YORK,1,0,2000,NA,NA,1602,976,626,612,204,408,0.41000000000000003,0.33,0.38,15870,175,319,713
194310,PACE UNIVERSITY-NEW YORK,1,0,2001,NA,NA,1573,948,625,567,192,375,0.39,0.31,0.36,16650,204,429,607
194310,PACE UNIVERSITY-NEW YORK,1,0,2002,NA,NA,1508,916,592,592,190,402,0.43,0.32,0.39,17800,211,432,686
194310,PACE UNIVERSITY-NEW YORK,1,0,2003,NA,NA,1553,997,556,653,214,439,0.44,0.38,0.42,20540,225,426,783
194310,PACE UNIVERSITY-NEW YORK,1,0,2004,NA,NA,1437,900,537,577,194,383,0.42,0.36,0.4,22100,239,448,663
194310,Pace University-New York,1,0,2005,NA,NA,1474,954,520,584,186,398,0.41000000000000003,0.36,0.4,24752,258,474,741
194310,Pace University-New York,1,0,2006,NA,NA,1131,738,393,441,126,315,0.42,0.32,0.39,29454,274,460,589
194310,Pace University-New York,1,0,2007,NA,NA,1537,937,600,528,183,345,0.36,0.3,0.34,29454,280,416,696
194310,Pace University-New York,1,0,2008,NA,NA,1616,1002,614,589,208,381,0.38,0.34,0.36,30632,266,415,717
194310,Pace University-New York,1,0,2009,NA,NA,1637,1036,601,603,194,409,0.39,0.32,0.37,31860,280,416,768
194310,Pace University-New York,1,0,2010,NA,NA,1766,1089,677,696,240,456,0.41000000000000003,0.35,0.39,32656,277,414,491
194824,RENSSELAER POLYTECHNIC INSTITUTE,1,0,1991,NA,NA,971,193,778,428,334,94,0.48,0.43,0.44,15633,174,374,669
194824,RENSSELAER POLYTECHNIC INSTITUTE,1,0,1992,NA,NA,1083,216,867,483,368,115,0.53,0.42,0.45,16402,186,369,762
194824,RENSSELAER POLYTECHNIC INSTITUTE,1,0,1993,NA,NA,936,168,768,408,303,105,0.62,0.39,0.44,17335,186,369,638
194824,RENSSELAER POLYTECHNIC INSTITUTE,1,0,1995,NA,NA,962,243,719,425,296,129,0.53,0.41,0.44,18656,184,333,725
194824,RENSSELAER POLYTECHNIC INSTITUTE,1,0,1996,NA,NA,898,225,673,454,318,136,0.6,0.47,0.51,19685,185,336,654
194824,RENSSELAER POLYTECHNIC INSTITUTE,1,0,1997,NA,NA,1069,267,802,584,414,170,0.63,0.52,0.55,20960,178,326,719
194824,RENSSELAER POLYTECHNIC INSTITUTE,1,0,1998,NA,NA,1138,258,880,654,483,171,0.66,0.55,0.57,21655,179,340,765
194824,RENSSELAER POLYTECHNIC INSTITUTE,1,0,1999,NA,NA,1323,295,1028,812,611,201,0.68,0.59,0.61,22300,194,343,928
194824,RENSSELAER POLYTECHNIC INSTITUTE,1,0,2000,NA,NA,1303,334,969,833,603,230,0.68,0.62,0.64,23525,217,386,871
194824,RENSSELAER POLYTECHNIC INSTITUTE,1,0,2001,NA,NA,1109,283,826,730,532,198,0.6900000000000001,0.64,0.66,24820,233,429,770
194824,RENSSELAER POLYTECHNIC INSTITUTE,1,0,2002,NA,NA,1047,263,784,672,490,182,0.6900000000000001,0.62,0.64,26400,248,399,751
194824,RENSSELAER POLYTECHNIC INSTITUTE,1,0,2003,NA,NA,1341,320,1021,856,626,230,0.71,0.61,0.64,27700,279,407,973
194824,RENSSELAER POLYTECHNIC INSTITUTE,1,0,2004,NA,NA,1079,259,820,696,521,175,0.67,0.64,0.65,28950,296,405,792
194824,Rensselaer Polytechnic Institute,1,0,2005,NA,NA,1236,283,953,745,550,195,0.68,0.58,0.6,31000,309,400,937
194824,Rensselaer Polytechnic Institute,1,0,2006,NA,NA,1269,362,907,766,544,222,0.61,0.6,0.6,32600,335,393,966
194824,Rensselaer Polytechnic Institute,1,0,2007,NA,NA,1288,389,899,836,576,260,0.66,0.64,0.65,34900,346,400,985
194824,Rensselaer Polytechnic Institute,1,0,2008,NA,NA,1355,380,975,833,599,234,0.61,0.61,0.61,36950,374,394,980
194824,Rensselaer Polytechnic Institute,1,0,2009,NA,NA,1337,360,977,840,599,241,0.66,0.61,0.63,38100,382,383,967
194824,Rensselaer Polytechnic Institute,1,0,2010,NA,NA,1152,322,830,703,494,209,0.64,0.6,0.61,39600,384,378,834
195003,ROCHESTER INSTITUTE OF TECHNOLOGY,0,1,1991,Inf,0,1265,370,895,287,162,125,0.33,0.18,0.23,12058,205,637,1034
195003,ROCHESTER INSTITUTE OF TECHNOLOGY,0,1,1992,Inf,0,1482,432,1050,323,172,151,0.34,0.16,0.22,12760,219,640,1144
195003,ROCHESTER INSTITUTE OF TECHNOLOGY,0,1,1993,Inf,0,1343,425,918,310,146,164,0.38,0.16,0.23,13555,224,664,1062
195003,ROCHESTER INSTITUTE OF TECHNOLOGY,0,1,1995,Inf,0,1634,502,1132,621,379,242,0.48,0.33,0.38,14977,238,629,1218
195003,ROCHESTER INSTITUTE OF TECHNOLOGY,0,1,1996,Inf,0,1725,571,1154,690,419,271,0.47000000000000003,0.36,0.4,15691,237,537,1400
195003,ROCHESTER INSTITUTE OF TECHNOLOGY,0,1,1997,Inf,0,1836,617,1219,727,446,281,0.45,0.37,0.4,16399,211,622,1457
195003,ROCHESTER INSTITUTE OF TECHNOLOGY,0,1,1998,Inf,0,1980,609,1371,816,526,290,0.47000000000000003,0.38,0.41,17067,226,634,1369
195003,ROCHESTER INSTITUTE OF TECHNOLOGY,0,1,1999,Inf,0,2107,602,1505,366,187,179,0.29,0.12,0.17,17328,247,605,1614
195003,ROCHESTER INSTITUTE OF TECHNOLOGY,0,1,2000,Inf,0,2278,636,1642,453,244,209,0.32,0.15,0.2,17934,283,616,1758
195003,ROCHESTER INSTITUTE OF TECHNOLOGY,0,1,2001,Inf,0,2227,574,1653,451,249,202,0.35000000000000003,0.15,0.2,18633,291,627,1630
195003,ROCHESTER INSTITUTE OF TECHNOLOGY,0,1,2002,Inf,0,2327,614,1713,563,299,264,0.43,0.17,0.24,19470,321,684,1685
195003,ROCHESTER INSTITUTE OF TECHNOLOGY,0,1,2003,Inf,0,2121,567,1554,538,286,252,0.44,0.18,0.25,21027,340,799,1522
195003,ROCHESTER INSTITUTE OF TECHNOLOGY,0,1,2004,Inf,0,2233,562,1671,577,316,261,0.46,0.19,0.26,22056,363,731,1659
195003,Rochester Institute of Technology,0,1,2005,Inf,0,2184,656,1528,587,289,298,0.45,0.19,0.27,23247,356,794,1582
195003,Rochester Institute of Technology,0,1,2006,Inf,0,2355,675,1680,589,315,274,0.4,0.19,0.25,24627,384,766,1787
195003,Rochester Institute of Technology,0,1,2007,Inf,0,2497,788,1709,648,306,342,0.43,0.18,0.26,26085,388,797,1881
195003,Rochester Institute of Technology,0,1,2008,Inf,0,2594,848,1746,706,357,349,0.41000000000000003,0.2,0.27,27624,393,924,1945
195003,Rochester Institute of Technology,0,1,2009,Inf,0,2582,798,1784,796,413,383,0.47000000000000003,0.23,0.31,28866,428,945,1858
195003,Rochester Institute of Technology,0,1,2010,Inf,0,2583,820,1763,699,346,353,0.43,0.2,0.27,30282,467,961,1395
195030,UNIVERSITY OF ROCHESTER,1,0,1991,NA,NA,1215,537,678,805,440,365,0.67,0.65,0.66,15513,656,526,856
195030,UNIVERSITY OF ROCHESTER,1,0,1992,NA,NA,1266,585,681,824,425,399,0.68,0.62,0.65,16444,708,521,910
195030,UNIVERSITY OF ROCHESTER,1,0,1993,NA,NA,1229,599,630,754,365,389,0.64,0.58,0.61,17345,790,508,867
195030,UNIVERSITY OF ROCHESTER,1,0,1995,NA,NA,1205,583,622,751,354,397,0.68,0.57,0.62,19165,878,501,837
195030,UNIVERSITY OF ROCHESTER,1,0,1996,NA,NA,1011,501,510,719,336,383,0.76,0.66,0.71,20080,887,498,677
195030,UNIVERSITY OF ROCHESTER,1,0,1997,NA,NA,892,404,488,592,301,291,0.72,0.62,0.66,21020,867,486,639
195030,UNIVERSITY OF ROCHESTER,1,0,1998,NA,NA,1062,481,581,730,372,358,0.74,0.64,0.69,21981,1042,476,696
195030,UNIVERSITY OF ROCHESTER,1,0,1999,NA,NA,1211,525,686,828,429,399,0.76,0.63,0.68,22300,1168,475,739
195030,UNIVERSITY OF ROCHESTER,1,0,2000,NA,NA,1044,460,584,741,395,346,0.75,0.68,0.71,23130,1309,487,640
195030,UNIVERSITY OF ROCHESTER,1,0,2001,NA,NA,1095,481,614,767,390,377,0.78,0.64,0.7,24150,1383,499,699
195030,UNIVERSITY OF ROCHESTER,1,0,2002,NA,NA,1055,492,563,776,392,384,0.78,0.7,0.74,25430,1528,506,675
195030,UNIVERSITY OF ROCHESTER,1,0,2003,NA,NA,1086,508,578,747,368,379,0.74,0.64,0.69,26900,1632,513,650
195030,UNIVERSITY OF ROCHESTER,1,0,2004,NA,NA,1083,496,587,808,409,399,0.8,0.7,0.75,28250,1774,556,726
195030,University of Rochester,1,0,2005,NA,NA,1106,563,543,808,376,432,0.76,0.69,0.73,30540,1878,552,712
195030,University of Rochester,1,0,2006,NA,NA,1219,561,658,906,467,439,0.78,0.71,0.74,32650,2041,569,667
195030,University of Rochester,1,0,2007,NA,NA,1181,603,578,905,415,490,0.81,0.72,0.77,34380,2177,566,635
195030,University of Rochester,1,0,2008,NA,NA,1282,642,640,936,442,494,0.76,0.69,0.73,36410,2338,567,683
195030,University of Rochester,1,0,2009,NA,NA,1195,594,601,890,431,459,0.77,0.72,0.74,37870,2448,573,631
195030,University of Rochester,1,0,2010,NA,NA,1305,641,664,120,69,51,0.07,0.1,0.09,39480,2518,588,777
195164,SAINT BONAVENTURE UNIVERSITY,1,0,1991,NA,NA,479,236,243,267,117,150,0.63,0.48,0.56,9067,37,145,440
195164,SAINT BONAVENTURE UNIVERSITY,1,0,1992,NA,NA,441,216,225,226,93,133,0.61,0.41,0.51,9284,40,169,399
195164,SAINT BONAVENTURE UNIVERSITY,1,0,1993,NA,NA,370,187,183,215,95,120,0.64,0.52,0.58,9656,43,154,350
195164,SAINT BONAVENTURE UNIVERSITY,1,0,1995,NA,NA,547,278,269,285,127,158,0.56,0.47,0.52,11604,35,110,482
195164,SAINT BONAVENTURE UNIVERSITY,1,0,1996,NA,NA,590,311,279,327,153,174,0.55,0.55,0.55,12439,41,116,534
195164,SAINT BONAVENTURE UNIVERSITY,1,0,1997,NA,NA,542,274,268,309,144,165,0.6,0.54,0.57,13100,34,121,292
195164,SAINT BONAVENTURE UNIVERSITY,1,0,1998,NA,NA,568,284,284,290,126,164,0.5700000000000001,0.44,0.51,13800,36,133,463
195164,SAINT BONAVENTURE UNIVERSITY,1,0,1999,NA,NA,520,294,226,273,100,173,0.58,0.44,0.52,13880,39,147,276
195164,SAINT BONAVENTURE UNIVERSITY,1,0,2000,NA,NA,584,316,268,309,116,193,0.61,0.43,0.53,14510,41,147,306
195164,SAINT BONAVENTURE UNIVERSITY,1,0,2001,NA,NA,518,263,255,280,121,159,0.6,0.47,0.54,15526,42,148,286
195164,SAINT BONAVENTURE UNIVERSITY,1,0,2002,NA,NA,584,295,289,300,136,164,0.55,0.47,0.51,16210,47,154,340
195164,SAINT BONAVENTURE UNIVERSITY,1,0,2003,NA,NA,595,292,303,296,135,161,0.55,0.45,0.5,17190,52,156,371
195164,SAINT BONAVENTURE UNIVERSITY,1,0,2004,NA,NA,574,304,270,305,134,171,0.56,0.5,0.53,18650,52,153,387
195164,Saint Bonaventure University,1,0,2005,NA,NA,477,225,252,239,112,127,0.56,0.44,0.5,20610,53,157,352
195164,Saint Bonaventure University,1,0,2006,NA,NA,459,234,225,235,105,130,0.55,0.47,0.51,21650,52,149,361
195164,Saint Bonaventure University,1,0,2007,NA,NA,527,264,263,283,133,150,0.56,0.51,0.54,22740,49,141,389
195164,Saint Bonaventure University,1,0,2008,NA,NA,563,315,248,310,113,197,0.62,0.46,0.55,23920,50,145,416
195164,Saint Bonaventure University,1,0,2009,NA,NA,465,249,216,252,106,146,0.58,0.49,0.54,24920,52,155,338
195164,Saint Bonaventure University,1,0,2010,NA,NA,494,242,252,257,116,141,0.58,0.46,0.52,25930,50,157,366
195173,ST FRANCIS COLLEGE,1,0,1991,NA,NA,353,207,146,68,26,42,0.2,0.18,0.19,5850,13,52,196
195173,ST FRANCIS COLLEGE,1,0,1992,NA,NA,372,200,172,63,26,37,0.18,0.15,0.17,6550,16,53,206
195173,ST FRANCIS COLLEGE,1,0,1993,NA,NA,358,214,144,107,40,67,0.31,0.28,0.3,6710,18,56,212
195173,ST FRANCIS COLLEGE,1,0,1995,NA,NA,281,145,136,89,48,41,0.28,0.35,0.32,7360,16,59,170
195173,ST FRANCIS COLLEGE,1,0,1996,NA,NA,305,181,124,93,35,58,0.32,0.28,0.3,7739,18,58,163
195173,ST FRANCIS COLLEGE,1,0,1997,NA,NA,410,253,157,95,26,69,0.27,0.17,0.23,8160,14,62,217
195173,ST FRANCIS COLLEGE,1,0,1998,NA,NA,440,259,181,146,40,106,0.4,0.22,0.33,8480,16,65,237
195173,ST FRANCIS COLLEGE,1,0,1999,NA,NA,474,284,190,130,54,76,0.26,0.28,0.27,8250,18,66,277
195173,ST FRANCIS COLLEGE,1,0,2000,NA,NA,434,242,192,191,72,119,0.49,0.38,0.44,8900,19,66,253
195173,ST FRANCIS COLLEGE,1,0,2001,NA,NA,471,220,251,171,75,96,0.43,0.3,0.36,9450,21,66,235
195173,ST FRANCIS COLLEGE,1,0,2002,NA,NA,454,238,216,153,61,92,0.38,0.28,0.34,9920,22,65,258
195173,ST FRANCIS COLLEGE,1,0,2003,NA,NA,428,224,204,71,18,53,0.23,0.09,0.17,10620,23,69,225
195173,ST FRANCIS COLLEGE,1,0,2004,NA,NA,473,228,245,148,67,81,0.35000000000000003,0.27,0.31,11420,26,70,226
195173,St Francis College,1,0,2005,NA,NA,497,224,273,140,68,72,0.32,0.25,0.28,12450,27,71,238
195173,St Francis College,1,0,2006,NA,NA,474,253,221,137,61,76,0.3,0.28,0.29,13500,30,76,228
195173,St Francis College,1,0,2007,NA,NA,478,261,217,130,48,82,0.31,0.22,0.27,14400,34,76,204
195173,St. Francis College,1,0,2008,NA,NA,566,292,274,160,68,92,0.31,0.25,0.28,15200,33,75,275
195173,St. Francis College,1,0,2009,NA,NA,580,301,279,168,63,105,0.34,0.23,0.29,16040,37,77,279
195173,St. Francis College,1,0,2010,NA,NA,559,289,270,151,65,86,0.29,0.24,0.27,16720,38,80,223
195216,SAINT LAWRENCE UNIVERSITY,1,0,1991,NA,NA,421,213,208,322,142,180,0.84,0.68,0.76,15735,54,158,381
195216,ST LAWRENCE UNIVERSITY,1,0,1992,NA,NA,601,294,307,413,207,206,0.7000000000000001,0.67,0.69,16820,56,151,552
195216,ST LAWRENCE UNIVERSITY,1,0,1993,NA,NA,507,260,247,353,167,186,0.71,0.68,0.7,17890,59,153,442
195216,ST LAWRENCE UNIVERSITY,1,0,1995,NA,NA,571,287,284,382,176,206,0.71,0.62,0.67,19790,62,154,517
195216,ST LAWRENCE UNIVERSITY,1,0,1996,NA,NA,592,281,311,388,209,179,0.63,0.67,0.66,20560,68,149,529
195216,ST LAWRENCE UNIVERSITY,1,0,1997,NA,NA,476,232,244,328,148,180,0.77,0.61,0.69,21325,53,154,434
195216,ST LAWRENCE UNIVERSITY,1,0,1998,NA,NA,479,255,224,339,155,184,0.72,0.69,0.71,22120,54,153,364
195216,ST LAWRENCE UNIVERSITY,1,0,1999,NA,NA,575,301,274,410,182,228,0.75,0.66,0.71,22905,59,156,459
195216,ST LAWRENCE UNIVERSITY,1,0,2000,NA,NA,612,325,287,436,186,250,0.76,0.65,0.71,23765,63,157,440
195216,ST LAWRENCE UNIVERSITY,1,0,2001,NA,NA,511,269,242,377,179,198,0.73,0.74,0.74,24655,69,158,341
195216,ST LAWRENCE UNIVERSITY,1,0,2002,NA,NA,615,316,299,443,197,246,0.77,0.66,0.72,26280,74,171,427
195216,ST LAWRENCE UNIVERSITY,1,0,2003,NA,NA,565,296,269,444,196,248,0.8300000000000001,0.73,0.79,27985,81,168,394
195216,ST LAWRENCE UNIVERSITY,1,0,2004,NA,NA,566,298,268,444,203,241,0.8,0.76,0.78,30270,84,171,419
195216,St Lawrence University,1,0,2005,NA,NA,534,268,266,407,190,217,0.8,0.71,0.76,31935,88,181,415
195216,St Lawrence University,1,0,2006,NA,NA,608,325,283,463,210,253,0.77,0.74,0.76,33690,94,179,495
195216,St Lawrence University,1,0,2007,NA,NA,627,383,244,482,181,301,0.78,0.74,0.77,35375,96,187,508
195216,St Lawrence University,1,0,2008,NA,NA,616,334,282,490,220,270,0.8,0.78,0.8,37675,106,190,512
195216,St Lawrence University,1,0,2009,NA,NA,579,307,272,476,219,257,0.8300000000000001,0.81,0.82,39520,109,183,492
195216,St Lawrence University,1,0,2010,NA,NA,609,316,293,492,227,265,0.8300000000000001,0.77,0.81,40905,109,179,495
195234,COLLEGE OF SAINT ROSE,1,0,1991,NA,NA,207,152,55,106,24,82,0.53,0.44,0.51,8420,25,118,184
195234,COLLEGE OF SAINT ROSE,1,0,1992,NA,NA,233,177,56,122,21,101,0.5700000000000001,0.38,0.52,9036,30,118,204
195234,COLLEGE OF SAINT ROSE,1,0,1993,NA,NA,236,160,76,116,24,92,0.5700000000000001,0.32,0.49,9562,33,129,213
195234,THE COLLEGE OF SAINT ROSE,1,0,1995,NA,NA,248,170,78,111,34,77,0.45,0.44,0.45,10610,38,135,225
195234,THE COLLEGE OF SAINT ROSE,1,0,1996,NA,NA,319,226,93,146,30,116,0.51,0.32,0.46,11174,38,130,273
195234,THE COLLEGE OF SAINT ROSE,1,0,1997,NA,NA,311,223,88,146,29,117,0.52,0.33,0.47,11684,31,135,290
195234,THE COLLEGE OF SAINT ROSE,1,0,1998,NA,NA,345,262,83,175,29,146,0.55,0.35,0.51,11968,33,130,313
195234,THE COLLEGE OF SAINT ROSE,1,0,1999,NA,NA,401,297,104,202,39,163,0.54,0.38,0.5,12434,35,138,368
195234,THE COLLEGE OF SAINT ROSE,1,0,2000,NA,NA,485,349,136,216,47,169,0.48,0.35,0.45,12870,38,148,442
195234,THE COLLEGE OF SAINT ROSE,1,0,2001,NA,NA,490,356,134,239,45,194,0.54,0.34,0.49,13578,42,159,435
195234,THE COLLEGE OF SAINT ROSE,1,0,2002,NA,NA,526,391,135,303,65,238,0.6,0.48,0.58,14244,47,163,467
195234,THE COLLEGE OF SAINT ROSE,1,0,2003,NA,NA,531,397,134,277,52,225,0.56,0.39,0.52,15242,52,166,455
195234,THE COLLEGE OF SAINT ROSE,1,0,2004,NA,NA,563,408,155,387,91,296,0.72,0.59,0.69,16230,52,171,388
195234,The College of Saint Rose,1,0,2005,NA,NA,595,411,184,330,75,255,0.62,0.41,0.55,17368,58,181,452
195234,The College of Saint Rose,1,0,2006,NA,NA,630,423,207,328,88,240,0.56,0.43,0.52,18672,63,197,510
195234,The College of Saint Rose,1,0,2007,NA,NA,611,456,155,326,63,263,0.5700000000000001,0.41,0.53,19860,69,204,487
195234,The College of Saint Rose,1,0,2008,NA,NA,574,415,159,312,72,240,0.5700000000000001,0.45,0.54,21260,75,204,462
195234,The College of Saint Rose,1,0,2009,NA,NA,583,381,202,271,76,195,0.51,0.38,0.46,22324,82,207,425
195234,The College of Saint Rose,1,0,2010,NA,NA,639,432,207,313,83,230,0.53,0.4,0.49,23330,84,206,474
195243,SAINT THOMAS AQUINAS COLLEGE,1,0,1991,NA,NA,198,113,85,95,28,67,0.59,0.33,0.48,6750,11,66,177
195243,SAINT THOMAS AQUINAS COLLEGE,1,0,1992,NA,NA,214,125,89,53,9,44,0.35000000000000003,0.1,0.25,7350,13,63,162
195243,SAINT THOMAS AQUINAS COLLEGE,1,0,1993,NA,NA,211,132,79,86,24,62,0.46,0.3,0.41,8150,14,63,170
195243,SAINT THOMAS AQUINAS COLLEGE,1,0,1995,NA,NA,276,162,114,74,22,52,0.32,0.19,0.27,9450,18,63,192
195243,SAINT THOMAS AQUINAS COLLEGE,1,0,1996,NA,NA,238,142,96,65,16,49,0.34,0.17,0.27,10100,20,63,183
195243,SAINT THOMAS AQUINAS COLLEGE,1,0,1997,NA,NA,300,179,121,106,34,72,0.4,0.28,0.35,10700,17,61,241
195243,SAINT THOMAS AQUINAS COLLEGE,1,0,1998,NA,NA,306,179,127,97,34,63,0.35000000000000003,0.27,0.32,11420,18,62,236
195243,SAINT THOMAS AQUINAS COLLEGE,1,0,1999,NA,NA,304,168,136,103,33,70,0.41000000000000003,0.24,0.34,11800,19,61,213
195243,SAINT THOMAS AQUINAS COLLEGE,1,0,2000,NA,NA,298,173,125,117,38,79,0.45,0.3,0.39,12500,19,61,188
195243,SAINT THOMAS AQUINAS COLLEGE,1,0,2001,NA,NA,301,164,137,101,35,66,0.4,0.26,0.34,13120,21,61,195
195243,SAINT THOMAS AQUINAS COLLEGE,1,0,2002,NA,NA,329,191,138,130,38,92,0.48,0.28,0.4,13780,22,62,209
195243,SAINT THOMAS AQUINAS COLLEGE,1,0,2003,NA,NA,343,188,155,97,39,58,0.3,0.25,0.28,14500,24,65,231
195243,SAINT THOMAS AQUINAS COLLEGE,1,0,2004,NA,NA,349,168,181,112,56,56,0.33,0.31,0.32,15300,26,64,225
195243,Saint Thomas Aquinas College,1,0,2005,NA,NA,327,188,139,119,43,76,0.4,0.31,0.36,16200,22,61,238
195243,Saint Thomas Aquinas College,1,0,2006,NA,NA,323,185,138,113,39,74,0.4,0.28,0.35,17200,23,62,229
195243,Saint Thomas Aquinas College,1,0,2007,NA,NA,324,163,161,117,49,68,0.41000000000000003,0.3,0.36,18400,24,64,227
195243,Saint Thomas Aquinas College,1,0,2008,NA,NA,352,213,139,140,44,96,0.45,0.32,0.4,19500,26,63,239
195243,Saint Thomas Aquinas College,1,0,2009,NA,NA,293,156,137,105,56,49,0.31,0.41,0.36,20670,27,66,195
195243,Saint Thomas Aquinas College,1,0,2010,NA,NA,290,173,117,123,40,83,0.47000000000000003,0.34,0.42,21910,28,61,178
195304,SARAH LAWRENCE COLLEGE,1,0,1991,NA,NA,228,168,60,125,34,91,0.54,0.57,0.55,16750,24,64,193
195304,SARAH LAWRENCE COLLEGE,1,0,1992,NA,NA,220,168,52,127,30,97,0.5700000000000001,0.58,0.58,17640,26,67,181
195304,SARAH LAWRENCE COLLEGE,1,0,1993,NA,NA,255,195,60,131,31,100,0.51,0.52,0.51,18460,28,69,200
195304,SARAH LAWRENCE COLLEGE,1,0,1995,NA,NA,233,183,50,118,29,89,0.48,0.58,0.51,20708,32,76,183
195304,SARAH LAWRENCE COLLEGE,1,0,1996,NA,NA,294,219,75,193,47,146,0.66,0.63,0.66,21836,35,78,234
195304,SARAH LAWRENCE COLLEGE,1,0,1997,NA,NA,283,222,61,174,33,141,0.63,0.54,0.61,22936,30,76,236
195304,SARAH LAWRENCE COLLEGE,1,0,1998,NA,NA,306,227,79,202,57,145,0.63,0.72,0.66,24066,33,78,243
195304,SARAH LAWRENCE COLLEGE,1,0,1999,NA,NA,278,215,63,180,44,136,0.63,0.7,0.65,24810,36,88,203
195304,SARAH LAWRENCE COLLEGE,1,0,2000,NA,NA,292,212,80,204,56,148,0.6900000000000001,0.7,0.7,26040,39,92,203
195304,SARAH LAWRENCE COLLEGE,1,0,2001,NA,NA,323,240,83,213,50,163,0.67,0.6,0.66,27330,43,97,239
195304,SARAH LAWRENCE COLLEGE,1,0,2002,NA,NA,323,249,74,205,56,149,0.59,0.76,0.63,28680,46,103,261
195304,SARAH LAWRENCE COLLEGE,1,0,2003,NA,NA,322,234,88,218,63,155,0.66,0.72,0.68,30120,50,106,243
195304,SARAH LAWRENCE COLLEGE,1,0,2004,NA,NA,329,253,76,233,50,183,0.72,0.66,0.71,31680,53,104,254
195304,Sarah Lawrence College,1,0,2005,NA,NA,376,285,91,237,50,187,0.65,0.55,0.63,33270,56,111,308
195304,Sarah Lawrence College,1,0,2006,NA,NA,381,286,95,261,62,199,0.6900000000000001,0.65,0.69,35280,62,112,286
195304,Sarah Lawrence College,1,0,2007,NA,NA,363,278,85,226,50,176,0.63,0.59,0.62,37230,65,111,209
195304,Sarah Lawrence College,1,0,2008,NA,NA,348,273,75,246,57,189,0.6900000000000001,0.76,0.71,39450,68,113,254
195304,Sarah Lawrence College,1,0,2009,NA,NA,365,273,92,263,72,191,0.6900000000000001,0.78,0.72,41040,69,107,270
195304,Sarah Lawrence College,1,0,2010,NA,NA,338,238,100,249,68,181,0.76,0.68,0.74,42600,68,102,231
195474,SIENA COLLEGE,1,0,1991,NA,NA,584,307,277,455,220,235,0.76,0.79,0.78,9060,36,143,537
195474,SIENA COLLEGE,1,0,1992,NA,NA,544,315,229,399,153,246,0.78,0.67,0.73,9810,38,149,497
195474,SIENA COLLEGE,1,0,1993,NA,NA,616,339,277,421,185,236,0.6900000000000001,0.67,0.68,10505,41,155,554
195474,SIENA COLLEGE,1,0,1995,NA,NA,590,317,273,393,182,211,0.66,0.67,0.67,11650,44,145,552
195474,SIENA COLLEGE,1,0,1996,NA,NA,558,325,233,354,137,217,0.66,0.59,0.63,12150,49,139,522
195474,SIENA COLLEGE,1,0,1997,NA,NA,583,301,282,400,181,219,0.72,0.64,0.69,12770,39,139,545
195474,SIENA COLLEGE,1,0,1998,NA,NA,619,311,308,436,202,234,0.75,0.66,0.7,13545,41,139,570
195474,SIENA COLLEGE,1,0,1999,NA,NA,677,381,296,491,197,294,0.77,0.67,0.73,13660,45,145,603
195474,SIENA COLLEGE,1,0,2000,NA,NA,765,404,361,547,234,313,0.77,0.65,0.72,14330,48,150,704
195474,SIENA COLLEGE,1,0,2001,NA,NA,713,394,319,530,230,300,0.76,0.72,0.74,15330,50,156,639
195474,SIENA COLLEGE,1,0,2002,NA,NA,677,405,272,497,185,312,0.77,0.68,0.73,16405,56,160,591
195474,SIENA COLLEGE,1,0,2003,NA,NA,759,438,321,519,204,315,0.71,0.64,0.68,17555,60,165,660
195474,SIENA COLLEGE,1,0,2004,NA,NA,715,412,303,532,212,320,0.77,0.7,0.74,18590,63,169,616
195474,Siena College,1,0,2005,NA,NA,763,443,320,531,225,306,0.6900000000000001,0.7,0.7,20100,65,172,646
195474,Siena College,1,0,2006,NA,NA,688,393,295,478,190,288,0.73,0.64,0.69,21285,69,175,579
195474,Siena College,1,0,2007,NA,NA,781,463,318,578,219,359,0.77,0.69,0.74,22510,71,178,668
195474,Siena College,1,0,2008,NA,NA,824,444,380,613,272,341,0.76,0.72,0.74,23750,76,181,704
195474,Siena College,1,0,2009,NA,NA,783,417,366,563,239,324,0.77,0.65,0.72,25060,84,188,656
195474,Siena College,1,0,2010,NA,NA,768,410,358,539,228,311,0.75,0.64,0.7,26185,90,199,634
195526,SKIDMORE COLLEGE,1,0,1991,NA,NA,652,392,260,401,139,262,0.66,0.53,0.62,15991,56,171,538
195526,SKIDMORE COLLEGE,1,0,1992,NA,NA,615,369,246,425,144,281,0.76,0.59,0.69,16650,59,165,505
195526,SKIDMORE COLLEGE,1,0,1993,NA,NA,588,355,233,414,153,261,0.73,0.66,0.7,17560,63,168,476
195526,SKIDMORE COLLEGE,1,0,1995,NA,NA,606,373,233,438,152,286,0.76,0.65,0.72,19725,68,158,487
195526,SKIDMORE COLLEGE,1,0,1996,NA,NA,702,424,278,501,196,305,0.71,0.71,0.71,20670,71,158,559
195526,SKIDMORE COLLEGE,1,0,1997,NA,NA,605,372,233,452,175,277,0.74,0.75,0.75,21750,66,173,485
195526,SKIDMORE COLLEGE,1,0,1998,NA,NA,596,366,230,482,193,289,0.78,0.84,0.81,22853,68,198,471
195526,SKIDMORE COLLEGE,1,0,1999,NA,NA,642,367,275,470,189,281,0.76,0.69,0.73,24000,73,211,485
195526,SKIDMORE COLLEGE,1,0,2000,NA,NA,599,345,254,461,186,275,0.79,0.73,0.77,25190,76,203,433
195526,SKIDMORE COLLEGE,1,0,2001,NA,NA,598,352,246,469,196,273,0.77,0.8,0.78,26400,78,196,430
195526,SKIDMORE COLLEGE,1,0,2002,NA,NA,634,383,251,494,191,303,0.79,0.76,0.78,27700,87,192,443
195526,SKIDMORE COLLEGE,1,0,2003,NA,NA,642,377,265,527,208,319,0.84,0.78,0.82,29350,94,231,452
195526,SKIDMORE COLLEGE,1,0,2004,NA,NA,676,383,293,539,229,310,0.8,0.78,0.8,30800,91,237,490
195526,Skidmore College,1,0,2005,NA,NA,694,433,261,567,202,365,0.84,0.77,0.82,32340,97,236,508
195526,Skidmore College,1,0,2006,NA,NA,672,388,284,565,231,334,0.86,0.81,0.84,34224,105,257,495
195526,Skidmore College,1,0,2007,NA,NA,682,406,276,564,213,351,0.86,0.77,0.83,36126,116,248,470
195526,Skidmore College,1,0,2008,NA,NA,652,400,252,552,212,340,0.85,0.84,0.85,38114,127,258,484
195526,Skidmore College,1,0,2009,NA,NA,663,414,249,549,194,355,0.85,0.78,0.83,39600,124,248,494
195526,Skidmore College,1,0,2010,NA,NA,768,485,283,653,225,428,0.88,0.8,0.85,40350,129,244,526
195544,SAINT JOSEPHS COLLEGE MAIN CAMPUS,1,0,1991,NA,NA,65,47,18,41,9,32,0.68,0.5,0.63,6280,14,80,46
195544,SAINT JOSEPHS COLLEGE MAIN CAMPUS,1,0,1992,NA,NA,55,42,13,32,7,25,0.59,0.54,0.58,6700,17,80,36
195544,SAINT JOSEPHS COLLEGE-MAIN CAMPUS,1,0,1993,NA,NA,78,61,17,42,10,32,0.52,0.59,0.54,7122,19,81,55
195544,SAINT JOSEPHS COLLEGE-MAIN CAMPUS,1,0,1995,NA,NA,84,64,20,56,9,47,0.73,0.45,0.67,7818,25,87,62
195544,SAINT JOSEPHS COLLEGE-MAIN CAMPUS,1,0,1996,NA,NA,97,76,21,59,8,51,0.67,0.38,0.61,8116,25,89,68
195544,SAINT JOSEPHS COLLEGE-MAIN CAMPUS,1,0,1997,NA,NA,107,74,33,60,18,42,0.56,0.55,0.56,8428,22,92,73
195544,SAINT JOSEPHS COLLEGE-MAIN CAMPUS,1,0,1998,NA,NA,100,82,18,69,9,60,0.73,0.5,0.69,8672,23,100,72
195544,SAINT JOSEPHS COLLEGE-MAIN CAMPUS,1,0,1999,NA,NA,77,55,22,51,8,43,0.78,0.36,0.66,8600,25,108,57
195544,SAINT JOSEPHS COLLEGE-MAIN CAMPUS,1,0,2000,NA,NA,98,80,18,67,6,61,0.76,0.33,0.68,9030,28,113,66
195544,SAINT JOSEPHS COLLEGE-MAIN CAMPUS,1,0,2001,NA,NA,66,56,10,43,4,39,0.6900000000000001,0.4,0.65,9480,32,118,45
195544,SAINT JOSEPHS COLLEGE-MAIN CAMPUS,1,0,2002,NA,NA,109,92,17,78,11,67,0.72,0.65,0.72,10050,34,128,71
195544,SAINT JOSEPHS COLLEGE-MAIN CAMPUS,1,0,2003,NA,NA,96,80,16,67,10,57,0.71,0.62,0.7,10550,38,130,67
195544,SAINT JOSEPHS COLLEGE-MAIN CAMPUS,1,0,2004,NA,NA,593,420,173,311,68,243,0.5700000000000001,0.39,0.52,11078,43,138,418
195544,Saint Josephs College-Main Campus,1,0,2005,NA,NA,605,446,159,291,57,234,0.52,0.36,0.48,11854,47,148,466
195544,Saint Josephs College-Main Campus,1,0,2006,NA,NA,597,424,173,309,68,241,0.56,0.39,0.52,12564,12,50,453
195544,Saint Josephs College-Main Campus,1,0,2007,NA,NA,672,474,198,373,87,286,0.6,0.44,0.56,14000,13,48,502
195544,Saint Josephs College-Main Campus,1,0,2008,NA,NA,613,420,193,326,84,242,0.5700000000000001,0.44,0.53,15400,14,50,462
195544,Saint Josephs College-Main Campus,1,0,2009,NA,NA,700,519,181,374,73,301,0.58,0.4,0.53,16200,15,52,489
195544,Saint Joseph's College-New York,1,0,2010,NA,NA,697,498,199,403,102,301,0.6,0.51,0.58,17000,68,172,465
195809,SAINT JOHN'S UNIVERSITY NEW YORK,1,0,1991,NA,NA,2483,1282,1201,612,253,359,0.28,0.21,0.25,7530,147,934,1423
195809,SAINT JOHN'S UNIVERSITY NEW YORK,1,0,1992,NA,NA,2326,1211,1115,526,223,303,0.25,0.2,0.23,8230,184,610,1376
195809,SAINT JOHNS UNIVERSITY-NEW YORK,1,0,1993,NA,NA,2324,1174,1150,565,223,342,0.29,0.19,0.24,8980,188,610,1371
195809,SAINT JOHNS UNIVERSITY-NEW YORK,1,0,1995,NA,NA,2206,1181,1025,629,234,395,0.33,0.23,0.29,10450,212,582,1146
195809,SAINT JOHNS UNIVERSITY-NEW YORK,1,0,1996,NA,NA,2157,1146,1011,629,229,400,0.34,0.23,0.29,11380,207,553,1105
195809,SAINT JOHNS UNIVERSITY-NEW YORK,1,0,1997,NA,NA,2480,1358,1122,789,311,478,0.35000000000000003,0.28,0.32,12230,186,548,1135
195809,SAINT JOHNS UNIVERSITY-NEW YORK,1,0,1998,NA,NA,2504,1417,1087,886,318,568,0.4,0.29,0.35,13630,200,540,1157
195809,SAINT JOHNS UNIVERSITY-NEW YORK,1,0,1999,NA,NA,2650,1500,1150,954,357,597,0.39,0.31,0.36,13990,203,538,1087
195809,ST JOHN'S UNIVERSITY-NEW YORK,1,0,2000,NA,NA,2853,1619,1234,997,387,610,0.37,0.31,0.35,15500,224,539,1187
195809,ST JOHN'S UNIVERSITY-NEW YORK,1,0,2001,NA,NA,2670,1523,1147,957,357,600,0.39,0.31,0.36,16900,249,540,1103
195809,ST JOHN'S UNIVERSITY-NEW YORK,1,0,2002,NA,NA,2954,1736,1218,1001,347,654,0.37,0.28,0.34,17850,273,550,1167
195809,ST JOHN'S UNIVERSITY-NEW YORK,1,0,2003,NA,NA,2966,1749,1217,1058,381,677,0.38,0.31,0.36,19600,285,563,1265
195809,ST JOHN'S UNIVERSITY-NEW YORK,1,0,2004,NA,NA,2996,1696,1300,1035,384,651,0.38,0.3,0.35,21150,301,579,1112
195809,St. John's University-New York,1,0,2005,NA,NA,3153,1742,1411,1098,435,663,0.38,0.31,0.35,22800,326,597,1133
195809,St. John's University-New York,1,0,2006,NA,NA,3260,1713,1547,1198,494,704,0.41000000000000003,0.32,0.37,24400,345,620,1158
195809,St. John's University-New York,1,0,2007,NA,NA,3151,1689,1462,1121,455,666,0.39,0.31,0.36,26200,365,655,1120
195809,St. John's University-New York,1,0,2008,NA,NA,3258,1737,1521,1294,521,773,0.44,0.34,0.4,28100,398,671,1116
195809,St. John's University-New York,1,0,2009,NA,NA,3101,1651,1450,1245,534,711,0.43,0.37,0.4,29350,427,668,1119
195809,St John's University-New York,1,0,2010,NA,NA,3105,1626,1479,1117,500,617,0.37,0.34,0.36,31250,464,628,1028
196413,SYRACUSE UNIVERSITY MAIN CAMPUS,1,0,1991,NA,NA,2513,1294,1219,1388,596,792,0.61,0.49,0.55,12957,382,928,1697
196413,SYRACUSE UNIVERSITY MAIN CAMPUS,1,0,1992,NA,NA,2581,1329,1252,1465,628,837,0.62,0.5,0.57,13811,377,896,1879
196413,SYRACUSE UNIVERSITY-MAIN CAMPUS,1,0,1993,NA,NA,2418,1270,1148,1386,590,796,0.62,0.51,0.57,14707,391,891,1707
196413,SYRACUSE UNIVERSITY,1,0,1995,NA,NA,2392,1259,1133,1467,631,836,0.66,0.56,0.61,16280,412,817,1699
196413,SYRACUSE UNIVERSITY,1,0,1996,NA,NA,2652,1429,1223,1722,735,987,0.6900000000000001,0.6,0.65,17092,430,807,1959
196413,SYRACUSE UNIVERSITY,1,0,1997,NA,NA,2562,1417,1145,1773,713,1060,0.74,0.62,0.69,17950,357,807,1864
196413,SYRACUSE UNIVERSITY,1,0,1998,NA,NA,2566,1383,1183,1689,702,987,0.71,0.59,0.66,18850,372,805,1799
196413,SYRACUSE UNIVERSITY,1,0,1999,NA,NA,2724,1534,1190,1841,748,1093,0.71,0.63,0.68,19360,399,822,1991
196413,SYRACUSE UNIVERSITY,1,0,2000,NA,NA,2791,1569,1222,1981,805,1176,0.74,0.66,0.71,20380,413,827,2126
196413,SYRACUSE UNIVERSITY,1,0,2001,NA,NA,2601,1493,1108,1837,716,1121,0.75,0.65,0.71,21500,454,832,1850
196413,SYRACUSE UNIVERSITY,1,0,2002,NA,NA,2894,1676,1218,2021,793,1228,0.73,0.65,0.7,22800,471,859,1987
196413,SYRACUSE UNIVERSITY,1,0,2003,NA,NA,2628,1501,1127,1914,755,1159,0.77,0.67,0.73,24170,517,864,1926
196413,SYRACUSE UNIVERSITY,1,0,2004,NA,NA,2662,1505,1157,1907,766,1141,0.75,0.66,0.72,25720,534,879,1920
196413,Syracuse University,1,0,2005,NA,NA,3243,1849,1394,2261,903,1358,0.73,0.65,0.7,27210,569,891,2000
196413,Syracuse University,1,0,2006,NA,NA,3045,1686,1359,2099,839,1260,0.74,0.62,0.69,28820,610,906,1919
196413,Syracuse University,1,0,2007,NA,NA,3092,1756,1336,2119,846,1273,0.72,0.63,0.69,30470,634,913,1863
196413,Syracuse University,1,0,2008,NA,NA,3161,1853,1308,2173,846,1327,0.71,0.65,0.69,32180,683,947,1634
196413,Syracuse University,1,0,2009,NA,NA,3240,1868,1372,2215,854,1361,0.72,0.62,0.68,33630,716,955,1843
196413,Syracuse University,1,0,2010,NA,NA,3452,1929,1523,2379,962,1417,0.73,0.63,0.69,34970,743,982,2085
196592,TOURO COLLEGE,1,0,1991,NA,NA,503,330,173,37,15,22,0.06,0.09,0.07,6650,58,202,0
196592,TOURO COLLEGE,1,0,1992,NA,NA,1037,676,361,63,14,49,0.07,0.04,0.06,7030,98,232,801
196592,TOURO COLLEGE,1,0,1993,NA,NA,1236,815,421,70,6,64,0.07,0.01,0.06,7130,103,253,982
196592,TOURO COLLEGE,1,0,1995,NA,NA,1899,1266,633,136,70,66,0.05,0.11,0.07,8700,107,223,1445
196592,TOURO COLLEGE,1,0,1996,NA,NA,2337,1646,691,73,40,33,0.02,0.06,0.03,8700,103,219,1633
196592,TOURO COLLEGE,1,0,1997,NA,NA,2028,1457,571,85,27,58,0.03,0.05,0.04,8750,59,262,1348
196592,TOURO COLLEGE,1,0,1998,NA,NA,1651,1155,496,221,65,156,0.13,0.13,0.13,8850,66,264,1005
196592,TOURO COLLEGE,1,0,1999,NA,NA,1756,1210,546,152,50,102,0.08,0.09,0.09,9250,75,273,1230
196592,TOURO COLLEGE,1,0,2000,NA,NA,1272,919,353,121,46,75,0.08,0.13,0.1,9750,79,268,790
196592,TOURO COLLEGE,1,0,2001,NA,NA,1520,1064,456,146,42,104,0.09,0.09,0.1,9950,83,264,968
196592,TOURO COLLEGE,1,0,2002,NA,NA,1877,1306,571,159,40,119,0.09,0.07,0.08,9900,96,282,922
196592,TOURO COLLEGE,1,0,2003,NA,NA,1967,1343,624,247,74,173,0.12,0.12,0.13,9900,107,275,936
196592,TOURO COLLEGE,1,0,2004,NA,NA,1863,1278,585,246,86,160,0.12,0.15,0.13,10200,126,392,977
196592,Touro College,1,0,2005,NA,NA,1839,1261,578,40,13,27,0.02,0.02,0.02,10900,150,375,956
196592,Touro College,1,0,2006,NA,NA,1479,988,491,60,25,35,0.03,0.05,0.04,11800,169,497,474
196592,Touro College,1,0,2007,NA,NA,848,545,303,80,22,58,0.1,0.07,0.09,12300,192,474,352
196592,Touro College,1,0,2008,NA,NA,790,486,304,69,27,42,0.08,0.09,0.09,12800,235,527,375
196592,Touro College,1,0,2009,NA,NA,867,555,312,58,7,51,0.09,0.02,0.07,13300,259,593,356
196592,Touro College,1,0,2010,NA,NA,1030,668,362,152,21,131,0.19,0.06,0.15,13700,198,506,592
197045,UTICA COLLEGE OF SYRACUSE UNIVERSITY,1,0,1991,NA,NA,328,169,159,96,42,54,0.31,0.26,0.29,10536,23,111,258
197045,UTICA COLLEGE OF SYRACUSE UNIVERSITY,1,0,1992,NA,NA,323,183,140,90,37,53,0.28,0.26,0.28,11230,27,111,250
197045,UTICA COLLEGE OF SYRACUSE UNIVERSITY,1,0,1993,NA,NA,256,140,116,84,35,49,0.35000000000000003,0.3,0.33,11980,28,105,214
197045,UTICA COLLEGE OF SYRACUSE UNIVERSITY,1,0,1995,NA,NA,255,162,93,100,27,73,0.45,0.29,0.39,13406,29,99,184
197045,UTICA COLLEGE OF SYRACUSE UNIVERSITY,1,0,1996,NA,NA,338,223,115,126,34,92,0.41000000000000003,0.3,0.37,14206,28,96,222
197045,UTICA COLLEGE OF SYRACUSE UNIVERSITY,1,0,1997,NA,NA,320,216,104,130,44,86,0.39,0.42,0.41,14912,20,98,232
197045,UTICA COLLEGE OF SYRACUSE UNIVERSITY,1,0,1998,NA,NA,306,203,103,107,31,76,0.37,0.3,0.35,15654,22,96,189
197045,UTICA COLLEGE OF SYRACUSE UNIVERSITY,1,0,1999,NA,NA,365,221,144,158,49,109,0.49,0.34,0.43,16150,23,100,240
197045,UTICA COLLEGE OF SYRACUSE UNIVERSITY,1,0,2000,NA,NA,445,260,185,139,41,98,0.37,0.22,0.31,16844,26,102,287
197045,UTICA COLLEGE OF SYRACUSE UNIVERSITY,1,0,2001,NA,NA,475,218,257,154,76,78,0.35000000000000003,0.3,0.32,17790,28,104,333
197045,UTICA COLLEGE,1,0,2002,NA,NA,451,226,225,180,73,107,0.47000000000000003,0.32,0.4,18848,31,102,327
197045,UTICA COLLEGE,1,0,2003,NA,NA,447,254,193,169,70,99,0.38,0.36,0.38,19980,34,107,256
197045,UTICA COLLEGE,1,0,2004,NA,NA,484,248,236,143,68,75,0.3,0.29,0.3,20980,38,108,310
197045,Utica College,1,0,2005,NA,NA,468,264,204,139,52,87,0.32,0.25,0.3,22030,43,119,276
197045,Utica College,1,0,2006,NA,NA,495,277,218,164,62,102,0.36,0.28,0.33,23130,48,123,270
197045,Utica College,1,0,2007,NA,NA,492,265,227,146,60,86,0.32,0.26,0.3,24264,49,120,316
197045,Utica College,1,0,2008,NA,NA,568,254,314,171,82,89,0.35000000000000003,0.26,0.3,25538,54,126,354
197045,Utica College,1,0,2009,NA,NA,559,271,288,161,76,85,0.31,0.26,0.29,27764,55,131,351
197045,Utica College,1,0,2010,NA,NA,564,281,283,190,83,107,0.38,0.29,0.34,28100,58,136,376
197133,VASSAR COLLEGE,1,0,1991,NA,NA,592,364,228,460,167,293,0.8,0.73,0.78,16510,74,209,454
197133,VASSAR COLLEGE,1,0,1992,NA,NA,597,370,227,478,175,303,0.81,0.77,0.8,17620,81,218,458
197133,VASSAR COLLEGE,1,0,1993,NA,NA,649,414,235,497,169,328,0.79,0.72,0.77,18456,86,218,490
197133,VASSAR COLLEGE,1,0,1995,NA,NA,632,381,251,509,193,316,0.8200000000000001,0.77,0.81,20420,89,215,511
197133,VASSAR COLLEGE,1,0,1996,NA,NA,614,375,239,499,191,308,0.8200000000000001,0.8,0.81,21330,98,215,466
197133,VASSAR COLLEGE,1,0,1997,NA,NA,646,409,237,529,186,343,0.8300000000000001,0.78,0.82,22090,95,215,482
197133,VASSAR COLLEGE,1,0,1998,NA,NA,626,379,247,504,191,313,0.8200000000000001,0.77,0.81,23000,99,215,470
197133,VASSAR COLLEGE,1,0,1999,NA,NA,633,381,252,543,209,334,0.87,0.83,0.86,23700,105,247,478
197133,VASSAR COLLEGE,1,0,2000,NA,NA,639,389,250,544,211,333,0.85,0.84,0.85,24610,110,246,484
197133,VASSAR COLLEGE,1,0,2001,NA,NA,695,447,248,612,211,401,0.89,0.85,0.88,25890,99,246,508
197133,VASSAR COLLEGE,1,0,2002,NA,NA,632,377,255,552,217,335,0.88,0.85,0.87,27550,108,258,473
197133,VASSAR COLLEGE,1,0,2003,NA,NA,631,367,264,554,226,328,0.89,0.86,0.88,29095,114,253,478
197133,VASSAR COLLEGE,1,0,2004,NA,NA,654,419,235,586,198,388,0.92,0.84,0.9,30895,123,267,466
197133,Vassar College,1,0,2005,NA,NA,647,374,273,572,238,334,0.89,0.87,0.88,33310,133,277,482
197133,Vassar College,1,0,2006,NA,NA,668,412,256,534,173,361,0.87,0.68,0.8,35520,138,281,488
197133,Vassar College,1,0,2007,NA,NA,677,409,268,607,233,374,0.91,0.87,0.9,37570,149,293,467
197133,Vassar College,1,0,2008,NA,NA,638,365,273,560,235,325,0.89,0.86,0.88,39635,155,299,444
197133,Vassar College,1,0,2009,NA,NA,658,392,266,568,217,351,0.89,0.82,0.86,41335,163,296,430
197133,Vassar College,1,0,2010,NA,NA,665,382,283,576,242,334,0.87,0.86,0.87,42560,164,279,419
197869,APPALACHIAN STATE UNIVERSITY,1,0,1991,NA,NA,1916,1025,891,562,185,377,0.36,0.21,0.29,1166,115,533,1780
197869,APPALACHIAN STATE UNIVERSITY,1,0,1992,NA,NA,2060,1146,914,621,215,406,0.35000000000000003,0.24,0.3,1264,122,539,1944
197869,APPALACHIAN STATE UNIVERSITY,1,0,1993,NA,NA,1931,1098,833,603,192,411,0.37,0.23,0.31,1459,127,545,1809
197869,APPALACHIAN STATE UNIVERSITY,1,0,1995,NA,NA,2205,1198,1007,749,273,476,0.39,0.27,0.34,1627,142,572,2082
197869,APPALACHIAN STATE UNIVERSITY,1,0,1996,NA,NA,2026,1111,915,689,226,463,0.41000000000000003,0.25,0.34,1663,153,583,1920
197869,APPALACHIAN STATE UNIVERSITY,1,0,1997,NA,NA,2161,1177,984,711,235,476,0.4,0.24,0.33,1703,154,574,2029
197869,APPALACHIAN STATE UNIVERSITY,1,0,1998,NA,NA,2312,1192,1120,687,239,448,0.37,0.21,0.3,1753,172,581,2184
197869,APPALACHIAN STATE UNIVERSITY,1,0,1999,NA,NA,2199,1186,1013,778,266,512,0.43,0.26,0.35,962,184,592,2059
197869,APPALACHIAN STATE UNIVERSITY,1,0,2000,NA,NA,2544,1370,1174,872,285,587,0.42,0.24,0.34,982,191,612,2380
197869,APPALACHIAN STATE UNIVERSITY,1,0,2001,NA,NA,2303,1196,1107,857,309,548,0.45,0.28,0.37,1222,212,633,2181
197869,APPALACHIAN STATE UNIVERSITY,1,0,2002,NA,NA,2412,1261,1151,964,385,579,0.45,0.33,0.4,1520,198,619,2165
197869,APPALACHIAN STATE UNIVERSITY,1,0,2003,NA,NA,2462,1216,1246,920,360,560,0.46,0.29,0.37,1596,209,663,2219
197869,APPALACHIAN STATE UNIVERSITY,1,0,2004,NA,NA,2507,1247,1260,941,357,584,0.46,0.28,0.38,1821,217,674,2229
197869,Appalachian State University,1,0,2005,NA,NA,2536,1265,1271,974,391,583,0.46,0.31,0.38,1821,229,703,2308
197869,Appalachian State University,1,0,2006,NA,NA,2707,1403,1304,1080,402,678,0.48,0.31,0.4,2221,254,710,2369
197869,Appalachian State University,1,0,2007,NA,NA,2730,1401,1329,1133,431,702,0.5,0.32,0.42,2221,278,737,2347
197869,Appalachian State University,1,0,2008,NA,NA,2768,1415,1353,1221,462,759,0.53,0.34,0.44,2263,308,779,2403
197869,Appalachian State University,1,0,2009,NA,NA,2732,1471,1261,1267,464,803,0.54,0.37,0.46,2341,317,824,2437
197869,Appalachian State University,1,0,2010,NA,NA,2816,1538,1278,1387,500,887,0.5700000000000001,0.39,0.49,2961,337,862,2434
197984,BELMONT ABBEY COLLEGE,1,0,1991,NA,NA,174,92,82,56,21,35,0.38,0.26,0.32,7470,11,51,141
197984,BELMONT ABBEY COLLEGE,1,0,1992,NA,NA,145,67,78,42,22,20,0.29,0.28,0.29,7974,11,49,122
197984,BELMONT ABBEY COLLEGE,1,0,1993,NA,NA,136,69,67,44,20,24,0.34,0.3,0.32,8684,12,46,120
197984,BELMONT ABBEY COLLEGE,1,0,1995,NA,NA,114,45,69,47,26,21,0.46,0.38,0.41,9818,11,41,98
197984,BELMONT ABBEY COLLEGE,1,0,1996,NA,NA,181,93,88,62,30,32,0.34,0.34,0.34,10408,11,36,156
197984,BELMONT ABBEY COLLEGE,1,0,1997,NA,NA,159,68,91,61,27,34,0.5,0.3,0.38,11034,9,36,133
197984,BELMONT ABBEY COLLEGE,1,0,1998,NA,NA,198,94,104,87,41,46,0.48,0.39,0.44,11640,13,38,179
197984,BELMONT ABBEY COLLEGE,1,0,1999,NA,NA,195,90,105,57,27,30,0.33,0.26,0.29,11650,14,40,163
197984,BELMONT ABBEY COLLEGE,1,0,2000,NA,NA,188,113,75,63,22,41,0.36,0.29,0.34,12116,15,41,162
197984,BELMONT ABBEY COLLEGE,1,0,2001,NA,NA,143,68,75,61,22,39,0.5700000000000001,0.29,0.43,12722,16,43,113
197984,BELMONT ABBEY COLLEGE,1,0,2002,NA,NA,223,136,87,64,20,44,0.32,0.23,0.29,13358,17,43,137
197984,BELMONT ABBEY COLLEGE,1,0,2003,NA,NA,147,70,77,48,25,23,0.32,0.32,0.33,14160,18,43,110
197984,BELMONT ABBEY COLLEGE,1,0,2004,NA,NA,174,96,78,47,20,27,0.28,0.26,0.27,15010,17,40,123
197984,Belmont Abbey College,1,0,2005,NA,NA,224,109,115,75,23,52,0.47000000000000003,0.2,0.33,15910,18,48,154
197984,Belmont Abbey College,1,0,2006,NA,NA,279,142,137,94,34,60,0.42,0.25,0.34,16870,18,53,198
197984,Belmont Abbey College,1,0,2007,NA,NA,210,90,120,69,28,41,0.45,0.23,0.33,17880,19,54,144
197984,Belmont Abbey College,1,0,2008,NA,NA,286,134,152,93,39,54,0.4,0.26,0.33,19114,21,59,184
197984,Belmont Abbey College,1,0,2009,NA,NA,396,224,172,138,50,88,0.39,0.29,0.35,20356,23,69,211
197984,Belmont Abbey College,1,0,2010,NA,NA,307,139,168,103,53,50,0.35000000000000003,0.32,0.34,23183,24,72,21
198385,DAVIDSON COLLEGE,1,0,1991,NA,NA,397,179,218,339,178,161,0.89,0.82,0.85,14058,40,126,352
198385,DAVIDSON COLLEGE,1,0,1992,NA,NA,414,221,193,367,170,197,0.89,0.88,0.89,14950,44,126,375
198385,DAVIDSON COLLEGE,1,0,1993,NA,NA,452,195,257,381,212,169,0.86,0.82,0.84,16263,48,130,383
198385,DAVIDSON COLLEGE,1,0,1995,NA,NA,429,209,220,373,186,187,0.89,0.85,0.87,18626,54,137,373
198385,DAVIDSON COLLEGE,1,0,1996,NA,NA,439,230,209,385,181,204,0.88,0.87,0.88,19631,56,137,399
198385,DAVIDSON COLLEGE,1,0,1997,NA,NA,470,230,240,417,206,211,0.91,0.86,0.89,20595,49,147,407
198385,DAVIDSON COLLEGE,1,0,1998,NA,NA,472,253,219,423,198,225,0.88,0.9,0.9,21395,51,145,405
198385,DAVIDSON COLLEGE,1,0,1999,NA,NA,456,226,230,380,187,193,0.85,0.81,0.83,22014,57,152,394
198385,DAVIDSON COLLEGE,1,0,2000,NA,NA,465,229,236,413,193,220,0.96,0.82,0.89,22872,62,153,407
198385,DAVIDSON COLLEGE,1,0,2001,NA,NA,465,246,219,420,193,227,0.92,0.88,0.9,23739,67,154,369
198385,DAVIDSON COLLEGE,1,0,2002,NA,NA,468,243,225,430,201,229,0.9400000000000001,0.89,0.92,24930,72,159,382
198385,DAVIDSON COLLEGE,1,0,2003,NA,NA,489,237,252,435,218,217,0.91,0.87,0.89,24987,75,159,385
198385,DAVIDSON COLLEGE,1,0,2004,NA,NA,462,238,224,410,192,218,0.91,0.86,0.89,26211,76,158,345
198385,Davidson College,1,0,2005,NA,NA,459,234,225,400,182,218,0.93,0.81,0.87,27653,82,158,358
198385,Davidson College,1,0,2006,NA,NA,461,233,228,410,197,213,0.91,0.86,0.89,29119,82,162,340
198385,Davidson College,1,0,2007,NA,NA,464,234,230,417,198,219,0.93,0.86,0.9,30662,89,167,346
198385,Davidson College,1,0,2008,NA,NA,480,250,230,436,209,227,0.9,0.91,0.91,33148,91,168,345
198385,Davidson College,1,0,2009,NA,NA,487,252,235,438,207,231,0.91,0.88,0.9,34776,93,164,365
198385,Davidson College,1,0,2010,NA,NA,499,246,253,452,223,229,0.93,0.88,0.91,36320,90,166,344
198464,EAST CAROLINA UNIVERSITY,1,0,1991,NA,NA,2338,1288,1050,386,124,262,0.2,0.12,0.17,1204,225,741,2025
198464,EAST CAROLINA UNIVERSITY,1,0,1992,NA,NA,2880,1673,1207,561,166,395,0.23,0.14,0.19,1246,245,791,2552
198464,EAST CAROLINA UNIVERSITY,1,0,1993,NA,NA,2428,1417,1011,558,151,407,0.28,0.15,0.23,1366,272,792,2106
198464,EAST CAROLINA UNIVERSITY,1,0,1995,NA,NA,2635,1550,1085,630,189,441,0.28,0.17,0.24,1673,289,804,2263
198464,EAST CAROLINA UNIVERSITY,1,0,1996,NA,NA,2626,1581,1045,673,216,457,0.28,0.21,0.26,1752,292,804,2208
198464,EAST CAROLINA UNIVERSITY,1,0,1997,NA,NA,2871,1718,1153,705,222,483,0.28,0.19,0.25,1832,315,808,2411
198464,EAST CAROLINA UNIVERSITY,1,0,1998,NA,NA,2803,1714,1089,720,196,524,0.3,0.18,0.26,1886,344,808,2288
198464,EAST CAROLINA UNIVERSITY,1,0,1999,NA,NA,3255,1931,1324,822,266,556,0.28,0.2,0.25,992,366,827,2600
198464,EAST CAROLINA UNIVERSITY,1,0,2000,NA,NA,3105,1837,1268,856,248,608,0.33,0.2,0.28,1195,386,791,2533
198464,EAST CAROLINA UNIVERSITY,1,0,2001,NA,NA,3182,1877,1305,813,242,571,0.3,0.19,0.26,1453,421,755,2576
198464,EAST CAROLINA UNIVERSITY,1,0,2002,NA,NA,3561,2117,1444,968,294,674,0.31,0.2,0.27,1819,411,791,2973
198464,EAST CAROLINA UNIVERSITY,1,0,2003,NA,NA,3458,2117,1341,1035,293,742,0.35000000000000003,0.22,0.3,1910,426,886,2811
198464,EAST CAROLINA UNIVERSITY,1,0,2004,NA,NA,3451,2143,1308,1009,294,715,0.33,0.22,0.29,2135,476,932,2746
198464,East Carolina University,1,0,2005,NA,NA,3220,1973,1247,1048,345,703,0.35000000000000003,0.28,0.33,2135,526,961,2505
198464,East Carolina University,1,0,2006,NA,NA,3784,2331,1453,1240,347,893,0.38,0.24,0.33,2335,575,1033,2820
198464,East Carolina University,1,0,2007,NA,NA,4195,2535,1660,1294,391,903,0.35000000000000003,0.24,0.31,2431,631,1058,3123
198464,East Carolina University,1,0,2008,NA,NA,4515,2608,1907,1468,483,985,0.37,0.25,0.33,2445,658,1280,3483
198464,East Carolina University,1,0,2009,NA,NA,3942,2273,1669,1397,445,952,0.41000000000000003,0.27,0.35,2491,704,1234,3021
198464,East Carolina University,1,0,2010,NA,NA,4196,2446,1750,1417,448,969,0.39,0.26,0.34,2881,728,1246,2984
198507,ELIZABETH CITY STATE UNIVERSITY,1,0,1991,NA,NA,402,217,185,135,48,87,0.4,0.26,0.34,1150,24,103,49
198507,ELIZABETH CITY STATE UNIVERSITY,1,0,1992,NA,NA,541,317,224,181,47,134,0.42,0.21,0.33,1184,28,105,72
198507,ELIZABETH CITY STATE UNIVERSITY,1,0,1993,NA,NA,460,273,187,164,47,117,0.42,0.25,0.36,1242,31,105,93
198507,ELIZABETH CITY STATE UNIVERSITY,1,0,1995,NA,NA,381,222,159,162,47,115,0.51,0.3,0.43,1410,34,109,49
198507,ELIZABETH CITY STATE UNIVERSITY,1,0,1996,NA,NA,380,205,175,130,44,86,0.41000000000000003,0.25,0.34,1468,37,108,66
198507,ELIZABETH CITY STATE UNIVERSITY,1,0,1997,NA,NA,424,251,173,133,33,100,0.39,0.19,0.31,1522,38,86,70
198507,ELIZABETH CITY STATE UNIVERSITY,1,0,1998,NA,NA,378,229,149,109,22,87,0.37,0.15,0.29,1572,39,98,51
198507,ELIZABETH CITY STATE UNIVERSITY,1,0,1999,NA,NA,402,247,155,109,22,87,0.35000000000000003,0.14,0.27,806,39,109,71
198507,ELIZABETH CITY STATE UNIVERSITY,1,0,2000,NA,NA,441,248,193,133,32,101,0.4,0.17,0.3,822,41,105,51
198507,ELIZABETH CITY STATE UNIVERSITY,1,0,2001,NA,NA,363,200,163,102,32,70,0.35000000000000003,0.2,0.28,896,42,102,49
198507,ELIZABETH CITY STATE UNIVERSITY,1,0,2002,NA,NA,458,270,188,108,16,92,0.34,0.09,0.24,1118,40,122,60
198507,ELIZABETH CITY STATE UNIVERSITY,1,0,2003,NA,NA,459,258,201,104,36,68,0.26,0.18,0.23,1174,45,133,73
198507,ELIZABETH CITY STATE UNIVERSITY,1,0,2004,NA,NA,554,295,259,107,30,77,0.26,0.12,0.19,1399,46,131,78
198507,Elizabeth City State University,1,0,2005,NA,NA,556,328,228,99,28,71,0.21,0.12,0.18,1399,50,128,66
198507,Elizabeth City State University,1,0,2006,NA,NA,534,313,221,90,20,70,0.22,0.09,0.17,1490,59,149,49
198507,Elizabeth City State University,1,0,2007,NA,NA,642,391,251,138,39,99,0.25,0.16,0.21,1587,64,175,49
198507,Elizabeth City State University,1,0,2008,NA,NA,636,368,268,95,25,70,0.19,0.09,0.15,1611,73,161,41
198507,Elizabeth City State University,1,0,2009,NA,NA,659,375,284,106,35,71,0.18,0.12,0.16,1681,76,165,70
198507,Elizabeth City State University,1,0,2010,NA,NA,573,319,254,94,31,63,0.19,0.12,0.16,2204,76,170,45
198516,ELON COLLEGE,1,0,1991,NA,NA,780,461,319,381,121,260,0.56,0.38,0.49,7520,31,134,729
198516,ELON COLLEGE,1,0,1992,NA,NA,817,470,347,455,175,280,0.59,0.5,0.56,8110,29,136,742
198516,ELON COLLEGE,1,0,1993,NA,NA,857,492,365,478,197,281,0.5700000000000001,0.54,0.56,8630,35,138,787
198516,ELON COLLEGE,1,0,1995,NA,NA,907,545,362,548,198,350,0.64,0.55,0.6,9910,42,148,827
198516,ELON COLLEGE,1,0,1996,NA,NA,941,569,372,551,204,347,0.6,0.55,0.59,10667,45,151,851
198516,ELON COLLEGE,1,0,1997,NA,NA,964,584,380,599,207,392,0.67,0.54,0.62,11542,39,158,860
198516,ELON COLLEGE,1,0,1998,NA,NA,1013,632,381,660,234,426,0.67,0.61,0.65,12147,45,175,894
198516,ELON COLLEGE,1,0,1999,NA,NA,999,637,362,701,232,469,0.73,0.64,0.7,12671,49,192,885
198516,ELON COLLEGE,1,0,2000,NA,NA,1144,718,426,744,244,500,0.6900000000000001,0.57,0.65,13556,55,201,1034
198516,ELON UNIVERSITY,1,0,2001,NA,NA,1212,757,455,797,263,534,0.7000000000000001,0.58,0.66,14335,63,210,1058
198516,ELON UNIVERSITY,1,0,2002,NA,NA,1192,736,456,856,308,548,0.74,0.68,0.72,15280,70,235,1054
198516,ELON UNIVERSITY,1,0,2003,NA,NA,1227,775,452,875,294,581,0.74,0.65,0.71,16325,78,252,1083
198516,ELON UNIVERSITY,1,0,2004,NA,NA,1230,775,455,918,319,599,0.77,0.7,0.75,17310,83,261,1038
198516,Elon University,1,0,2005,NA,NA,1237,748,489,959,370,589,0.78,0.76,0.78,18699,90,279,1060
198516,Elon University,1,0,2006,NA,NA,1283,740,543,991,378,613,0.8200000000000001,0.7,0.77,20171,100,291,1064
198516,Elon University,1,0,2007,NA,NA,1286,746,540,987,380,607,0.81,0.7,0.77,21886,115,311,1055
198516,Elon University,1,0,2008,NA,NA,1290,777,513,977,358,619,0.79,0.7,0.76,23746,129,333,983
198516,Elon University,1,0,2009,NA,NA,1290,774,516,1025,374,651,0.84,0.72,0.79,25159,141,343,1065
198516,Elon University,1,0,2010,NA,NA,1359,794,565,1041,386,655,0.8200000000000001,0.68,0.77,26480,141,358,1052
198835,LENOIR-RHYNE COLLEGE,1,0,1991,NA,NA,279,153,126,113,33,80,0.52,0.26,0.41,8520,22,95,251
198835,LENOIR-RHYNE COLLEGE,1,0,1992,NA,NA,255,162,93,104,30,74,0.45,0.32,0.41,9500,21,95,227
198835,LENOIR-RHYNE COLLEGE,1,0,1993,NA,NA,254,135,119,115,39,76,0.56,0.33,0.45,10220,19,91,229
198835,LENOIR-RHYNE COLLEGE,1,0,1995,NA,NA,287,157,130,132,47,85,0.54,0.36,0.46,10960,19,91,258
198835,LENOIR-RHYNE COLLEGE,1,0,1996,NA,NA,232,135,97,96,32,64,0.47000000000000003,0.33,0.41,11416,21,98,205
198835,LENOIR-RHYNE COLLEGE,1,0,1997,NA,NA,306,167,139,119,41,78,0.46,0.29,0.39,12036,16,102,270
198835,LENOIR-RHYNE COLLEGE,1,0,1998,NA,NA,267,138,129,112,38,74,0.53,0.29,0.42,12386,18,104,219
198835,LENOIR-RHYNE COLLEGE,1,0,1999,NA,NA,288,168,120,117,37,80,0.47000000000000003,0.31,0.41,12310,19,101,228
198835,LENOIR-RHYNE COLLEGE,1,0,2000,NA,NA,268,142,126,122,42,80,0.56,0.33,0.46,12870,16,98,229
198835,LENOIR-RHYNE COLLEGE,1,0,2001,NA,NA,268,159,109,107,27,80,0.5,0.25,0.4,13600,21,95,234
198835,LENOIR-RHYNE COLLEGE,1,0,2002,NA,NA,319,161,158,145,69,76,0.47000000000000003,0.44,0.45,14350,22,95,271
198835,LENOIR-RHYNE COLLEGE,1,0,2003,NA,NA,308,178,130,124,45,79,0.44,0.35,0.4,15750,23,86,264
198835,LENOIR-RHYNE COLLEGE,1,0,2004,NA,NA,322,196,126,123,35,88,0.44,0.28,0.38,17120,22,90,262
198835,Lenoir-Rhyne College,1,0,2005,NA,NA,326,203,123,122,37,85,0.41000000000000003,0.3,0.37,18130,24,88,264
198835,Lenoir-Rhyne College,1,0,2006,NA,NA,347,195,152,117,40,77,0.39,0.26,0.34,19350,25,90,275
198835,Lenoir-Rhyne College,1,0,2007,NA,NA,367,214,153,146,48,98,0.45,0.31,0.4,20690,27,93,288
198835,Lenoir-Rhyne University,1,0,2008,NA,NA,345,217,128,140,32,108,0.49,0.25,0.41,23070,28,93,259
198835,Lenoir-Rhyne University,1,0,2009,NA,NA,355,215,140,119,36,83,0.38,0.26,0.34,24200,30,88,170
198835,Lenoir-Rhyne University,1,0,2010,NA,NA,423,229,194,149,53,96,0.41000000000000003,0.27,0.35,25290,29,89,325
198969,METHODIST COLLEGE,1,0,1991,NA,NA,254,86,168,59,35,24,0.27,0.21,0.23,7700,11,53,217
198969,METHODIST COLLEGE,1,0,1992,NA,NA,290,98,192,54,36,18,0.18,0.19,0.19,8250,14,58,217
198969,METHODIST COLLEGE,1,0,1993,NA,NA,310,81,229,49,28,21,0.25,0.12,0.16,8850,16,62,227
198969,METHODIST COLLEGE,1,0,1995,NA,NA,370,121,249,67,37,30,0.24,0.15,0.18,9950,20,94,267
198969,METHODIST COLLEGE,1,0,1996,NA,NA,320,100,220,55,30,25,0.25,0.14,0.17,10600,22,93,241
198969,METHODIST COLLEGE,1,0,1997,NA,NA,350,107,243,69,41,28,0.26,0.17,0.2,11250,17,87,270
198969,METHODIST COLLEGE,1,0,1998,NA,NA,437,117,320,88,55,33,0.28,0.17,0.2,11900,18,82,312
198969,METHODIST COLLEGE,1,0,1999,NA,NA,378,123,255,53,23,30,0.24,0.09,0.14,12600,20,101,285
198969,METHODIST COLLEGE,1,0,2000,NA,NA,308,115,193,46,18,28,0.24,0.09,0.15,13300,22,98,226
198969,METHODIST COLLEGE,1,0,2001,NA,NA,379,117,262,59,28,31,0.26,0.11,0.16,14070,23,95,265
198969,METHODIST COLLEGE,1,0,2002,NA,NA,395,118,277,58,20,38,0.32,0.07,0.15,14840,26,100,274
198969,METHODIST COLLEGE,1,0,2003,NA,NA,384,120,264,58,26,32,0.26,0.1,0.15,15650,27,101,275
198969,METHODIST COLLEGE,1,0,2004,NA,NA,435,143,292,71,25,46,0.32,0.09,0.16,16500,27,108,290
198969,Methodist College,1,0,2005,NA,NA,387,143,244,59,22,37,0.25,0.09,0.15,17580,29,119,266
198969,Methodist University,1,0,2006,NA,NA,449,135,314,75,31,44,0.32,0.1,0.17,18780,31,117,306
198969,Methodist University,1,0,2007,NA,NA,433,138,295,76,31,45,0.32,0.11,0.18,20050,34,127,262
198969,Methodist University,1,0,2008,NA,NA,439,148,291,64,26,38,0.25,0.09,0.15,21470,34,127,239
198969,Methodist University,1,0,2009,NA,NA,472,144,328,80,35,45,0.31,0.11,0.17,22620,36,128,161
198969,Methodist University,1,0,2010,NA,NA,531,190,341,104,46,58,0.3,0.13,0.2,23780,37,139,282
199102,NORTH CAROLINA AGRICULTURAL AND TECHNICAL ST UNIV,1,0,1991,NA,NA,1469,803,666,275,63,212,0.26,0.09,0.19,1228,78,318,35
199102,NORTH CAROLINA AGRICULTURAL AND TECHNICAL ST UNIV,1,0,1992,NA,NA,1484,780,704,290,86,204,0.26,0.12,0.2,1270,83,352,40
199102,NORTH CAROLINA AGRICULTURAL AND TECHNICAL ST UNIV,1,0,1993,NA,NA,1429,775,654,300,85,215,0.27,0.13,0.21,1367,90,361,40
199102,NORTH CAROLINA AGRICULTURAL AND TECHNICAL ST UNIV,1,0,1995,NA,NA,1396,706,690,339,117,222,0.31,0.17,0.24,1532,111,398,40
199102,NORTH CAROLINA AGRICULTURAL AND TECHNICAL ST UNIV,1,0,1996,NA,NA,1313,692,621,300,90,210,0.3,0.14,0.23,1561,114,414,30
199102,NORTH CAROLINA AGRICULTURAL AND TECHNICAL ST UNIV,1,0,1997,NA,NA,1383,727,656,363,118,245,0.33,0.18,0.26,1622,120,401,43
199102,NORTH CAROLINA AGRICULTURAL AND TECHNICAL ST UNIV,1,0,1998,NA,NA,1366,695,671,323,104,219,0.31,0.15,0.24,1680,121,412,34
199102,NORTH CAROLINA AGRICULTURAL AND TECHNICAL ST UNIV,1,0,1999,NA,NA,1530,850,680,348,112,236,0.27,0.16,0.23,962,129,369,37
199102,NORTH CAROLINA AGRICULTURAL AND TECHNICAL ST UNIV,1,0,2000,NA,NA,1661,884,777,321,97,224,0.25,0.12,0.19,982,139,368,46
199102,NORTH CAROLINA AGRICULTURAL AND TECHNICAL ST UNIV,1,0,2001,NA,NA,1760,874,886,354,117,237,0.27,0.13,0.2,1222,150,368,56
199102,NORTH CAROLINA AGRICULTURAL AND TECHNICAL ST UNIV,1,0,2002,NA,NA,2025,1043,982,299,90,209,0.2,0.09,0.15,1470,145,367,60
199102,NORTH CAROLINA A & T STATE UNIVERSITY,1,0,2003,NA,NA,2221,1176,1045,389,104,285,0.24,0.1,0.18,1544,160,307,69
199102,NORTH CAROLINA  A &T STATE UNIVERSITY,1,0,2004,NA,NA,2212,1147,1065,335,86,249,0.21,0.08,0.15,1769,173,339,39
199102,North Carolina A & T State University,1,0,2005,NA,NA,2237,1178,1059,369,116,253,0.21,0.11,0.16,1769,196,364,34
199102,North Carolina A & T State University,1,0,2006,NA,NA,2068,1102,966,340,81,259,0.23,0.08,0.16,1994,205,425,53
199102,North Carolina A & T State University,1,0,2007,NA,NA,1569,819,750,251,64,187,0.22,0.09,0.16,1994,219,442,34
199102,North Carolina A & T State University,1,0,2008,NA,NA,1592,848,744,342,105,237,0.27,0.14,0.21,1994,227,472,44
199102,North Carolina A & T State University,1,0,2009,NA,NA,1875,1028,847,383,116,267,0.25,0.14,0.2,1994,236,522,45
199102,North Carolina A & T State University,1,0,2010,NA,NA,2040,1065,975,374,108,266,0.24,0.11,0.18,2621,257,519,38
199111,UNIVERSITY OF NORTH CAROLINA AT ASHEVILLE,1,0,1991,NA,NA,336,199,137,77,18,59,0.29,0.13,0.23,1116,26,139,316
199111,UNIVERSITY OF NORTH CAROLINA AT ASHEVILLE,1,0,1992,NA,NA,364,195,169,101,33,68,0.34,0.2,0.28,1150,28,144,339
199111,UNIVERSITY OF NORTH CAROLINA AT ASHEVILLE,1,0,1993,NA,NA,394,222,172,129,42,87,0.39,0.24,0.33,1436,29,147,368
199111,UNIVERSITY OF NORTH CAROLINA AT ASHEVILLE,1,0,1995,NA,NA,393,235,158,123,35,88,0.37,0.22,0.31,1658,33,153,346
199111,UNIVERSITY OF NORTH CAROLINA AT ASHEVILLE,1,0,1996,NA,NA,450,275,175,139,42,97,0.35000000000000003,0.24,0.31,1723,35,158,408
199111,UNIVERSITY OF NORTH CAROLINA AT ASHEVILLE,1,0,1997,NA,NA,470,264,206,138,49,89,0.33,0.24,0.29,1784,37,156,427
199111,UNIVERSITY OF NORTH CAROLINA AT ASHEVILLE,1,0,1998,NA,NA,474,278,196,120,35,85,0.3,0.18,0.25,1832,40,161,434
199111,UNIVERSITY OF NORTH CAROLINA AT ASHEVILLE,1,0,1999,NA,NA,456,267,189,128,48,80,0.29,0.25,0.28,806,44,157,414
199111,UNIVERSITY OF NORTH CAROLINA AT ASHEVILLE,1,0,2000,NA,NA,496,284,212,154,54,100,0.35000000000000003,0.25,0.31,822,46,165,451
199111,UNIVERSITY OF NORTH CAROLINA AT ASHEVILLE,1,0,2001,NA,NA,446,281,165,149,43,106,0.37,0.26,0.33,1196,49,173,396
199111,UNIVERSITY OF NORTH CAROLINA AT ASHEVILLE,1,0,2002,NA,NA,421,250,171,140,41,99,0.39,0.24,0.33,1592,50,180,383
199111,UNIVERSITY OF NORTH CAROLINA AT ASHEVILLE,1,0,2003,NA,NA,590,332,258,170,45,125,0.37,0.17,0.29,1672,52,177,535
199111,UNIVERSITY OF NORTH CAROLINA AT ASHEVILLE,1,0,2004,NA,NA,694,418,276,208,59,149,0.35000000000000003,0.21,0.3,1897,56,184,626
199111,University of North Carolina at Asheville,1,0,2005,NA,NA,471,291,180,154,51,103,0.35000000000000003,0.28,0.33,1897,65,200,418
199111,University of North Carolina at Asheville,1,0,2006,NA,NA,567,328,239,180,57,123,0.37,0.24,0.32,2172,69,206,503
199111,University of North Carolina at Asheville,1,0,2007,NA,NA,571,341,230,211,67,144,0.42,0.29,0.37,2307,73,207,487
199111,University of North Carolina at Asheville,1,0,2008,NA,NA,586,361,225,225,77,148,0.41000000000000003,0.34,0.38,2339,76,207,498
199111,University of North Carolina at Asheville,1,0,2009,NA,NA,637,363,274,230,75,155,0.42,0.27,0.36,2389,77,208,556
199111,University of North Carolina at Asheville,1,0,2010,NA,NA,590,335,255,231,87,144,0.42,0.34,0.39,2626,77,217,497
199120,UNIVERSITY OF NORTH CAROLINA AT CHAPEL HILL,1,0,1991,NA,NA,3133,1941,1192,1966,672,1294,0.66,0.56,0.63,1248,686,1261,2589
199120,UNIVERSITY OF NORTH CAROLINA AT CHAPEL HILL,1,0,1992,NA,NA,3200,1957,1243,2009,733,1276,0.65,0.59,0.63,1249,729,1277,2626
199120,UNIVERSITY OF NORTH CAROLINA AT CHAPEL HILL,1,0,1993,NA,NA,3310,2048,1262,2089,744,1345,0.65,0.59,0.63,1419,792,1268,2702
199120,UNIVERSITY OF NORTH CAROLINA AT CHAPEL HILL,1,0,1995,NA,NA,3229,1982,1247,2101,732,1369,0.6900000000000001,0.59,0.65,1640,918,1261,2610
199120,UNIVERSITY OF NORTH CAROLINA AT CHAPEL HILL,1,0,1996,NA,NA,3270,2065,1205,2185,718,1467,0.71,0.6,0.67,2110,974,1225,2629
199120,UNIVERSITY OF NORTH CAROLINA AT CHAPEL HILL,1,0,1997,NA,NA,3412,2118,1294,2371,816,1555,0.73,0.63,0.69,2173,1050,1222,2728
199120,UNIVERSITY OF NORTH CAROLINA AT CHAPEL HILL,1,0,1998,NA,NA,3425,2116,1309,2289,794,1495,0.7000000000000001,0.61,0.67,2211,1116,1240,2778
199120,UNIVERSITY OF NORTH CAROLINA AT CHAPEL HILL,1,0,1999,NA,NA,3388,2099,1289,2389,797,1592,0.75,0.62,0.71,1528,1185,1285,2706
199120,UNIVERSITY OF NORTH CAROLINA AT CHAPEL HILL,1,0,2000,NA,NA,3406,2121,1285,2426,829,1597,0.75,0.65,0.71,1860,1259,1244,2680
199120,UNIVERSITY OF NORTH CAROLINA AT CHAPEL HILL,1,0,2001,NA,NA,3681,2195,1486,2611,986,1625,0.74,0.66,0.71,2328,1368,1203,2827
199120,UNIVERSITY OF NORTH CAROLINA AT CHAPEL HILL,1,0,2002,NA,NA,3455,2053,1402,2513,935,1578,0.76,0.67,0.73,2814,1499,1356,2581
199120,UNIVERSITY OF NORTH CAROLINA AT CHAPEL HILL,1,0,2003,NA,NA,3511,2068,1443,2535,945,1590,0.76,0.65,0.72,2955,1561,1296,2558
199120,UNIVERSITY OF NORTH CAROLINA AT CHAPEL HILL,1,0,2004,NA,NA,3584,2099,1485,2685,1027,1658,0.78,0.69,0.75,3205,1629,1318,2610
199120,University of North Carolina at Chapel Hill,1,0,2005,NA,NA,3747,2270,1477,2819,1050,1769,0.77,0.71,0.75,3205,1703,1382,2740
199120,University of North Carolina at Chapel Hill,1,0,2006,NA,NA,3796,2276,1520,2893,1107,1786,0.78,0.73,0.76,3455,1842,1490,2649
199120,University of North Carolina at Chapel Hill,1,0,2007,NA,NA,3877,2338,1539,3124,1151,1973,0.84,0.75,0.81,3705,1995,1514,2684
199120,University of North Carolina at Chapel Hill,1,0,2008,NA,NA,3852,2270,1582,3096,1188,1908,0.84,0.75,0.8,3705,2149,1600,2641
199120,University of North Carolina at Chapel Hill,1,0,2009,NA,NA,3955,2354,1601,3216,1225,1991,0.84,0.77,0.81,3865,2286,1628,2655
199120,University of North Carolina at Chapel Hill,1,0,2010,NA,NA,3944,2371,1573,3299,1235,2064,0.87,0.79,0.84,4815,2360,1671,2763
199139,UNIVERSITY OF NORTH CAROLINA AT CHARLOTTE,1,0,1991,NA,NA,1552,876,676,347,86,261,0.29,0.13,0.22,1147,107,611,1216
199139,UNIVERSITY OF NORTH CAROLINA AT CHARLOTTE,1,0,1992,NA,NA,1575,813,762,291,111,180,0.22,0.15,0.18,1189,118,639,1202
199139,UNIVERSITY OF NORTH CAROLINA AT CHARLOTTE,1,0,1993,NA,NA,1685,845,840,312,111,201,0.23,0.13,0.19,1383,125,643,1245
199139,UNIVERSITY OF NORTH CAROLINA AT CHARLOTTE,1,0,1995,NA,NA,1663,974,689,396,115,281,0.28,0.17,0.24,1618,142,625,1231
199139,UNIVERSITY OF NORTH CAROLINA AT CHARLOTTE,1,0,1996,NA,NA,1682,952,730,359,113,246,0.25,0.15,0.21,1716,167,637,1243
199139,UNIVERSITY OF NORTH CAROLINA AT CHARLOTTE,1,0,1997,NA,NA,1904,1077,827,418,155,263,0.24,0.19,0.22,1777,169,643,1417
199139,UNIVERSITY OF NORTH CAROLINA AT CHARLOTTE,1,0,1998,NA,NA,2122,1178,944,456,169,287,0.24,0.18,0.21,1834,186,644,1508
199139,UNIVERSITY OF NORTH CAROLINA AT CHARLOTTE,1,0,1999,NA,NA,2078,1111,967,489,181,308,0.27,0.19,0.24,962,195,664,1575
199139,UNIVERSITY OF NORTH CAROLINA AT CHARLOTTE,1,0,2000,NA,NA,2142,1208,934,553,194,359,0.29,0.21,0.26,1132,206,654,1648
199139,UNIVERSITY OF NORTH CAROLINA AT CHARLOTTE,1,0,2001,NA,NA,2309,1273,1036,610,209,401,0.31,0.2,0.26,1417,224,644,1795
199139,UNIVERSITY OF NORTH CAROLINA AT CHARLOTTE,1,0,2002,NA,NA,2383,1234,1149,577,204,373,0.3,0.18,0.24,1813,200,721,1890
199139,UNIVERSITY OF NORTH CAROLINA AT CHARLOTTE,1,0,2003,NA,NA,2472,1291,1181,630,244,386,0.29,0.21,0.25,1904,217,769,1975
199139,UNIVERSITY OF NORTH CAROLINA AT CHARLOTTE,1,0,2004,NA,NA,2599,1416,1183,707,249,458,0.32,0.21,0.27,2129,229,787,2092
199139,University of North Carolina at Charlotte,1,0,2005,NA,NA,2859,1498,1361,741,273,468,0.31,0.2,0.26,2129,258,837,2288
199139,University of North Carolina at Charlotte,1,0,2006,NA,NA,2764,1475,1289,728,280,448,0.3,0.22,0.26,2344,298,878,2161
199139,University of North Carolina at Charlotte,1,0,2007,NA,NA,2926,1520,1406,749,304,445,0.29,0.22,0.26,2461,342,922,2238
199139,University of North Carolina at Charlotte,1,0,2008,NA,NA,3059,1610,1449,766,289,477,0.29,0.2,0.25,2516,363,971,2238
199139,University of North Carolina at Charlotte,1,0,2009,NA,NA,3152,1571,1581,820,319,501,0.31,0.2,0.26,2516,391,953,2078
199139,University of North Carolina at Charlotte,1,0,2010,NA,NA,2947,1513,1434,840,312,528,0.34,0.22,0.29,3044,409,949,1927
199148,UNIVERSITY OF NORTH CAROLINA AT GREENSBORO,1,0,1991,NA,NA,1345,890,455,358,82,276,0.31,0.18,0.27,1492,101,568,1090
199148,UNIVERSITY OF NORTH CAROLINA AT GREENSBORO,1,0,1992,NA,NA,1509,1000,509,363,80,283,0.28,0.16,0.24,1540,113,580,1182
199148,UNIVERSITY OF NORTH CAROLINA AT GREENSBORO,1,0,1993,NA,NA,1500,959,541,297,61,236,0.24,0.11,0.2,1717,119,572,1187
199148,UNIVERSITY OF NORTH CAROLINA AT GREENSBORO,1,0,1995,NA,NA,1804,1234,570,376,77,299,0.24,0.14,0.21,1868,139,548,1333
199148,UNIVERSITY OF NORTH CAROLINA AT GREENSBORO,1,0,1996,NA,NA,1552,1075,477,390,77,313,0.29,0.16,0.25,1943,148,562,1182
199148,UNIVERSITY OF NORTH CAROLINA AT GREENSBORO,1,0,1997,NA,NA,1577,1091,486,431,90,341,0.31,0.19,0.27,2019,151,565,1150
199148,UNIVERSITY OF NORTH CAROLINA AT GREENSBORO,1,0,1998,NA,NA,1791,1257,534,472,94,378,0.3,0.18,0.26,2039,170,587,1283
199148,UNIVERSITY OF NORTH CAROLINA AT GREENSBORO,1,0,1999,NA,NA,1908,1346,562,540,107,433,0.32,0.19,0.28,1086,195,601,1373
199148,UNIVERSITY OF NORTH CAROLINA AT GREENSBORO,1,0,2000,NA,NA,1867,1355,512,556,112,444,0.32,0.22,0.3,1108,203,624,1363
199148,UNIVERSITY OF NORTH CAROLINA AT GREENSBORO,1,0,2001,NA,NA,1898,1350,548,511,102,409,0.3,0.19,0.27,1358,218,647,1336
199148,UNIVERSITY OF NORTH CAROLINA AT GREENSBORO,1,0,2002,NA,NA,2071,1420,651,570,118,452,0.31,0.18,0.28,1717,203,629,1487
199148,UNIVERSITY OF NORTH CAROLINA AT GREENSBORO,1,0,2003,NA,NA,2039,1422,617,577,123,454,0.31,0.2,0.28,1803,218,686,1436
199148,UNIVERSITY OF NORTH CAROLINA AT GREENSBORO,1,0,2004,NA,NA,2159,1525,634,625,124,501,0.32,0.2,0.29,2028,238,695,1517
199148,University of North Carolina at Greensboro,1,0,2005,NA,NA,2399,1690,709,670,125,545,0.32,0.18,0.28,2028,249,727,1664
199148,University of North Carolina at Greensboro,1,0,2006,NA,NA,2400,1698,702,706,128,578,0.34,0.18,0.29,2308,273,736,1546
199148,University of North Carolina at Greensboro,1,0,2007,NA,NA,2431,1689,742,721,166,555,0.32,0.22,0.3,2458,301,784,1532
199148,University of North Carolina at Greensboro,1,0,2008,NA,NA,2471,1703,768,759,183,576,0.33,0.24,0.31,2507,321,796,1581
199148,University of North Carolina at Greensboro,1,0,2009,NA,NA,2495,1733,762,804,180,624,0.36,0.24,0.32,2590,336,788,1553
199148,University of North Carolina at Greensboro,1,0,2010,NA,NA,2505,1722,783,762,162,600,0.34,0.21,0.3,3243,360,839,1485
199157,NORTH CAROLINA CENTRAL UNIVERSITY,1,0,1991,NA,NA,531,336,195,93,21,72,0.21,0.11,0.18,1169,50,234,7
199157,NORTH CAROLINA CENTRAL UNIVERSITY,1,0,1992,NA,NA,759,452,307,134,30,104,0.23,0.1,0.18,1211,51,241,12
199157,NORTH CAROLINA CENTRAL UNIVERSITY,1,0,1993,NA,NA,810,525,285,201,40,161,0.3,0.14,0.25,1338,53,263,5
199157,NORTH CAROLINA CENTRAL UNIVERSITY,1,0,1995,NA,NA,510,309,201,139,34,105,0.33,0.17,0.27,1512,64,269,21
199157,NORTH CAROLINA CENTRAL UNIVERSITY,1,0,1996,NA,NA,681,441,240,179,38,141,0.31,0.16,0.26,1595,67,281,11
199157,NORTH CAROLINA CENTRAL UNIVERSITY,1,0,1997,NA,NA,712,467,245,202,45,157,0.33,0.18,0.28,1736,72,261,17
199157,NORTH CAROLINA CENTRAL UNIVERSITY,1,0,1998,NA,NA,673,409,264,184,41,143,0.34,0.16,0.27,1793,75,264,17
199157,NORTH CAROLINA CENTRAL UNIVERSITY,1,0,1999,NA,NA,625,345,280,143,31,112,0.32,0.11,0.23,962,82,265,9
199157,NORTH CAROLINA CENTRAL UNIVERSITY,1,0,2000,NA,NA,720,443,277,162,26,136,0.3,0.09,0.22,982,84,251,12
199157,NORTH CAROLINA CENTRAL UNIVERSITY,1,0,2001,NA,NA,763,492,271,174,29,145,0.29,0.11,0.23,1272,88,237,9
199157,NORTH CAROLINA CENTRAL UNIVERSITY,1,0,2002,NA,NA,821,542,279,191,42,149,0.27,0.15,0.23,1574,96,234,15
199157,NORTH CAROLINA CENTRAL UNIVERSITY,1,0,2003,NA,NA,1025,679,346,190,32,158,0.23,0.09,0.19,1653,102,250,13
199157,NORTH CAROLINA CENTRAL UNIVERSITY,1,0,2004,NA,NA,1138,732,406,205,51,154,0.21,0.13,0.18,1878,122,240,18
199157,North Carolina Central University,1,0,2005,NA,NA,1195,800,395,181,45,136,0.17,0.11,0.15,1878,131,281,20
199157,North Carolina Central University,1,0,2006,NA,NA,975,631,344,145,30,115,0.18,0.09,0.15,2078,146,319,18
199157,North Carolina Central University,1,0,2007,NA,NA,1236,764,472,185,47,138,0.18,0.1,0.15,2218,160,348,26
199157,North Carolina Central University,1,0,2008,NA,NA,1026,683,343,224,56,168,0.24,0.16,0.22,2218,170,366,23
199157,North Carolina Central University,1,0,2009,NA,NA,1345,858,487,215,49,166,0.19,0.1,0.16,2264,181,369,27
199157,North Carolina Central University,1,0,2010,NA,NA,1218,809,409,238,56,182,0.22,0.14,0.2,2812,184,412,22
199193,NORTH CAROLINA STATE UNIVERSITY AT RALEIGH,1,0,1991,NA,NA,3296,1290,2006,773,370,403,0.31,0.18,0.23,1238,460,1233,2724
199193,NORTH CAROLINA STATE UNIVERSITY AT RALEIGH,1,0,1992,NA,NA,3176,1219,1957,759,338,421,0.34,0.17,0.24,1286,478,1240,2589
199193,NORTH CAROLINA STATE UNIVERSITY AT RALEIGH,1,0,1993,NA,NA,3277,1248,2029,841,397,444,0.35000000000000003,0.2,0.26,1389,510,1235,2724
199193,NORTH CAROLINA STATE UNIVERSITY AT RALEIGH,1,0,1995,NA,NA,3607,1523,2084,900,395,505,0.33,0.19,0.25,1732,578,1210,2898
199193,NORTH CAROLINA STATE UNIVERSITY AT RALEIGH,1,0,1996,NA,NA,3630,1457,2173,968,442,526,0.36,0.2,0.27,2200,594,1198,2996
199193,NORTH CAROLINA STATE UNIVERSITY AT RALEIGH,1,0,1997,NA,NA,3756,1496,2260,961,427,534,0.35000000000000003,0.19,0.26,2270,638,1215,3049
199193,NORTH CAROLINA STATE UNIVERSITY AT RALEIGH,1,0,1998,NA,NA,3751,1513,2238,1075,492,583,0.38,0.22,0.29,2634,676,1171,3044
199193,NORTH CAROLINA STATE UNIVERSITY AT RALEIGH,1,0,1999,NA,NA,3636,1499,2137,1253,559,694,0.46,0.26,0.34,1528,733,1202,3029
199193,NORTH CAROLINA STATE UNIVERSITY AT RALEIGH,1,0,2000,NA,NA,3816,1622,2194,1379,634,745,0.45,0.29,0.36,1860,766,1234,3082
199193,NORTH CAROLINA STATE UNIVERSITY AT RALEIGH,1,0,2001,NA,NA,3862,1630,2232,1404,619,785,0.48,0.28,0.36,2328,816,1266,3128
199193,NORTH CAROLINA STATE UNIVERSITY AT RALEIGH,1,0,2002,NA,NA,3713,1561,2152,1391,580,811,0.51,0.27,0.37,2814,781,1285,3032
199193,NORTH CAROLINA STATE UNIVERSITY AT RALEIGH,1,0,2003,NA,NA,3915,1665,2250,1595,734,861,0.51,0.33,0.41,2955,811,1647,3235
199193,NORTH CAROLINA STATE UNIVERSITY AT RALEIGH,1,0,2004,NA,NA,3935,1702,2233,1585,682,903,0.53,0.31,0.4,3205,845,1638,3154
199193,North Carolina State University at Raleigh,1,0,2005,NA,NA,4364,1918,2446,1732,716,1016,0.52,0.29,0.4,3205,894,1671,3513
199193,North Carolina State University at Raleigh,1,0,2006,NA,NA,4667,2067,2600,1781,761,1020,0.49,0.29,0.38,3530,965,1652,3719
199193,North Carolina State University at Raleigh,1,0,2007,NA,NA,4895,2179,2716,1975,836,1139,0.52,0.31,0.4,3760,1026,1723,3908
199193,North Carolina State University at Raleigh,1,0,2008,NA,NA,4792,2184,2608,2029,863,1166,0.53,0.33,0.42,3860,1113,1768,3770
199193,North Carolina State University at Raleigh,1,0,2009,NA,NA,4716,2067,2649,2031,920,1111,0.53,0.35,0.43,3953,1138,1773,3589
199193,North Carolina State University at Raleigh,1,0,2010,NA,NA,4685,2098,2587,2187,962,1225,0.58,0.37,0.47,4853,1138,1755,3592
199218,UNIVERSITY OF NORTH CAROLINA AT WILMINGTON,1,0,1991,NA,NA,1545,923,622,385,111,274,0.29,0.18,0.25,1302,63,340,1444
199218,UNIVERSITY OF NORTH CAROLINA AT WILMINGTON,1,0,1992,NA,NA,1225,771,454,320,95,225,0.29,0.21,0.26,1344,70,356,1104
199218,UNIVERSITY OF NORTH CAROLINA AT WILMINGTON,1,0,1993,NA,NA,1439,860,579,417,131,286,0.33,0.23,0.29,1492,76,346,1296
199218,UNIVERSITY OF NORTH CAROLINA AT WILMINGTON,1,0,1995,NA,NA,1370,863,507,463,133,330,0.38,0.26,0.34,1664,86,363,1253
199218,UNIVERSITY OF NORTH CAROLINA AT WILMINGTON,1,0,1996,NA,NA,1619,990,629,602,196,406,0.41000000000000003,0.31,0.37,1734,90,369,1472
199218,UNIVERSITY OF NORTH CAROLINA-WILMINGTON,1,0,1997,NA,NA,1350,837,513,478,149,329,0.39,0.29,0.35,1782,94,382,1216
199218,UNIVERSITY OF NORTH CAROLINA-WILMINGTON,1,0,1998,NA,NA,1681,1030,651,628,180,448,0.43,0.28,0.37,1934,106,388,1551
199218,UNIVERSITY OF NORTH CAROLINA-WILMINGTON,1,0,1999,NA,NA,1649,1011,638,672,213,459,0.45,0.33,0.41,962,119,413,1522
199218,UNIVERSITY OF NORTH CAROLINA-WILMINGTON,1,0,2000,NA,NA,1661,1081,580,711,185,526,0.48,0.32,0.43,1102,130,423,1524
199218,UNIVERSITY OF NORTH CAROLINA-WILMINGTON,1,0,2001,NA,NA,1983,1246,737,824,205,619,0.49,0.28,0.42,1317,139,433,1823
199218,UNIVERSITY OF NORTH CAROLINA-WILMINGTON,1,0,2002,NA,NA,1629,1014,615,733,209,524,0.51,0.34,0.45,1622,139,433,1489
199218,UNIVERSITY OF NORTH CAROLINA-WILMINGTON,1,0,2003,NA,NA,1764,1133,631,783,227,556,0.49,0.36,0.44,1703,144,467,1557
199218,UNIVERSITY OF NORTH CAROLINA-WILMINGTON,1,0,2004,NA,NA,1891,1154,737,841,272,569,0.49,0.37,0.44,1928,155,464,1668
199218,University of North Carolina-Wilmington,1,0,2005,NA,NA,1933,1133,800,842,302,540,0.47000000000000003,0.38,0.44,1928,167,493,1693
199218,University of North Carolina-Wilmington,1,0,2006,NA,NA,1980,1140,840,973,335,638,0.55,0.4,0.49,2221,183,515,1652
199218,University of North Carolina-Wilmington,1,0,2007,NA,NA,1913,1138,775,991,340,651,0.5700000000000001,0.44,0.52,2413,214,543,1607
199218,University of North Carolina-Wilmington,1,0,2008,NA,NA,2069,1229,840,1017,326,691,0.56,0.39,0.49,2459,241,580,1761
199218,University of North Carolina-Wilmington,1,0,2009,NA,NA,1943,1178,765,975,314,661,0.56,0.41,0.5,2565,237,617,1607
199218,University of North Carolina at Wilmington,1,0,2010,NA,NA,1985,1236,749,1044,320,724,0.58,0.43,0.53,3029,254,617,1655
199281,PEMBROKE STATE UNIVERSITY,1,0,1991,NA,NA,379,195,184,58,21,37,0.18,0.11,0.15,914,23,141,229
199281,PEMBROKE STATE UNIVERSITY,1,0,1992,NA,NA,417,199,218,68,26,42,0.21,0.12,0.16,948,23,145,251
199281,PEMBROKE STATE UNIVERSITY,1,0,1993,NA,NA,422,216,206,71,19,52,0.24,0.09,0.17,1078,25,143,245
199281,UNIVERSITY OF NORTH CAROLINA-PEMBROKE,1,0,1995,NA,NA,410,199,211,81,34,47,0.23,0.16,0.2,1325,27,144,230
199281,UNIVERSITY OF NORTH CAROLINA-PEMBROKE,1,0,1996,NA,NA,450,211,239,80,30,50,0.23,0.13,0.18,1467,30,145,228
199281,UNIVERSITY OF NORTH CAROLINA-PEMBROKE,1,0,1997,NA,NA,480,258,222,98,34,64,0.24,0.15,0.2,1536,32,143,272
199281,UNIVERSITY OF NORTH CAROLINA AT PEMBROKE,1,0,1998,NA,NA,464,244,220,99,36,63,0.25,0.16,0.21,1600,34,145,241
199281,UNIVERSITY OF NORTH CAROLINA AT PEMBROKE,1,0,1999,NA,NA,475,241,234,89,33,56,0.23,0.14,0.19,962,38,145,268
199281,UNIVERSITY OF NORTH CAROLINA AT PEMBROKE,1,0,2000,NA,NA,567,303,264,114,34,80,0.26,0.13,0.2,982,40,156,307
199281,UNIVERSITY OF NORTH CAROLINA AT PEMBROKE,1,0,2001,NA,NA,688,363,325,100,31,69,0.19,0.1,0.15,1152,44,167,378
199281,UNIVERSITY OF NORTH CAROLINA AT PEMBROKE,1,0,2002,NA,NA,709,376,333,101,38,63,0.16,0.11,0.14,1394,47,180,413
199281,UNIVERSITY OF NORTH CAROLINA AT PEMBROKE,1,0,2003,NA,NA,792,415,377,130,45,85,0.2,0.12,0.16,1464,53,202,459
199281,UNIVERSITY OF NORTH CAROLINA AT PEMBROKE,1,0,2004,NA,NA,741,393,348,113,44,69,0.17,0.13,0.15,1689,63,219,358
199281,University of North Carolina at Pembroke,1,0,2005,NA,NA,961,528,433,142,50,92,0.17,0.12,0.15,1689,69,243,437
199281,University of North Carolina at Pembroke,1,0,2006,NA,NA,929,475,454,148,54,94,0.19,0.12,0.16,1869,77,257,414
199281,University of North Carolina at Pembroke,1,0,2007,NA,NA,1101,585,516,170,57,113,0.19,0.11,0.15,1949,88,285,487
199281,University of North Carolina at Pembroke,1,0,2008,NA,NA,1054,563,491,157,50,107,0.19,0.1,0.15,2007,110,291,448
199281,University of North Carolina at Pembroke,1,0,2009,NA,NA,1202,642,560,218,77,141,0.21,0.14,0.18,2060,108,293,454
199281,University of North Carolina at Pembroke,1,0,2010,NA,NA,1036,582,454,209,74,135,0.23,0.16,0.2,2423,114,329,410
199306,PFEIFFER COLLEGE,1,0,1991,NA,NA,166,82,84,45,17,28,0.34,0.2,0.27,7295,9,47,149
199306,PFEIFFER COLLEGE,1,0,1992,NA,NA,147,66,81,45,18,27,0.4,0.22,0.31,7730,10,47,130
199306,PFEIFFER COLLEGE,1,0,1993,NA,NA,156,70,86,40,14,26,0.37,0.16,0.26,8190,10,49,126
199306,PFEIFFER UNIVERSITY,1,0,1995,NA,NA,146,66,80,31,10,21,0.31,0.12,0.21,8990,11,47,121
199306,PFEIFFER UNIVERSITY,1,0,1996,NA,NA,120,54,66,26,12,14,0.25,0.18,0.22,9260,11,51,99
199306,PFEIFFER UNIVERSITY,1,0,1997,NA,NA,162,59,103,40,21,19,0.32,0.2,0.25,9816,11,51,129
199306,PFEIFFER UNIVERSITY,1,0,1998,NA,NA,148,67,81,45,17,28,0.41000000000000003,0.21,0.3,10230,12,58,122
199306,PFEIFFER UNIVERSITY,1,0,1999,NA,NA,159,80,79,52,15,37,0.46,0.19,0.33,10844,12,59,126
199306,PFEIFFER UNIVERSITY,1,0,2000,NA,NA,185,90,95,58,17,41,0.45,0.18,0.31,11380,13,58,154
199306,PFEIFFER UNIVERSITY,1,0,2001,NA,NA,146,69,77,63,26,37,0.53,0.34,0.43,12066,14,58,120
199306,PFEIFFER UNIVERSITY,1,0,2002,NA,NA,166,97,69,71,29,42,0.43,0.42,0.43,12780,15,63,138
199306,PFEIFFER UNIVERSITY,1,0,2003,NA,NA,158,86,72,56,20,36,0.41000000000000003,0.28,0.35,13550,17,65,130
199306,PFEIFFER UNIVERSITY,1,0,2004,NA,NA,191,88,103,54,17,37,0.42,0.17,0.28,14570,18,65,153
199306,Pfeiffer University,1,0,2005,NA,NA,198,90,108,74,28,46,0.51,0.26,0.37,15590,19,65,147
199306,Pfeiffer University,1,0,2006,NA,NA,196,85,111,72,38,34,0.4,0.34,0.37,16450,22,67,145
199306,Pfeiffer University,1,0,2007,NA,NA,189,90,99,63,28,35,0.38,0.28,0.33,17520,24,77,154
199306,Pfeiffer University,1,0,2008,NA,NA,192,91,101,48,15,33,0.36,0.15,0.25,18570,26,74,133
199306,Pfeiffer University,1,0,2009,NA,NA,225,100,125,71,34,37,0.37,0.27,0.32,19040,24,73,172
199306,Pfeiffer University,1,0,2010,NA,NA,199,88,111,67,31,36,0.4,0.28,0.34,20182,24,81,127
199412,QUEENS COLLEGE,1,0,1991,NA,NA,144,102,42,47,9,38,0.37,0.21,0.33,9300,13,67,117
199412,QUEENS COLLEGE,1,0,1992,NA,NA,127,95,32,45,8,37,0.38,0.25,0.35,9850,18,66,102
199412,QUEENS COLLEGE,1,0,1993,NA,NA,169,134,35,60,13,47,0.35000000000000003,0.37,0.36,10400,15,63,139
199412,QUEENS COLLEGE,1,0,1995,NA,NA,146,110,36,72,19,53,0.48,0.53,0.49,11520,19,64,113
199412,QUEENS COLLEGE,1,0,1996,NA,NA,155,116,39,80,14,66,0.56,0.36,0.52,12310,18,64,117
199412,QUEENS COLLEGE,1,0,1997,NA,NA,198,142,56,80,20,60,0.42,0.36,0.4,12980,15,65,148
199412,QUEENS COLLEGE,1,0,1998,NA,NA,147,111,36,67,15,52,0.46,0.42,0.46,9410,16,69,114
199412,QUEENS COLLEGE,1,0,1999,NA,NA,123,85,38,67,15,52,0.61,0.39,0.54,10020,18,62,89
199412,QUEENS COLLEGE,1,0,2000,NA,NA,188,136,52,93,23,70,0.51,0.44,0.49,10680,19,61,150
199412,QUEENS COLLEGE,1,0,2001,NA,NA,209,166,43,105,23,82,0.49,0.53,0.5,11360,21,60,165
199412,QUEENS UNIVERSITY OF CHARLOTTE,1,0,2002,NA,NA,193,150,43,111,24,87,0.58,0.56,0.58,12290,23,63,168
199412,QUEENS UNIVERSITY OF CHARLOTTE,1,0,2003,NA,NA,252,186,66,127,34,93,0.5,0.52,0.5,15650,25,75,216
199412,QUEENS UNIVERSITY OF CHARLOTTE,1,0,2004,NA,NA,223,154,69,98,28,70,0.45,0.41,0.44,17008,24,85,183
199412,Queens University of Charlotte,1,0,2005,NA,NA,238,171,67,116,30,86,0.5,0.45,0.49,18028,27,90,189
199412,Queens University of Charlotte,1,0,2006,NA,NA,235,173,62,104,22,82,0.47000000000000003,0.35,0.44,19450,28,92,148
199412,Queens University of Charlotte,1,0,2007,NA,NA,290,198,92,126,32,94,0.47000000000000003,0.35,0.43,20720,30,102,202
199412,Queens University of Charlotte,1,0,2008,NA,NA,307,214,93,164,49,115,0.53,0.53,0.53,22068,37,103,190
199412,Queens University of Charlotte,1,0,2009,NA,NA,311,232,79,144,31,113,0.48,0.39,0.46,22730,39,109,177
199412,Queens University of Charlotte,1,0,2010,NA,NA,349,252,97,162,38,124,0.49,0.39,0.46,23752,44,119,205
199582,SAINT AUGUSTINE'S COLLEGE,1,0,1991,NA,NA,418,237,181,44,10,34,0.14,0.06,0.11,4950,24,109,1
199582,SAINT AUGUSTINE'S COLLEGE,1,0,1992,NA,NA,401,232,169,61,14,47,0.2,0.08,0.15,5300,24,89,0
199582,SAINT AUGUSTINES COLLEGE,1,0,1993,NA,NA,361,196,165,49,12,37,0.18,0.07,0.14,5700,25,91,1
199582,SAINT AUGUSTINES COLLEGE,1,0,1995,NA,NA,385,203,182,61,17,44,0.21,0.09,0.16,5872,23,94,0
199582,SAINT AUGUSTINES COLLEGE,1,0,1996,NA,NA,408,228,180,46,21,25,0.1,0.12,0.11,6284,29,94,0
199582,SAINT AUGUSTINES COLLEGE,1,0,1997,NA,NA,400,228,172,60,14,46,0.2,0.08,0.15,6472,22,91,1
199582,SAINT AUGUSTINES COLLEGE,1,0,1998,NA,NA,299,164,135,57,13,44,0.26,0.1,0.19,6796,22,85,1
199582,SAINT AUGUSTINES COLLEGE,1,0,1999,NA,NA,331,173,158,57,16,41,0.23,0.1,0.17,5132,23,87,0
199582,SAINT AUGUSTINES COLLEGE,1,0,2000,NA,NA,398,232,166,67,17,50,0.21,0.1,0.17,5650,24,82,1
199582,SAINT AUGUSTINES COLLEGE,1,0,2001,NA,NA,324,172,152,52,16,36,0.2,0.11,0.16,5780,23,77,0
199582,SAINT AUGUSTINES COLLEGE,1,0,2002,NA,NA,449,183,266,25,13,12,0.06,0.05,0.06,6030,22,79,0
199582,SAINT AUGUSTINES COLLEGE,1,0,2003,NA,NA,542,238,304,46,15,31,0.13,0.05,0.08,7398,24,78,3
199582,SAINT AUGUSTINES COLLEGE,1,0,2004,NA,NA,324,140,184,45,15,30,0.21,0.08,0.14,8138,27,89,3
199582,Saint Augustines College,1,0,2005,NA,NA,261,129,132,34,16,18,0.13,0.12,0.13,8952,25,78,0
199582,Saint Augustines College,1,0,2006,NA,NA,363,146,217,58,23,35,0.23,0.11,0.16,9980,26,78,2
199582,Saint Augustines College,1,0,2007,NA,NA,417,188,229,91,31,60,0.31,0.14,0.22,10580,27,82,4
199582,Saint Augustines College,1,0,2008,NA,NA,484,233,251,87,33,54,0.23,0.13,0.18,10580,30,72,3
199582,Saint Augustines College,1,0,2009,NA,NA,424,206,218,91,35,56,0.27,0.16,0.21,12004,33,72,13
199582,Saint Augustines College,1,0,2010,NA,NA,440,196,244,78,25,53,0.27,0.1,0.18,12364,36,79,3
199643,SHAW UNIVERSITY,1,0,1991,NA,NA,579,330,249,190,82,108,0.32,0.33,0.33,4894,19,73,22
199643,SHAW UNIVERSITY,1,0,1992,NA,NA,740,428,312,124,33,91,0.21,0.11,0.17,5272,22,103,17
199643,SHAW UNIVERSITY,1,0,1993,NA,NA,601,336,265,140,43,97,0.28,0.16,0.23,5562,27,92,7
199643,SHAW UNIVERSITY,1,0,1995,NA,NA,518,305,213,127,29,98,0.32,0.14,0.25,5946,30,99,14
199643,SHAW UNIVERSITY,1,0,1996,NA,NA,374,232,142,67,17,50,0.21,0.12,0.18,5946,32,82,5
199643,SHAW UNIVERSITY,1,0,1997,NA,NA,304,173,131,43,12,31,0.17,0.09,0.14,6304,29,84,5
199643,SHAW UNIVERSITY,1,0,1998,NA,NA,382,220,162,73,20,53,0.24,0.12,0.19,6494,31,88,8
199643,SHAW UNIVERSITY,1,0,1999,NA,NA,440,258,182,61,21,40,0.15,0.12,0.14,6272,24,80,3
199643,SHAW UNIVERSITY,1,0,2000,NA,NA,401,247,154,43,13,30,0.12,0.08,0.11,6712,38,88,7
199643,SHAW UNIVERSITY,1,0,2001,NA,NA,445,283,162,83,18,65,0.22,0.11,0.19,7056,40,96,13
199643,SHAW UNIVERSITY,1,0,2002,NA,NA,526,240,286,67,26,41,0.17,0.09,0.13,7560,29,85,11
199643,SHAW UNIVERSITY,1,0,2003,NA,NA,469,249,220,79,31,48,0.19,0.14,0.17,7800,35,88,6
199643,SHAW UNIVERSITY,1,0,2004,NA,NA,417,227,190,61,16,45,0.19,0.08,0.15,7800,38,105,9
199643,Shaw University,1,0,2005,NA,NA,573,307,266,75,29,46,0.14,0.11,0.13,7800,44,111,5
199643,Shaw University,1,0,2006,NA,NA,674,423,251,82,23,59,0.13,0.09,0.12,8280,41,112,10
199643,Shaw University,1,0,2007,NA,NA,565,321,244,89,35,54,0.16,0.14,0.16,8800,46,116,11
199643,Shaw University,1,0,2008,NA,NA,532,308,224,64,21,43,0.13,0.09,0.12,9336,51,114,9
199643,Shaw University,1,0,2009,NA,NA,581,334,247,74,24,50,0.14,0.1,0.13,9336,49,105,11
199643,Shaw University,1,0,2010,NA,NA,679,360,319,54,23,31,0.08,0.07,0.08,9840,46,120,9
199847,WAKE FOREST UNIVERSITY,1,0,1991,NA,NA,857,425,432,659,299,360,0.84,0.69,0.77,10800,296,317,753
199847,WAKE FOREST UNIVERSITY,1,0,1992,NA,NA,909,445,464,639,300,339,0.76,0.65,0.7,12000,325,313,805
199847,WAKE FOREST UNIVERSITY,1,0,1993,NA,NA,904,443,461,676,314,362,0.81,0.68,0.75,13000,357,323,793
199847,WAKE FOREST UNIVERSITY,1,0,1995,NA,NA,962,458,504,720,357,363,0.79,0.71,0.75,14750,411,331,841
199847,WAKE FOREST UNIVERSITY,1,0,1996,NA,NA,934,500,434,707,297,410,0.8200000000000001,0.68,0.76,18500,448,365,802
199847,WAKE FOREST UNIVERSITY,1,0,1997,NA,NA,962,483,479,739,338,401,0.8300000000000001,0.71,0.77,19450,477,383,849
199847,WAKE FOREST UNIVERSITY,1,0,1998,NA,NA,993,505,488,746,334,412,0.81,0.68,0.75,20450,516,394,875
199847,WAKE FOREST UNIVERSITY,1,0,1999,NA,NA,969,498,471,760,327,433,0.86,0.69,0.78,21420,562,409,865
199847,WAKE FOREST UNIVERSITY,1,0,2000,NA,NA,1020,530,490,804,355,449,0.84,0.72,0.79,22410,602,418,886
199847,WAKE FOREST UNIVERSITY,1,0,2001,NA,NA,960,481,479,756,343,413,0.85,0.72,0.79,23530,637,427,846
199847,WAKE FOREST UNIVERSITY,1,0,2002,NA,NA,999,509,490,832,393,439,0.86,0.8,0.83,24750,694,430,847
199847,WAKE FOREST UNIVERSITY,1,0,2003,NA,NA,984,507,477,834,386,448,0.88,0.81,0.85,26490,747,434,850
199847,WAKE FOREST UNIVERSITY,1,0,2004,NA,NA,1109,552,557,921,438,483,0.87,0.79,0.83,28210,776,431,946
199847,Wake Forest University,1,0,2005,NA,NA,1114,565,549,918,431,487,0.86,0.79,0.82,30110,848,450,916
199847,Wake Forest University,1,0,2006,NA,NA,1119,576,543,927,432,495,0.85,0.8,0.83,32040,880,466,927
199847,Wake Forest University,1,0,2007,NA,NA,1123,573,550,919,433,486,0.84,0.79,0.82,34230,947,468,936
199847,Wake Forest University,1,0,2008,NA,NA,1197,621,576,991,455,536,0.86,0.79,0.83,36560,1007,471,969
199847,Wake Forest University,1,0,2009,NA,NA,1193,628,565,983,445,538,0.85,0.79,0.82,38206,1032,476,914
199847,Wake Forest University,1,0,2010,NA,NA,1217,639,578,1019,462,557,0.87,0.8,0.84,39544,1094,505,941
199962,WINGATE COLLEGE,1,0,1991,NA,NA,371,181,190,93,28,65,0.35000000000000003,0.15,0.25,6120,14,79,321
199962,WINGATE COLLEGE,1,0,1992,NA,NA,365,179,186,84,36,48,0.26,0.19,0.23,6740,14,77,307
199962,WINGATE COLLEGE,1,0,1993,NA,NA,376,171,205,78,31,47,0.27,0.15,0.21,7410,15,79,314
199962,WINGATE UNIVERSITY,1,0,1995,NA,NA,334,157,177,113,45,68,0.43,0.25,0.34,8760,17,80,289
199962,WINGATE UNIVERSITY,1,0,1996,NA,NA,331,137,194,101,43,58,0.42,0.22,0.31,11090,18,83,289
199962,WINGATE UNIVERSITY,1,0,1997,NA,NA,296,123,173,103,43,60,0.48,0.25,0.35,11730,20,82,255
199962,WINGATE UNIVERSITY,1,0,1998,NA,NA,273,127,146,89,34,55,0.43,0.23,0.33,12150,22,79,245
199962,WINGATE UNIVERSITY,1,0,1999,NA,NA,301,144,157,102,32,70,0.48,0.2,0.34,11950,22,79,242
199962,WINGATE UNIVERSITY,1,0,2000,NA,NA,380,181,199,142,54,88,0.48,0.27,0.37,12300,25,79,303
199962,WINGATE UNIVERSITY,1,0,2001,NA,NA,393,209,184,147,44,103,0.49,0.24,0.37,12900,21,80,334
199962,WINGATE UNIVERSITY,1,0,2002,NA,NA,374,197,177,167,62,105,0.53,0.35,0.45,13550,21,83,314
199962,WINGATE UNIVERSITY,1,0,2003,NA,NA,372,198,174,160,55,105,0.53,0.32,0.43,14200,23,95,314
199962,WINGATE UNIVERSITY,1,0,2004,NA,NA,358,174,184,155,66,89,0.51,0.36,0.43,15000,25,100,296
199962,Wingate University,1,0,2005,NA,NA,371,183,188,154,54,100,0.54,0.29,0.42,15800,27,102,319
199962,Wingate University,1,0,2006,NA,NA,385,198,187,152,57,95,0.47000000000000003,0.3,0.39,16600,29,110,294
199962,Wingate University,1,0,2007,NA,NA,426,209,217,200,87,113,0.54,0.4,0.47,17430,32,114,318
199962,Wingate University,1,0,2008,NA,NA,431,223,208,183,79,104,0.46,0.38,0.42,18300,34,111,291
199962,Wingate University,1,0,2009,NA,NA,375,195,180,150,59,91,0.46,0.33,0.4,18990,37,122,243
199962,Wingate University,1,0,2010,NA,NA,605,336,269,267,95,172,0.51,0.35,0.44,19990,38,120,366
199999,WINSTON-SALEM STATE UNIVERSITY,1,0,1991,NA,NA,431,287,144,59,7,52,0.18,0.05,0.14,1060,28,147,16
199999,WINSTON-SALEM STATE UNIVERSITY,1,0,1992,NA,NA,391,267,124,83,20,63,0.23,0.16,0.21,1094,29,146,14
199999,WINSTON-SALEM STATE UNIVERSITY,1,0,1993,NA,NA,369,225,144,79,26,53,0.23,0.18,0.21,1172,29,149,19
199999,WINSTON-SALEM STATE UNIVERSITY,1,0,1995,NA,NA,446,298,148,121,32,89,0.29,0.22,0.27,1351,35,156,27
199999,WINSTON-SALEM STATE UNIVERSITY,1,0,1996,NA,NA,480,351,129,95,19,76,0.21,0.15,0.2,1414,38,156,35
199999,WINSTON-SALEM STATE UNIVERSITY,1,0,1997,NA,NA,485,329,156,117,27,90,0.27,0.17,0.24,1504,44,157,23
199999,WINSTON SALEM STATE UNIVERSITY,1,0,1998,NA,NA,524,364,160,114,23,91,0.25,0.14,0.22,1561,43,163,19
199999,WINSTON-SALEM STATE UNIVERSITY,1,0,1999,NA,NA,476,316,160,103,19,84,0.26,0.12,0.22,806,46,162,12
199999,WINSTON-SALEM STATE UNIVERSITY,1,0,2000,NA,NA,499,359,140,97,19,78,0.21,0.14,0.19,822,49,168,21
199999,WINSTON-SALEM STATE UNIVERSITY,1,0,2001,NA,NA,614,424,190,124,17,107,0.25,0.09,0.2,896,54,175,15
199999,WINSTON-SALEM STATE UNIVERSITY,1,0,2002,NA,NA,670,471,199,121,28,93,0.19,0.14,0.18,1168,55,179,25
199999,WINSTON-SALEM STATE UNIVERSITY,1,0,2003,NA,NA,883,580,303,124,25,99,0.17,0.08,0.14,1226,60,170,17
199999,WINSTON-SALEM STATE UNIVERSITY,1,0,2004,NA,NA,891,619,272,117,35,82,0.13,0.13,0.13,1451,75,191,29
199999,Winston-Salem State University,1,0,2005,NA,NA,1050,701,349,167,42,125,0.17,0.12,0.16,1451,85,200,37
199999,Winston-Salem State University,1,0,2006,NA,NA,976,692,284,144,36,108,0.15,0.13,0.15,1651,98,258,24
199999,Winston-Salem State University,1,0,2007,NA,NA,962,661,301,171,40,131,0.19,0.13,0.18,1701,119,319,34
199999,Winston-Salem State University,1,0,2008,NA,NA,1353,886,467,234,62,172,0.19,0.13,0.17,1701,125,338,27
199999,Winston-Salem State University,1,0,2009,NA,NA,794,540,254,135,39,96,0.17,0.15,0.17,1769,132,325,21
199999,Winston-Salem State University,1,0,2010,NA,NA,690,465,225,139,25,114,0.24,0.11,0.2,2274,137,343,32
200004,WESTERN CAROLINA UNIVERSITY,1,0,1991,NA,NA,1011,522,489,210,84,126,0.24,0.17,0.21,1229,64,291,933
200004,WESTERN CAROLINA UNIVERSITY,1,0,1992,NA,NA,1065,543,522,208,76,132,0.24,0.15,0.2,1271,67,308,998
200004,WESTERN CAROLINA UNIVERSITY,1,0,1993,NA,NA,1051,509,542,226,91,135,0.26,0.17,0.22,1391,75,319,968
200004,WESTERN CAROLINA UNIVERSITY,1,0,1995,NA,NA,1156,608,548,259,78,181,0.29,0.14,0.22,1589,79,325,1062
200004,WESTERN CAROLINA UNIVERSITY,1,0,1996,NA,NA,1177,560,617,260,87,173,0.3,0.14,0.22,1663,82,335,1090
200004,WESTERN CAROLINA UNIVERSITY,1,0,1997,NA,NA,1224,629,595,310,100,210,0.33,0.17,0.25,1723,85,328,1119
200004,WESTERN CAROLINA UNIVERSITY,1,0,1998,NA,NA,1098,544,554,249,80,169,0.31,0.14,0.23,1793,90,316,1004
200004,WESTERN CAROLINA UNIVERSITY,1,0,1999,NA,NA,1151,569,582,261,103,158,0.27,0.18,0.23,962,95,313,1043
200004,WESTERN CAROLINA UNIVERSITY,1,0,2000,NA,NA,1211,594,617,298,120,178,0.29,0.19,0.25,982,98,309,1075
200004,WESTERN CAROLINA UNIVERSITY,1,0,2001,NA,NA,1176,530,646,266,108,158,0.29,0.17,0.23,1072,101,305,1057
200004,WESTERN CAROLINA UNIVERSITY,1,0,2002,NA,NA,1216,627,589,344,127,217,0.34,0.22,0.28,1358,97,315,1074
200004,WESTERN CAROLINA UNIVERSITY,1,0,2003,NA,NA,1485,739,746,394,138,256,0.34,0.18,0.27,1426,103,326,1346
200004,WESTERN CAROLINA UNIVERSITY,1,0,2004,NA,NA,1571,805,766,447,154,293,0.36,0.2,0.28,1651,117,359,1400
200004,Western Carolina University,1,0,2005,NA,NA,1549,775,774,453,181,272,0.35000000000000003,0.23,0.29,1651,128,416,1354
200004,Western Carolina University,1,0,2006,NA,NA,1558,784,774,434,163,271,0.34,0.21,0.28,1904,148,433,1341
200004,Western Carolina University,1,0,2007,NA,NA,1249,651,598,400,142,258,0.39,0.24,0.32,2028,161,456,1038
200004,Western Carolina University,1,0,2008,NA,NA,1218,617,601,485,198,287,0.46,0.33,0.4,2078,172,472,1036
200004,Western Carolina University,1,0,2009,NA,NA,1547,848,699,568,211,357,0.42,0.3,0.37,2106,177,460,1253
200004,Western Carolina University,1,0,2010,NA,NA,1415,746,669,520,196,324,0.43,0.29,0.37,2816,168,451,1176
200059,DICKINSON STATE UNIVERSITY,1,0,1991,NA,NA,315,165,150,30,12,18,0.1,0.08,0.1,1706,10,67,306
200059,DICKINSON STATE UNIVERSITY,1,0,1992,NA,NA,336,191,145,32,9,23,0.12,0.06,0.1,1706,11,67,328
200059,DICKINSON STATE UNIVERSITY,1,0,1993,NA,NA,300,148,152,22,5,17,0.11,0.03,0.07,1782,11,72,289
200059,DICKINSON STATE UNIVERSITY,1,0,1995,NA,NA,296,140,156,27,10,17,0.12,0.06,0.09,1856,12,73,279
200059,DICKINSON STATE UNIVERSITY,1,0,1996,NA,NA,397,193,204,24,9,15,0.07,0.04,0.06,1970,12,72,375
200059,DICKINSON STATE UNIVERSITY,1,0,1997,NA,NA,408,233,175,39,15,24,0.1,0.09,0.1,2096,13,71,391
200059,DICKINSON STATE UNIVERSITY,1,0,1998,NA,NA,363,204,159,26,4,22,0.1,0.03,0.07,2196,13,70,349
200059,DICKINSON STATE UNIVERSITY,1,0,1999,NA,NA,359,179,180,39,15,24,0.13,0.08,0.11,1906,15,72,346
200059,DICKINSON STATE UNIVERSITY,1,0,2000,NA,NA,350,208,142,34,14,20,0.09,0.1,0.1,1982,17,71,329
200059,DICKINSON STATE UNIVERSITY,1,0,2001,NA,NA,375,188,187,39,8,31,0.16,0.04,0.1,2067,18,71,341
200059,DICKINSON STATE UNIVERSITY,1,0,2002,NA,NA,368,193,175,32,8,24,0.12,0.05,0.09,2202,18,72,327
200059,DICKINSON STATE UNIVERSITY,1,0,2003,NA,NA,383,201,182,42,14,28,0.13,0.08,0.11,2554,18,83,335
200059,DICKINSON STATE UNIVERSITY,1,0,2004,NA,NA,332,170,162,37,15,22,0.12,0.09,0.11,3040,20,94,286
200059,Dickinson State University,1,0,2005,NA,NA,317,162,155,29,11,18,0.11,0.07,0.09,3329,22,89,263
200059,Dickinson State University,1,0,2006,NA,NA,333,160,173,50,22,28,0.17,0.13,0.15,3645,24,87,240
200059,Dickinson State University,1,0,2007,NA,NA,355,191,164,48,19,29,0.15,0.12,0.14,3828,26,86,270
200059,Dickinson State University,1,0,2008,NA,NA,320,142,178,34,16,18,0.12,0.09,0.11,4019,27,93,228
200059,Dickinson State University,1,0,2009,NA,NA,307,177,130,43,13,30,0.16,0.1,0.14,4160,29,95,211
200059,Dickinson State University,1,0,2010,NA,NA,307,146,161,33,14,19,0.13,0.09,0.11,4304,29,93,226
200156,JAMESTOWN COLLEGE,1,0,1991,NA,NA,288,134,154,68,21,47,0.35000000000000003,0.14,0.24,6670,9,48,256
200156,JAMESTOWN COLLEGE,1,0,1992,NA,NA,292,140,152,86,27,59,0.42,0.18,0.29,6920,12,47,263
200156,JAMESTOWN COLLEGE,1,0,1993,NA,NA,262,121,141,62,27,35,0.28,0.19,0.24,7270,12,52,244
200156,JAMESTOWN COLLEGE,1,0,1995,NA,NA,289,144,145,89,32,57,0.39,0.22,0.31,7970,13,50,282
200156,JAMESTOWN COLLEGE,1,0,1996,NA,NA,288,159,129,90,25,65,0.4,0.19,0.31,8420,13,52,269
200156,JAMESTOWN COLLEGE,1,0,1997,NA,NA,232,134,98,100,36,64,0.47000000000000003,0.37,0.43,8770,9,51,220
200156,JAMESTOWN COLLEGE,1,0,1998,NA,NA,278,150,128,99,39,60,0.4,0.3,0.36,6770,9,50,261
200156,JAMESTOWN COLLEGE,1,0,1999,NA,NA,284,165,119,84,31,53,0.32,0.26,0.3,7150,10,53,269
200156,JAMESTOWN COLLEGE,1,0,2000,NA,NA,331,192,139,107,35,72,0.37,0.25,0.32,7550,11,53,304
200156,JAMESTOWN COLLEGE,1,0,2001,NA,NA,293,173,120,96,35,61,0.35000000000000003,0.29,0.33,7925,12,54,274
200156,JAMESTOWN COLLEGE,1,0,2002,NA,NA,332,176,156,98,29,69,0.39,0.19,0.3,8350,12,57,302
200156,JAMESTOWN COLLEGE,1,0,2003,NA,NA,261,142,119,82,27,55,0.38,0.23,0.31,8750,12,58,232
200156,JAMESTOWN COLLEGE,1,0,2004,NA,NA,229,135,94,63,33,30,0.22,0.35,0.28,9400,13,56,210
200156,Jamestown College,1,0,2005,NA,NA,270,139,131,67,24,43,0.3,0.18,0.25,10000,13,56,249
200156,Jamestown College,1,0,2006,NA,NA,238,129,109,75,21,54,0.41000000000000003,0.19,0.32,10550,13,56,223
200156,Jamestown College,1,0,2007,NA,NA,264,140,124,88,26,62,0.44,0.21,0.33,11235,14,54,239
200156,Jamestown College,1,0,2008,NA,NA,267,123,144,74,27,47,0.38,0.19,0.28,12748,14,55,234
200156,Jamestown College,1,0,2009,NA,NA,233,116,117,49,17,32,0.27,0.15,0.21,14432,15,57,208
200156,Jamestown College,1,0,2010,NA,NA,202,98,104,72,27,45,0.45,0.26,0.36,15680,15,58,161
200217,UNIVERSITY OF MARY,1,0,1991,NA,NA,317,179,138,96,33,63,0.35000000000000003,0.24,0.3,5550,11,66,294
200217,UNIVERSITY OF MARY,1,0,1992,NA,NA,343,205,138,104,30,74,0.36,0.22,0.3,5900,13,70,312
200217,UNIVERSITY OF MARY,1,0,1993,NA,NA,350,224,126,91,20,71,0.31,0.16,0.26,6260,14,75,326
200217,UNIVERSITY OF MARY,1,0,1995,NA,NA,412,234,178,115,32,83,0.35000000000000003,0.18,0.28,6950,16,76,388
200217,UNIVERSITY OF MARY,1,0,1996,NA,NA,440,266,174,117,36,81,0.3,0.21,0.27,7330,21,78,408
200217,UNIVERSITY OF MARY,1,0,1997,NA,NA,381,242,139,131,32,99,0.4,0.23,0.34,7590,18,82,366
200217,UNIVERSITY OF MARY,1,0,1998,NA,NA,404,244,160,149,39,110,0.45,0.24,0.37,8080,20,85,385
200217,UNIVERSITY OF MARY,1,0,1999,NA,NA,373,242,131,155,42,113,0.46,0.32,0.42,8200,20,83,359
200217,UNIVERSITY OF MARY,1,0,2000,NA,NA,351,201,150,142,37,105,0.52,0.25,0.4,8500,23,87,335
200217,UNIVERSITY OF MARY,1,0,2001,NA,NA,372,213,159,143,43,100,0.46,0.27,0.38,8800,25,91,348
200217,UNIVERSITY OF MARY,1,0,2002,NA,NA,402,240,162,168,44,124,0.51,0.27,0.42,9200,28,91,381
200217,UNIVERSITY OF MARY,1,0,2003,NA,NA,390,226,164,147,36,111,0.49,0.22,0.38,9600,28,90,353
200217,UNIVERSITY OF MARY,1,0,2004,NA,NA,430,251,179,156,46,110,0.43,0.26,0.36,9990,29,93,400
200217,University of Mary,1,0,2005,NA,NA,392,220,172,103,28,75,0.34,0.16,0.26,10600,31,100,358
200217,University of Mary,1,0,2006,NA,NA,343,187,156,19,10,9,0.04,0.06,0.06,11100,32,100,316
200217,University of Mary,1,0,2007,NA,NA,352,206,146,99,20,79,0.38,0.14,0.28,11530,34,103,302
200217,University of Mary,1,0,2008,NA,NA,373,227,146,108,25,83,0.36,0.17,0.29,11940,35,98,339
200217,University of Mary,1,0,2009,NA,NA,311,192,119,122,32,90,0.46,0.27,0.39,12360,37,95,280
200217,University of Mary,1,0,2010,NA,NA,362,203,159,138,38,100,0.49,0.24,0.38,12800,36,93,307
200226,MAYVILLE STATE UNIVERSITY,0,1,1991,1992,0,162,83,79,21,3,18,0.21,0.04,0.13,2133,6,33,150
200226,MAYVILLE STATE UNIVERSITY,1,0,1992,1992,1,165,86,79,15,5,10,0.11,0.06,0.09,2755,7,36,143
200226,MAYVILLE STATE UNIVERSITY,1,0,1993,1992,1,146,61,85,17,4,13,0.21,0.05,0.12,1831,7,37,122
200226,MAYVILLE STATE UNIVERSITY,1,0,1995,1992,1,193,80,113,25,10,15,0.18,0.09,0.13,2340,7,36,172
200226,MAYVILLE STATE UNIVERSITY,1,0,1996,1992,1,148,79,69,22,7,15,0.18,0.1,0.15,2016,8,39,141
200226,MAYVILLE STATE UNIVERSITY,1,0,1997,1992,1,129,73,56,20,6,14,0.19,0.11,0.16,2946,8,37,112
200226,MAYVILLE STATE UNIVERSITY,1,0,1998,1992,1,153,56,97,32,16,16,0.28,0.16,0.21,3032,9,38,132
200226,MAYVILLE STATE UNIVERSITY,1,0,1999,1992,1,140,71,69,41,15,26,0.36,0.22,0.29,1906,9,39,130
200226,MAYVILLE STATE UNIVERSITY,1,0,2000,1992,1,153,73,80,22,6,16,0.21,0.07,0.14,1982,9,37,145
200226,MAYVILLE STATE UNIVERSITY,1,0,2001,1992,1,133,62,71,18,6,12,0.19,0.08,0.14,2067,9,36,127
200226,MAYVILLE STATE UNIVERSITY,1,0,2002,1992,1,135,79,56,32,4,28,0.35000000000000003,0.07,0.24,2202,11,39,125
200226,MAYVILLE STATE UNIVERSITY,1,0,2003,1992,1,135,70,65,26,9,17,0.24,0.14,0.19,2576,12,36,113
200226,MAYVILLE STATE UNIVERSITY,1,0,2004,1992,1,162,72,90,25,5,20,0.27,0.06,0.15,3014,11,37,128
200226,Mayville State University,1,0,2005,1992,1,144,63,81,28,10,18,0.28,0.12,0.19,3300,13,36,121
200226,Mayville State University,1,0,2006,1992,1,137,59,78,29,7,22,0.37,0.09,0.21,3614,12,36,116
200226,Mayville State University,1,0,2007,1992,1,89,42,47,18,5,13,0.3,0.11,0.2,3795,12,42,76
200226,Mayville State University,1,0,2008,1992,1,89,52,37,17,5,12,0.23,0.14,0.19,3985,13,40,71
200226,Mayville State University,1,0,2009,1992,1,147,57,90,17,7,10,0.17,0.08,0.12,4124,13,39,98
200226,Mayville State University,1,0,2010,1992,1,130,54,76,17,10,7,0.12,0.13,0.13,4268,15,38,99
200253,MINOT STATE UNIVERSITY,0,1,1991,1992,0,546,363,183,52,14,38,0.1,0.08,0.1,1701,21,166,457
200253,MINOT STATE UNIVERSITY,1,0,1992,1992,1,624,398,226,30,6,24,0.06,0.03,0.05,1710,23,169,483
200253,MINOT STATE UNIVERSITY,1,0,1993,1992,1,579,346,233,48,13,35,0.1,0.06,0.08,1836,25,188,455
200253,MINOT STATE UNIVERSITY,1,0,1995,1992,1,525,322,203,36,11,25,0.07,0.05,0.07,1960,28,183,447
200253,MINOT STATE UNIVERSITY,1,0,1996,1992,1,457,304,153,35,10,25,0.08,0.07,0.08,2044,27,209,396
200253,MINOT STATE UNIVERSITY,1,0,1997,1992,1,442,270,172,38,9,29,0.1,0.05,0.09,2139,31,176,389
200253,MINOT STATE UNIVERSITY,1,0,1998,1992,1,371,217,154,28,7,21,0.09,0.05,0.08,2240,32,166,325
200253,MINOT STATE UNIVERSITY,1,0,1999,1992,1,433,251,182,40,11,29,0.11,0.06,0.09,2050,33,186,395
200253,MINOT STATE UNIVERSITY,1,0,2000,1992,1,452,260,192,61,25,36,0.13,0.13,0.13,2144,30,171,396
200253,MINOT STATE UNIVERSITY,1,0,2001,1992,1,419,241,178,43,11,32,0.13,0.06,0.1,2244,32,156,370
200253,MINOT STATE UNIVERSITY,1,0,2002,1992,1,476,268,208,62,11,51,0.19,0.05,0.13,2344,31,177,414
200253,MINOT STATE UNIVERSITY,1,0,2003,1992,1,435,252,183,70,16,54,0.21,0.09,0.16,2730,36,159,375
200253,MINOT STATE UNIVERSITY,1,0,2004,1992,1,431,254,177,72,20,52,0.2,0.11,0.17,3160,37,176,369
200253,Minot State University,1,0,2005,1992,1,431,240,191,64,19,45,0.18,0.1,0.15,3460,38,171,378
200253,Minot State University,1,0,2006,1992,1,461,263,198,58,13,45,0.17,0.07,0.13,3790,39,185,355
200253,Minot State University,1,0,2007,1992,1,418,231,187,60,21,39,0.16,0.11,0.14,3980,42,180,347
200253,Minot State University,1,0,2008,1992,1,406,259,147,55,11,44,0.16,0.07,0.14,4179,41,189,318
200253,Minot State University,1,0,2009,1992,1,418,238,180,68,21,47,0.19,0.12,0.16,4325,43,179,321
200253,Minot State University,1,0,2010,1992,1,461,298,163,83,10,73,0.24,0.06,0.18,4476,49,187,344
200280,UNIVERSITY OF NORTH DAKOTA-MAIN CAMPUS,1,0,1991,NA,NA,1288,588,700,161,78,83,0.14,0.11,0.12,2145,178,458,1188
200280,UNIVERSITY OF NORTH DAKOTA-MAIN CAMPUS,1,0,1992,NA,NA,1579,724,855,189,87,102,0.14,0.1,0.12,2165,195,473,1466
200280,UNIVERSITY OF NORTH DAKOTA-MAIN CAMPUS,1,0,1993,NA,NA,1465,747,718,205,80,125,0.16,0.11,0.14,2298,200,472,1371
200280,UNIVERSITY OF NORTH DAKOTA-MAIN CAMPUS,1,0,1995,NA,NA,1407,665,742,190,81,109,0.16,0.11,0.14,2428,217,505,1314
200280,UNIVERSITY OF NORTH DAKOTA-MAIN CAMPUS,1,0,1996,NA,NA,1365,630,735,194,92,102,0.16,0.13,0.14,2528,202,495,1269
200280,UNIVERSITY OF NORTH DAKOTA-MAIN CAMPUS,1,0,1997,NA,NA,1516,742,774,222,94,128,0.17,0.12,0.15,2677,192,457,1394
200280,UNIVERSITY OF NORTH DAKOTA-MAIN CAMPUS,1,0,1998,NA,NA,1465,722,743,326,141,185,0.25,0.19,0.22,2830,205,440,1377
200280,UNIVERSITY OF NORTH DAKOTA-MAIN CAMPUS,1,0,1999,NA,NA,1742,846,896,394,179,215,0.25,0.2,0.23,2956,200,442,1636
200280,UNIVERSITY OF NORTH DAKOTA-MAIN CAMPUS,1,0,2000,NA,NA,1832,858,974,394,192,202,0.23,0.2,0.22,2604,199,455,1731
200280,UNIVERSITY OF NORTH DAKOTA-MAIN CAMPUS,1,0,2001,NA,NA,1969,870,1099,436,191,245,0.28,0.17,0.22,2754,210,469,1816
200280,UNIVERSITY OF NORTH DAKOTA-MAIN CAMPUS,1,0,2002,NA,NA,1987,935,1052,438,205,233,0.24,0.19,0.22,2954,235,482,1856
200280,UNIVERSITY OF NORTH DAKOTA-MAIN CAMPUS,1,0,2003,NA,NA,2213,1039,1174,511,244,267,0.25,0.21,0.23,3441,246,515,2063
200280,UNIVERSITY OF NORTH DAKOTA-MAIN CAMPUS,1,0,2004,NA,NA,2178,1016,1162,459,216,243,0.23,0.19,0.21,4009,272,526,2015
200280,University of North Dakota,1,0,2005,NA,NA,1851,858,993,425,198,227,0.26,0.2,0.23,4390,293,577,1769
200280,University of North Dakota,1,0,2006,NA,NA,1868,869,999,438,199,239,0.27,0.2,0.23,4786,304,485,1754
200280,University of North Dakota,1,0,2007,NA,NA,1832,883,949,441,200,241,0.27,0.21,0.24,5025,317,488,1673
200280,University of North Dakota,1,0,2008,NA,NA,1923,896,1027,450,214,236,0.26,0.21,0.23,5276,333,505,1781
200280,University of North Dakota,1,0,2009,NA,NA,1970,940,1030,468,218,250,0.26,0.21,0.24,5461,359,527,1744
200280,University of North Dakota,1,0,2010,NA,NA,2073,978,1095,527,237,290,0.29,0.22,0.25,5652,374,550,1773
200332,NORTH DAKOTA STATE UNIVERSITY MAIN CAMPUS,0,1,1991,1992,0,1192,491,701,134,58,76,0.15,0.08,0.11,2248,120,465,1157
200332,NORTH DAKOTA STATE UNIVERSITY MAIN CAMPUS,1,0,1992,1992,1,1550,674,876,155,68,87,0.12,0.08,0.1,2032,131,464,1504
200332,NORTH DAKOTA STATE UNIVERSITY MAIN CAMPUS,1,0,1993,1992,1,1433,571,862,182,76,106,0.18,0.09,0.13,2184,133,448,1395
200332,NORTH DAKOTA STATE UNIVERSITY MAIN CAMPUS,1,0,1995,1992,1,1482,661,821,189,87,102,0.15,0.11,0.13,2310,144,501,1445
200332,NORTH DAKOTA STATE UNIVERSITY MAIN CAMPUS,1,0,1996,1992,1,1295,543,752,169,83,86,0.15,0.11,0.13,2410,145,484,1250
200332,NORTH DAKOTA STATE UNIVERSITY MAIN CAMPUS,1,0,1997,1992,1,1199,497,702,194,83,111,0.22,0.12,0.16,2566,149,487,1154
200332,NORTH DAKOTA STATE UNIVERSITY-MAIN CAMPUS,1,0,1998,1992,1,1259,524,735,181,83,98,0.18,0.11,0.14,2730,154,473,1191
200332,NORTH DAKOTA STATE UNIVERSITY-MAIN CAMPUS,1,0,1999,1992,1,1268,514,754,240,111,129,0.25,0.15,0.19,2596,163,484,1204
200332,NORTH DAKOTA STATE UNIVERSITY-MAIN CAMPUS,1,0,2000,1992,1,1280,512,768,217,102,115,0.22,0.13,0.17,2604,167,487,1234
200332,NORTH DAKOTA STATE UNIVERSITY-MAIN CAMPUS,1,0,2001,1992,1,1187,491,696,162,80,82,0.16,0.11,0.14,2754,184,491,1130
200332,NORTH DAKOTA STATE UNIVERSITY-MAIN CAMPUS,1,0,2002,1992,1,1803,785,1018,387,186,201,0.25,0.18,0.21,2904,204,527,1721
200332,NORTH DAKOTA STATE UNIVERSITY-MAIN CAMPUS,1,0,2003,1992,1,1944,902,1042,423,178,245,0.27,0.17,0.22,3374,216,527,1840
200332,NORTH DAKOTA STATE UNIVERSITY-MAIN CAMPUS,1,0,2004,1992,1,2089,949,1140,481,220,261,0.27,0.19,0.23,3981,226,531,1940
200332,North Dakota State University-Main Campus,1,0,2005,1992,1,1970,940,1030,457,191,266,0.28,0.19,0.23,4360,241,837,1879
200332,North Dakota State University-Main Campus,1,0,2006,1992,1,2040,920,1120,486,221,265,0.28,0.2,0.24,4774,262,580,1902
200332,North Dakota State University-Main Campus,1,0,2007,1992,1,2125,965,1160,544,244,300,0.31,0.21,0.26,5013,273,609,1999
200332,North Dakota State University-Main Campus,1,0,2008,1992,1,2650,1182,1468,667,326,341,0.28,0.22,0.25,5264,298,539,2439
200332,North Dakota State University-Main Campus,1,0,2009,1992,1,2435,1111,1324,655,299,356,0.32,0.23,0.27,5448,322,564,2250
200332,North Dakota State University-Main Campus,1,0,2010,1992,1,2373,1074,1299,635,297,338,0.31,0.23,0.27,5639,350,568,2131
200572,VALLEY CITY STATE UNIVERSITY,0,1,1991,1992,0,186,100,86,21,2,19,0.19,0.02,0.11,1707,8,54,171
200572,VALLEY CITY STATE UNIVERSITY,1,0,1992,1992,1,193,90,103,28,12,16,0.17,0.12,0.15,1707,8,56,172
200572,VALLEY CITY STATE UNIVERSITY,1,0,1993,1992,1,196,80,116,34,12,22,0.27,0.1,0.17,1815,9,55,171
200572,VALLEY CITY STATE UNIVERSITY,1,0,1995,1992,1,166,80,86,32,11,21,0.26,0.13,0.19,1893,9,53,149
200572,VALLEY CITY STATE UNIVERSITY,1,0,1996,1992,1,178,99,79,38,15,23,0.23,0.19,0.21,2843,10,53,167
200572,VALLEY CITY STATE UNIVERSITY,1,0,1997,1992,1,177,100,77,37,8,29,0.29,0.1,0.21,2919,11,51,158
200572,VALLEY CITY STATE UNIVERSITY,1,0,1998,1992,1,193,100,93,47,12,35,0.35000000000000003,0.13,0.24,3023,11,50,172
200572,VALLEY CITY STATE UNIVERSITY,1,0,1999,1992,1,158,76,82,35,8,27,0.35000000000000003,0.1,0.22,1906,12,56,142
200572,VALLEY CITY STATE UNIVERSITY,1,0,2000,1992,1,179,92,87,35,11,24,0.26,0.13,0.2,1982,12,57,160
200572,VALLEY CITY STATE UNIVERSITY,1,0,2001,1992,1,155,75,80,40,15,25,0.33,0.19,0.26,2067,13,58,140
200572,VALLEY CITY STATE UNIVERSITY,1,0,2002,1992,1,153,72,81,41,21,20,0.27,0.26,0.27,2202,14,61,133
200572,VALLEY CITY STATE UNIVERSITY,1,0,2003,1992,1,159,71,88,36,15,21,0.29,0.17,0.23,2652,12,61,143
200572,VALLEY CITY STATE UNIVERSITY,1,0,2004,1992,1,167,71,96,39,16,23,0.32,0.17,0.23,3130,13,60,143
200572,Valley City State University,1,0,2005,1992,1,171,73,98,40,16,24,0.32,0.16,0.23,3656,14,65,135
200572,Valley City State University,1,0,2006,1992,1,177,70,107,44,20,24,0.34,0.19,0.25,4003,14,62,150
200572,Valley City State University,1,0,2007,1992,1,184,86,98,42,14,28,0.32,0.14,0.23,4204,15,55,154
200572,Valley City State University,1,0,2008,1992,1,154,70,84,35,14,21,0.3,0.17,0.23,4412,15,56,121
200572,Valley City State University,1,0,2009,1992,1,152,53,99,32,13,19,0.35000000000000003,0.13,0.21,4568,16,58,119
200572,Valley City State University,1,0,2010,1992,1,217,95,122,45,22,23,0.24,0.18,0.21,4433,18,66,173
201104,ASHLAND UNIVERSITY,1,0,1991,NA,NA,542,238,304,145,52,93,0.39,0.17,0.27,9985,40,150,454
201104,ASHLAND UNIVERSITY,1,0,1992,NA,NA,650,307,343,172,69,103,0.33,0.2,0.26,10583,49,165,559
201104,ASHLAND UNIVERSITY,1,0,1993,NA,NA,510,268,242,134,29,105,0.39,0.12,0.26,10733,51,162,452
201104,ASHLAND UNIVERSITY,1,0,1995,NA,NA,549,269,280,214,67,147,0.54,0.24,0.39,12174,52,218,493
201104,ASHLAND UNIVERSITY,1,0,1996,NA,NA,432,240,192,150,47,103,0.42,0.24,0.35,12600,56,200,398
201104,ASHLAND UNIVERSITY,1,0,1997,NA,NA,531,302,229,220,76,144,0.47000000000000003,0.33,0.41,13293,55,192,493
201104,ASHLAND UNIVERSITY,1,0,1998,NA,NA,570,351,219,235,66,169,0.48,0.3,0.41,13726,60,176,541
201104,ASHLAND UNIVERSITY,1,0,1999,NA,NA,541,313,228,246,80,166,0.53,0.35,0.45,14276,64,198,512
201104,ASHLAND UNIVERSITY,1,0,2000,NA,NA,448,265,183,187,51,136,0.51,0.28,0.42,15134,70,207,413
201104,ASHLAND UNIVERSITY,1,0,2001,NA,NA,492,273,219,200,69,131,0.47000000000000003,0.32,0.41,15814,62,217,458
201104,ASHLAND UNIVERSITY,1,0,2002,NA,NA,559,373,186,258,60,198,0.53,0.32,0.46,16764,66,213,512
201104,ASHLAND UNIVERSITY,1,0,2003,NA,NA,605,379,226,275,76,199,0.52,0.34,0.45,17518,72,224,547
201104,ASHLAND UNIVERSITY,1,0,2004,NA,NA,571,340,231,245,70,175,0.51,0.3,0.43,18394,81,234,522
201104,Ashland University,1,0,2005,NA,NA,573,357,216,271,86,185,0.51,0.4,0.47,19314,85,232,530
201104,Ashland University,1,0,2006,NA,NA,554,313,241,238,78,160,0.51,0.32,0.43,20666,88,229,477
201104,Ashland University,1,0,2007,NA,NA,639,371,268,264,77,187,0.5,0.29,0.41,22216,90,234,558
201104,Ashland University,1,0,2008,NA,NA,570,306,264,236,83,153,0.5,0.31,0.41,23550,95,233,455
201104,Ashland University,1,0,2009,NA,NA,614,338,276,281,94,187,0.55,0.34,0.46,24828,95,213,507
201104,Ashland University,1,0,2010,NA,NA,688,407,281,345,115,230,0.56,0.41,0.5,26566,92,272,607
201371,BLUFFTON COLLEGE,0,1,1991,1999,0,193,93,100,85,30,55,0.59,0.3,0.44,8100,8,45,178
201371,BLUFFTON COLLEGE,0,1,1992,1999,0,181,104,77,92,39,53,0.5,0.51,0.51,8685,9,45,173
201371,BLUFFTON COLLEGE,0,1,1993,1999,0,214,105,109,110,43,67,0.63,0.39,0.51,9225,10,49,193
201371,BLUFFTON COLLEGE,0,1,1995,1999,0,248,163,85,125,39,86,0.52,0.46,0.5,10620,14,51,235
201371,BLUFFTON COLLEGE,0,1,1996,1999,0,183,115,68,97,38,59,0.51,0.56,0.53,11250,16,65,174
201371,BLUFFTON COLLEGE,0,1,1997,1999,0,254,149,105,124,37,87,0.58,0.35,0.49,11835,14,65,233
201371,BLUFFTON COLLEGE,0,1,1998,1999,0,190,112,78,102,32,70,0.62,0.41,0.54,12375,14,65,177
201371,BLUFFTON COLLEGE,1,0,1999,1999,1,248,156,92,114,32,82,0.52,0.35,0.46,13156,14,66,231
201371,BLUFFTON COLLEGE,1,0,2000,1999,1,227,124,103,114,48,66,0.53,0.47,0.5,14076,16,69,210
201371,BLUFFTON COLLEGE,1,0,2001,1999,1,239,133,106,117,44,73,0.54,0.42,0.49,15076,17,72,225
201371,BLUFFTON COLLEGE,1,0,2002,1999,1,262,141,121,135,55,80,0.56,0.45,0.52,16130,18,72,226
201371,BLUFFTON COLLEGE,1,0,2003,1999,1,236,143,93,133,51,82,0.5700000000000001,0.55,0.56,17260,20,71,208
201371,BLUFFTON UNIVERSITY,1,0,2004,1999,1,266,130,136,136,61,75,0.5700000000000001,0.45,0.51,17950,20,64,236
201371,Bluffton University,1,0,2005,1999,1,228,141,87,123,45,78,0.55,0.52,0.54,19028,20,67,198
201371,Bluffton University,1,0,2006,1999,1,241,122,119,119,50,69,0.56,0.42,0.49,20170,21,68,203
201371,Bluffton University,1,0,2007,1999,1,206,117,89,108,41,67,0.5700000000000001,0.46,0.52,21380,21,66,181
201371,Bluffton University,1,0,2008,1999,1,272,140,132,144,62,82,0.58,0.47,0.53,22470,21,64,250
201371,Bluffton University,1,0,2009,1999,1,257,116,141,107,48,59,0.5,0.34,0.42,23594,22,62,213
201371,Bluffton University,1,0,2010,1999,1,219,91,128,96,45,51,0.56,0.35,0.44,24480,21,63,169
201548,CAPITAL UNIVERSITY,1,0,1991,NA,NA,370,218,152,232,87,145,0.66,0.57,0.63,11085,31,137,342
201548,CAPITAL UNIVERSITY,1,0,1992,NA,NA,330,213,117,163,56,107,0.5,0.48,0.49,11810,36,139,296
201548,CAPITAL UNIVERSITY,1,0,1993,NA,NA,448,266,182,238,81,157,0.59,0.45,0.53,12500,39,158,396
201548,CAPITAL UNIVERSITY,1,0,1995,NA,NA,474,296,178,306,108,198,0.66,0.61,0.65,13700,47,176,415
201548,CAPITAL UNIVERSITY,1,0,1996,NA,NA,468,285,183,275,90,185,0.64,0.49,0.59,14200,52,174,399
201548,CAPITAL UNIVERSITY,1,0,1997,NA,NA,478,290,188,239,82,157,0.54,0.44,0.5,14760,44,176,413
201548,CAPITAL UNIVERSITY,1,0,1998,NA,NA,518,313,205,250,79,171,0.54,0.39,0.48,15260,42,171,444
201548,CAPITAL UNIVERSITY,1,0,1999,NA,NA,532,301,231,255,101,154,0.51,0.44,0.48,16000,45,174,474
201548,CAPITAL UNIVERSITY,1,0,2000,NA,NA,558,333,225,305,111,194,0.58,0.49,0.55,16880,46,178,476
201548,CAPITAL UNIVERSITY,1,0,2001,NA,NA,519,324,195,243,68,175,0.54,0.35,0.47,17990,50,182,449
201548,CAPITAL UNIVERSITY,1,0,2002,NA,NA,563,330,233,296,104,192,0.58,0.45,0.53,18980,51,196,482
201548,CAPITAL UNIVERSITY,1,0,2003,NA,NA,565,352,213,284,100,184,0.52,0.47,0.5,20500,55,198,473
201548,CAPITAL UNIVERSITY,1,0,2004,NA,NA,517,298,219,253,96,157,0.52,0.44,0.49,22035,63,201,438
201548,Capital University,1,0,2005,NA,NA,599,363,236,310,109,201,0.55,0.46,0.52,23433,70,218,504
201548,Capital University,1,0,2006,NA,NA,690,410,280,342,130,212,0.51,0.46,0.5,25100,74,223,591
201548,Capital University,1,0,2007,NA,NA,627,377,250,323,117,206,0.54,0.47,0.52,26360,71,217,525
201548,Capital University,1,0,2008,NA,NA,632,354,278,321,122,199,0.56,0.44,0.51,27680,68,199,517
201548,Capital University,1,0,2009,NA,NA,608,323,285,336,150,186,0.5700000000000001,0.53,0.55,28480,71,203,520
201548,Capital University,1,0,2010,NA,NA,715,409,306,381,167,214,0.52,0.55,0.53,29310,71,202,616
201645,CASE WESTERN RESERVE UNIVERSITY,1,0,1991,NA,NA,647,245,402,327,173,154,0.62,0.43,0.51,13708,282,507,438
201645,CASE WESTERN RESERVE UNIVERSITY,1,0,1992,NA,NA,762,321,441,350,152,198,0.61,0.34,0.46,14616,297,507,542
201645,CASE WESTERN RESERVE UNIVERSITY,1,0,1993,NA,NA,712,249,463,354,201,153,0.61,0.43,0.5,15322,322,530,487
201645,CASE WESTERN RESERVE UNIVERSITY,1,0,1995,NA,NA,729,275,454,388,205,183,0.66,0.45,0.53,16430,366,517,544
201645,CASE WESTERN RESERVE UNIVERSITY,1,0,1996,NA,NA,738,284,454,387,202,185,0.65,0.44,0.52,17235,379,532,507
201645,CASE WESTERN RESERVE UNIVERSITY,1,0,1997,NA,NA,736,269,467,408,235,173,0.64,0.5,0.55,17942,359,536,494
201645,CASE WESTERN RESERVE UNIVERSITY,1,0,1998,NA,NA,830,301,529,476,265,211,0.7000000000000001,0.5,0.57,18546,329,536,554
201645,CASE WESTERN RESERVE UNIVERSITY,1,0,1999,NA,NA,762,292,470,432,245,187,0.64,0.52,0.57,19200,394,553,579
201645,CASE WESTERN RESERVE UNIVERSITY,1,0,2000,NA,NA,833,305,528,489,279,210,0.68,0.53,0.59,20100,448,557,615
201645,CASE WESTERN RESERVE UNIVERSITY,1,0,2001,NA,NA,737,288,449,433,228,205,0.71,0.51,0.59,21000,474,562,523
201645,CASE WESTERN RESERVE UNIVERSITY,1,0,2002,NA,NA,835,322,513,482,264,218,0.67,0.51,0.58,22500,513,590,603
201645,CASE WESTERN RESERVE UNIVERSITY,1,0,2003,NA,NA,874,350,524,552,292,260,0.74,0.56,0.63,24100,571,637,624
201645,CASE WESTERN RESERVE UNIVERSITY,1,0,2004,NA,NA,782,306,476,508,282,226,0.73,0.59,0.65,26500,639,686,511
201645,Case Western Reserve University,1,0,2005,NA,NA,1162,456,706,702,386,316,0.6900000000000001,0.55,0.6,28400,719,646,682
201645,Case Western Reserve University,1,0,2006,NA,NA,1015,441,574,636,325,311,0.7000000000000001,0.57,0.63,31090,780,651,632
201645,Case Western Reserve University,1,0,2007,NA,NA,1132,492,640,734,368,366,0.74,0.58,0.65,32800,791,656,652
201645,Case Western Reserve University,1,0,2008,NA,NA,1023,442,581,651,337,314,0.71,0.58,0.64,34450,774,664,566
201645,Case Western Reserve University,1,0,2009,NA,NA,965,401,564,609,309,300,0.74,0.55,0.63,35900,806,683,546
201645,Case Western Reserve University,1,0,2010,NA,NA,1019,415,604,655,356,299,0.72,0.59,0.64,37300,817,680,537
201690,CENTRAL STATE UNIVERSITY,0,1,1991,2005,0,661,327,334,92,34,58,0.17,0.1,0.14,2388,38,114,13
201690,CENTRAL STATE UNIVERSITY,0,1,1992,2005,0,665,319,346,42,12,30,0.09,0.03,0.06,2679,40,128,6
201690,CENTRAL STATE UNIVERSITY,0,1,1993,2005,0,613,301,312,66,18,48,0.15,0.06,0.11,2811,43,136,2
201690,CENTRAL STATE UNIVERSITY,0,1,1995,2005,0,597,262,335,25,5,20,0.07,0.01,0.04,2664,41,94,4
201690,CENTRAL STATE UNIVERSITY,0,1,1996,2005,0,330,161,169,28,12,16,0.09,0.07,0.08,3318,42,95,1
201690,CENTRAL STATE UNIVERSITY,0,1,1997,2005,0,88,47,41,4,0,4,0.08,0,0.05,3318,38,75,0
201690,CENTRAL STATE UNIVERSITY,0,1,1998,2005,0,230,130,100,27,5,22,0.16,0.05,0.12,3336,30,69,13
201690,CENTRAL STATE UNIVERSITY,0,1,1999,2005,0,294,164,130,46,12,34,0.2,0.09,0.16,1926,39,75,5
201690,CENTRAL STATE UNIVERSITY,0,1,2000,2005,0,307,173,134,39,5,34,0.19,0.04,0.13,2046,37,76,5
201690,CENTRAL STATE UNIVERSITY,0,1,2001,2005,0,397,204,193,33,7,26,0.12,0.04,0.08,2064,43,77,0
201690,CENTRAL STATE UNIVERSITY,0,1,2002,2005,0,378,207,171,51,14,37,0.17,0.08,0.13,2208,43,87,2
201690,CENTRAL STATE UNIVERSITY,0,1,2003,2005,0,542,277,265,43,10,33,0.11,0.04,0.08,2340,46,87,4
201690,CENTRAL STATE UNIVERSITY,0,1,2004,2005,0,583,270,313,46,11,35,0.12,0.04,0.08,2571,46,92,2
201690,Central State University,1,0,2005,2005,1,343,156,187,31,15,16,0.1,0.08,0.09,2726,50,90,3
201690,Central State University,1,0,2006,2005,1,535,266,269,65,21,44,0.16,0.08,0.12,2890,51,97,5
201690,Central State University,1,0,2007,2005,1,564,278,286,59,15,44,0.15,0.05,0.1,2890,50,107,1
201690,Central State University,1,0,2008,2005,1,646,330,316,72,10,62,0.18,0.03,0.11,2890,57,106,2
201690,Central State University,1,0,2009,2005,1,702,363,339,42,14,28,0.07,0.04,0.06,2890,58,113,4
201690,Central State University,1,0,2010,2005,1,503,231,272,49,18,31,0.13,0.07,0.1,2992,63,111,4
202134,CLEVELAND STATE UNIVERSITY,0,1,1991,1999,0,959,435,524,70,34,36,0.08,0.06,0.07,2682,132,553,699
202134,CLEVELAND STATE UNIVERSITY,0,1,1992,1999,0,868,409,459,55,21,34,0.08,0.05,0.06,2976,137,556,625
202134,CLEVELAND STATE UNIVERSITY,0,1,1993,1999,0,942,479,463,77,26,51,0.1,0.06,0.08,3126,135,530,641
202134,CLEVELAND STATE UNIVERSITY,0,1,1995,1999,0,856,463,393,71,26,45,0.09,0.07,0.08,3332,140,517,511
202134,CLEVELAND STATE UNIVERSITY,0,1,1996,1999,0,845,443,402,80,25,55,0.12,0.06,0.09,3442,146,499,505
202134,CLEVELAND STATE UNIVERSITY,0,1,1997,1999,0,924,464,460,89,36,53,0.11,0.08,0.1,3456,152,513,588
202134,CLEVELAND STATE UNIVERSITY,0,1,1998,1999,0,962,455,507,86,37,49,0.1,0.07,0.09,3670,164,522,509
202134,CLEVELAND STATE UNIVERSITY,1,0,1999,1999,1,1048,494,554,114,50,64,0.12,0.09,0.11,3864,173,543,661
202134,CLEVELAND STATE UNIVERSITY,1,0,2000,1999,1,934,471,463,103,42,61,0.12,0.09,0.11,4110,183,534,561
202134,CLEVELAND STATE UNIVERSITY,1,0,2001,1999,1,1008,493,515,95,47,48,0.09,0.09,0.09,4464,190,525,614
202134,CLEVELAND STATE UNIVERSITY,1,0,2002,1999,1,946,463,483,80,39,41,0.08,0.08,0.08,5196,201,534,571
202134,CLEVELAND STATE UNIVERSITY,1,0,2003,1999,1,925,463,462,65,34,31,0.06,0.07,0.07,5760,209,541,530
202134,CLEVELAND STATE UNIVERSITY,1,0,2004,1999,1,922,463,459,79,31,48,0.1,0.07,0.09,6792,226,564,527
202134,Cleveland State University,1,0,2005,1999,1,955,507,448,87,31,56,0.11,0.07,0.09,6972,235,575,553
202134,Cleveland State University,1,0,2006,1999,1,947,520,427,95,31,64,0.12,0.07,0.1,7920,241,572,560
202134,Cleveland State University,1,0,2007,1999,1,1132,622,510,94,37,57,0.09,0.07,0.08,7920,248,571,612
202134,Cleveland State University,1,0,2008,1999,1,1005,548,457,150,50,100,0.18,0.11,0.15,7920,260,549,616
202134,Cleveland State University,1,0,2009,1999,1,1127,601,526,181,70,111,0.18,0.13,0.16,7920,273,537,662
202134,Cleveland State University,1,0,2010,1999,1,1148,615,533,237,105,132,0.21,0.2,0.21,8466,275,538,704
202480,UNIVERSITY OF DAYTON,0,1,1991,2005,0,1499,744,755,758,322,436,0.58,0.43,0.51,9410,150,420,1361
202480,UNIVERSITY OF DAYTON,0,1,1992,2005,0,1622,778,844,832,343,489,0.62,0.41,0.51,10210,163,420,1467
202480,UNIVERSITY OF DAYTON,0,1,1993,2005,0,1507,730,777,769,324,445,0.6,0.42,0.51,11090,175,419,1360
202480,UNIVERSITY OF DAYTON,0,1,1995,2005,0,1610,836,774,890,342,548,0.65,0.44,0.55,12350,196,404,1466
202480,UNIVERSITY OF DAYTON,0,1,1996,2005,0,1553,845,708,890,310,580,0.68,0.44,0.57,13640,201,404,1437
202480,UNIVERSITY OF DAYTON,0,1,1997,2005,0,1622,872,750,896,351,545,0.62,0.47,0.55,14180,186,400,1473
202480,UNIVERSITY OF DAYTON,0,1,1998,2005,0,1792,919,873,991,385,606,0.65,0.44,0.55,14670,193,387,1620
202480,UNIVERSITY OF DAYTON,0,1,1999,2005,0,1744,921,823,1041,412,629,0.68,0.5,0.6,15020,195,386,1516
202480,UNIVERSITY OF DAYTON,0,1,2000,2005,0,1764,932,832,1055,431,624,0.66,0.52,0.6,15550,209,387,1619
202480,UNIVERSITY OF DAYTON,0,1,2001,2005,0,1715,879,836,971,389,582,0.66,0.47,0.57,16320,230,388,1574
202480,UNIVERSITY OF DAYTON,0,1,2002,2005,0,1644,797,847,944,390,554,0.6900000000000001,0.46,0.57,17450,236,407,1404
202480,UNIVERSITY OF DAYTON,0,1,2003,2005,0,1858,956,902,1084,431,653,0.68,0.48,0.58,18390,248,401,1568
202480,UNIVERSITY OF DAYTON,0,1,2004,2005,0,1805,905,900,1048,437,611,0.67,0.49,0.58,19570,270,439,1574
202480,University of Dayton,1,0,2005,2005,1,1970,1004,966,1149,475,674,0.67,0.49,0.58,21246,278,446,1783
202480,University of Dayton,1,0,2006,2005,1,1738,864,874,1041,450,591,0.68,0.51,0.6,23000,294,458,1595
202480,University of Dayton,1,0,2007,2005,1,1763,893,870,1064,460,604,0.67,0.53,0.6,24880,316,457,1563
202480,University of Dayton,1,0,2008,2005,1,1985,1045,940,1177,452,725,0.6900000000000001,0.48,0.59,26200,333,462,1732
202480,University of Dayton,1,0,2009,2005,1,1692,834,858,1050,463,587,0.7000000000000001,0.54,0.62,27510,363,514,1493
202480,University of Dayton,1,0,2010,2005,1,2029,995,1034,1187,506,681,0.68,0.49,0.59,28700,361,545,1752
202523,DENISON UNIVERSITY,1,0,1991,NA,NA,501,271,230,351,150,201,0.74,0.65,0.7,14700,42,159,438
202523,DENISON UNIVERSITY,1,0,1992,NA,NA,570,301,269,392,174,218,0.72,0.65,0.69,15640,44,157,506
202523,DENISON UNIVERSITY,1,0,1993,NA,NA,535,290,245,342,142,200,0.68,0.58,0.64,15950,47,146,496
202523,DENISON UNIVERSITY,1,0,1995,NA,NA,701,357,344,488,221,267,0.74,0.64,0.7,18630,48,138,606
202523,DENISON UNIVERSITY,1,0,1996,NA,NA,642,305,337,464,229,235,0.77,0.68,0.72,19470,52,141,562
202523,DENISON UNIVERSITY,1,0,1997,NA,NA,593,325,268,438,185,253,0.77,0.69,0.74,20250,45,149,510
202523,DENISON UNIVERSITY,1,0,1998,NA,NA,631,364,267,456,173,283,0.77,0.65,0.72,21060,48,141,527
202523,DENISON UNIVERSITY,1,0,1999,NA,NA,587,335,252,444,171,273,0.81,0.68,0.76,20680,52,152,499
202523,DENISON UNIVERSITY,1,0,2000,NA,NA,648,370,278,484,198,286,0.77,0.71,0.75,21710,55,164,553
202523,DENISON UNIVERSITY,1,0,2001,NA,NA,553,309,244,414,170,244,0.78,0.7,0.75,22550,58,177,450
202523,DENISON UNIVERSITY,1,0,2002,NA,NA,633,338,295,469,192,277,0.81,0.65,0.74,23680,70,189,519
202523,DENISON UNIVERSITY,1,0,2003,NA,NA,629,358,271,502,199,303,0.84,0.73,0.8,25090,73,180,535
202523,DENISON UNIVERSITY,1,0,2004,NA,NA,616,362,254,501,200,301,0.8300000000000001,0.79,0.81,26700,80,179,512
202523,Denison University,1,0,2005,NA,NA,620,337,283,473,211,262,0.77,0.75,0.76,28170,87,202,506
202523,Denison University,1,0,2006,NA,NA,573,335,238,481,190,291,0.86,0.8,0.84,29860,89,218,479
202523,Denison University,1,0,2007,NA,NA,585,325,260,455,199,256,0.78,0.77,0.78,32160,94,217,480
202523,Denison University,1,0,2008,NA,NA,604,325,279,476,202,274,0.84,0.72,0.79,34410,98,214,472
202523,Denison University,1,0,2009,NA,NA,649,362,287,500,205,295,0.81,0.71,0.77,35650,101,213,486
202523,Denison University,1,0,2010,NA,NA,623,349,274,482,199,283,0.81,0.73,0.77,37270,103,224,452
202763,THE UNIVERSITY OF FINDLAY,1,0,1991,NA,NA,342,152,190,95,46,49,0.32,0.24,0.28,8880,25,102,262
202763,THE UNIVERSITY OF FINDLAY,1,0,1992,NA,NA,412,197,215,153,62,91,0.46,0.29,0.37,10054,29,110,337
202763,THE UNIVERSITY OF FINDLAY,1,0,1993,NA,NA,394,190,204,162,76,86,0.45,0.37,0.41,10920,35,115,286
202763,THE UNIVERSITY OF FINDLAY,1,0,1995,NA,NA,591,306,285,205,78,127,0.41000000000000003,0.27,0.35,12500,39,116,386
202763,THE UNIVERSITY OF FINDLAY,1,0,1996,NA,NA,553,302,251,210,83,127,0.42,0.33,0.38,13112,46,124,428
202763,THE UNIVERSITY OF FINDLAY,1,0,1997,NA,NA,651,390,261,264,75,189,0.48,0.29,0.41,13766,33,126,545
202763,THE UNIVERSITY OF FINDLAY,1,0,1998,NA,NA,585,384,201,228,64,164,0.42,0.32,0.39,14320,37,130,533
202763,THE UNIVERSITY OF FINDLAY,1,0,1999,NA,NA,522,337,185,212,52,160,0.47000000000000003,0.28,0.41,15080,42,130,452
202763,THE UNIVERSITY OF FINDLAY,1,0,2000,NA,NA,684,399,285,257,87,170,0.42,0.31,0.38,15830,47,145,603
202763,THE UNIVERSITY OF FINDLAY,1,0,2001,NA,NA,613,377,236,255,69,186,0.49,0.29,0.42,17088,51,160,537
202763,THE UNIVERSITY OF FINDLAY,1,0,2002,NA,NA,651,386,265,276,98,178,0.46,0.37,0.42,18114,54,157,571
202763,THE UNIVERSITY OF FINDLAY,1,0,2003,NA,NA,671,441,230,260,72,188,0.42,0.31,0.39,19052,56,154,569
202763,THE UNIVERSITY OF FINDLAY,1,0,2004,NA,NA,580,387,193,248,60,188,0.48,0.31,0.43,19996,59,164,517
202763,The University of Findlay,1,0,2005,NA,NA,584,399,185,240,64,176,0.44,0.35,0.41,20796,57,164,537
202763,The University of Findlay,1,0,2006,NA,NA,616,441,175,243,58,185,0.41000000000000003,0.33,0.39,21836,61,176,541
202763,The University of Findlay,1,0,2007,NA,NA,594,416,178,258,53,205,0.49,0.3,0.43,22906,66,190,535
202763,The University of Findlay,1,0,2008,NA,NA,562,391,171,242,56,186,0.47000000000000003,0.33,0.43,23938,70,192,504
202763,The University of Findlay,1,0,2009,NA,NA,565,398,167,251,51,200,0.5,0.31,0.44,25016,72,194,461
202763,The University of Findlay,1,0,2010,NA,NA,659,461,198,338,95,243,0.52,0.48,0.51,26016,72,201,585
203085,HEIDELBERG COLLEGE,1,0,1991,NA,NA,252,100,152,100,56,44,0.44,0.37,0.4,11680,14,70,236
203085,HEIDELBERG COLLEGE,1,0,1992,NA,NA,229,88,141,86,46,40,0.45,0.33,0.38,12380,16,70,203
203085,HEIDELBERG COLLEGE,1,0,1993,NA,NA,217,105,112,86,38,48,0.45,0.34,0.4,13000,19,68,204
203085,HEIDELBERG COLLEGE,1,0,1995,NA,NA,220,87,133,94,46,48,0.55,0.35,0.43,14606,20,70,208
203085,HEIDELBERG COLLEGE,1,0,1996,NA,NA,303,141,162,141,68,73,0.51,0.42,0.47,15140,21,66,273
203085,HEIDELBERG COLLEGE,1,0,1997,NA,NA,264,114,150,127,58,69,0.6,0.39,0.48,15594,17,65,249
203085,HEIDELBERG COLLEGE,1,0,1998,NA,NA,290,138,152,130,54,76,0.55,0.36,0.45,16100,19,71,274
203085,HEIDELBERG COLLEGE,1,0,1999,NA,NA,259,98,161,124,61,63,0.64,0.38,0.48,16422,19,70,246
203085,HEIDELBERG COLLEGE,1,0,2000,NA,NA,277,137,140,121,39,82,0.59,0.28,0.44,16998,20,71,255
203085,HEIDELBERG COLLEGE,1,0,2001,NA,NA,262,119,143,113,38,75,0.63,0.27,0.43,17848,21,73,228
203085,HEIDELBERG COLLEGE,1,0,2002,NA,NA,278,160,118,103,34,69,0.43,0.29,0.37,12850,21,72,252
203085,HEIDELBERG COLLEGE,1,0,2003,NA,NA,298,142,156,116,43,73,0.51,0.28,0.39,13620,22,62,264
203085,HEIDELBERG COLLEGE,1,0,2004,NA,NA,354,159,195,132,47,85,0.53,0.24,0.37,14574,22,64,318
203085,Heidelberg College,1,0,2005,NA,NA,324,135,189,174,85,89,0.65,0.45,0.54,15740,25,60,283
203085,Heidelberg College,1,0,2006,NA,NA,267,131,136,105,38,67,0.51,0.28,0.39,17000,27,58,214
203085,Heidelberg College,1,0,2007,NA,NA,369,149,220,130,64,66,0.44,0.29,0.35,18190,25,60,297
203085,Heidelberg University,1,0,2008,NA,NA,402,177,225,142,61,81,0.45,0.27,0.35,19464,27,62,313
203085,Heidelberg University,1,0,2009,NA,NA,375,168,207,118,48,70,0.41000000000000003,0.23,0.31,20826,28,65,279
203085,Heidelberg University,1,0,2010,NA,NA,334,158,176,137,57,80,0.5,0.32,0.41,22242,28,65,258
203128,HIRAM COLLEGE,0,1,1991,1996,0,287,148,139,159,69,90,0.6,0.5,0.55,11950,21,80,255
203128,HIRAM COLLEGE,0,1,1992,1996,0,277,134,143,116,116,0,0,0.81,0.42,12897,23,79,253
203128,HIRAM COLLEGE,0,1,1993,1996,0,263,127,136,134,64,70,0.55,0.47,0.51,13665,25,81,231
203128,HIRAM COLLEGE,0,1,1995,1996,0,217,119,98,124,47,77,0.64,0.48,0.57,15270,26,69,180
203128,HIRAM COLLEGE,1,0,1996,1996,1,232,129,103,144,60,84,0.65,0.58,0.62,15600,27,68,194
203128,HIRAM COLLEGE,1,0,1997,1996,1,240,123,117,136,54,82,0.66,0.46,0.57,16224,20,68,199
203128,HIRAM COLLEGE,1,0,1998,1996,1,231,106,125,137,63,74,0.6900000000000001,0.5,0.59,17010,27,68,200
203128,HIRAM COLLEGE,1,0,1999,1996,1,279,143,136,153,64,89,0.62,0.47,0.55,17230,29,65,241
203128,HIRAM COLLEGE,1,0,2000,1996,1,244,139,105,128,54,74,0.53,0.51,0.52,17870,24,69,214
203128,HIRAM COLLEGE,1,0,2001,1996,1,269,157,112,149,52,97,0.61,0.46,0.55,18720,24,73,221
203128,HIRAM COLLEGE,1,0,2002,1996,1,233,126,107,132,52,80,0.63,0.49,0.57,19650,26,75,191
203128,HIRAM COLLEGE,1,0,2003,1996,1,236,127,109,151,59,92,0.72,0.54,0.64,20440,27,72,194
203128,HIRAM COLLEGE,1,0,2004,1996,1,220,106,114,137,62,75,0.7000000000000001,0.54,0.62,21533,27,74,154
203128,Hiram College,1,0,2005,1996,1,208,101,107,125,57,68,0.67,0.53,0.6,23510,27,64,161
203128,Hiram College,1,0,2006,1996,1,298,143,155,174,80,94,0.65,0.52,0.58,23510,26,60,176
203128,Hiram College,1,0,2007,1996,1,333,184,149,199,77,122,0.66,0.52,0.6,24215,29,68,229
203128,Hiram College,1,0,2008,1996,1,331,164,167,189,82,107,0.65,0.49,0.57,24940,32,74,230
203128,Hiram College,1,0,2009,1996,1,293,143,150,154,74,80,0.55,0.49,0.53,26435,34,79,223
203128,Hiram College,1,0,2010,1996,1,295,157,138,160,65,95,0.6,0.47,0.54,26435,34,78,215
203368,JOHN CARROLL UNIVERSITY,1,0,1991,NA,NA,765,386,379,465,212,253,0.65,0.56,0.61,9600,50,201,692
203368,JOHN CARROLL UNIVERSITY,1,0,1992,NA,NA,748,395,353,452,184,268,0.67,0.52,0.6,10440,56,199,685
203368,JOHN CARROLL UNIVERSITY,1,0,1993,NA,NA,813,422,391,487,216,271,0.64,0.55,0.6,11060,58,203,746
203368,JOHN CARROLL UNIVERSITY,1,0,1995,NA,NA,844,424,420,587,257,330,0.77,0.61,0.7,12390,64,223,784
203368,JOHN CARROLL UNIVERSITY,1,0,1996,NA,NA,775,425,350,483,201,282,0.66,0.57,0.62,13122,71,225,712
203368,JOHN CARROLL UNIVERSITY,1,0,1997,NA,NA,790,408,382,495,217,278,0.68,0.57,0.63,13883,54,222,728
203368,JOHN CARROLL UNIVERSITY,1,0,1998,NA,NA,854,433,421,532,241,291,0.67,0.57,0.62,14670,57,218,772
203368,JOHN CARROLL UNIVERSITY,1,0,1999,NA,NA,833,451,382,539,204,335,0.74,0.53,0.65,15424,61,221,756
203368,JOHN CARROLL UNIVERSITY,1,0,2000,NA,NA,830,467,363,543,214,329,0.7000000000000001,0.59,0.65,16334,62,227,750
203368,JOHN CARROLL UNIVERSITY,1,0,2001,NA,NA,789,442,347,515,219,296,0.66,0.63,0.65,17478,66,234,711
203368,JOHN CARROLL UNIVERSITY,1,0,2002,NA,NA,843,456,387,599,256,343,0.75,0.66,0.71,18832,75,239,763
203368,JOHN CARROLL UNIVERSITY,1,0,2003,NA,NA,859,453,406,543,226,317,0.6900000000000001,0.56,0.63,20566,79,237,760
203368,JOHN CARROLL UNIVERSITY,1,0,2004,NA,NA,734,383,351,466,207,259,0.67,0.59,0.63,22108,85,226,641
203368,John Carroll University,1,0,2005,NA,NA,786,401,385,504,217,287,0.71,0.56,0.64,23380,85,222,663
203368,John Carroll University,1,0,2006,NA,NA,712,385,327,469,205,264,0.68,0.63,0.66,24782,87,209,604
203368,John Carroll University,1,0,2007,NA,NA,720,358,362,471,216,255,0.71,0.6,0.65,26144,88,207,561
203368,John Carroll University,1,0,2008,NA,NA,789,393,396,473,209,264,0.67,0.53,0.6,27190,87,200,580
203368,John Carroll University,1,0,2009,NA,NA,660,335,325,373,163,210,0.62,0.5,0.57,27940,86,206,561
203368,John Carroll University,1,0,2010,NA,NA,703,380,323,460,189,271,0.71,0.59,0.65,29250,82,199,553
203517,KENT STATE UNIVERSITY MAIN CAMPUS,1,0,1991,NA,NA,2692,1609,1083,579,168,411,0.25,0.16,0.22,3300,222,721,2415
203517,KENT STATE UNIVERSITY MAIN CAMPUS,1,0,1992,NA,NA,2581,1580,1001,508,135,373,0.23,0.13,0.2,3596,232,727,2302
203517,KENT STATE UNIVERSITY-MAIN CAMPUS,1,0,1993,NA,NA,2371,1476,895,540,163,377,0.25,0.18,0.23,3740,223,682,2093
203517,KENT STATE UNIVERSITY-MAIN CAMPUS,1,0,1995,NA,NA,2623,1580,1043,353,85,268,0.16,0.08,0.13,4084,229,641,2319
203517,KENT STATE UNIVERSITY-MAIN CAMPUS,1,0,1996,NA,NA,2600,1516,1084,448,150,298,0.19,0.14,0.17,4288,243,637,2307
203517,KENT STATE UNIVERSITY-MAIN CAMPUS,1,0,1997,NA,NA,2573,1524,1049,508,173,335,0.21,0.16,0.2,4460,250,663,2252
203517,KENT STATE UNIVERSITY-MAIN CAMPUS,1,0,1998,NA,NA,3019,1867,1152,491,154,337,0.18,0.13,0.16,4660,256,689,2622
203517,KENT STATE UNIVERSITY-MAIN CAMPUS,1,0,1999,NA,NA,3476,2160,1316,668,187,481,0.22,0.14,0.19,4011,271,654,2974
203517,KENT STATE UNIVERSITY-MAIN CAMPUS,1,0,2000,NA,NA,3556,2184,1372,748,226,522,0.23,0.16,0.21,4234,287,664,3054
203517,KENT STATE UNIVERSITY-MAIN CAMPUS,1,0,2001,NA,NA,3588,2202,1386,556,158,398,0.18,0.11,0.15,4490,307,674,3137
203517,KENT STATE UNIVERSITY-MAIN CAMPUS,1,0,2002,NA,NA,3640,2232,1408,892,283,609,0.27,0.2,0.25,6374,328,763,3148
203517,KENT STATE UNIVERSITY-MAIN CAMPUS,1,0,2003,NA,NA,3746,2293,1453,895,266,629,0.27,0.18,0.24,6882,358,823,3153
203517,KENT STATE UNIVERSITY-MAIN CAMPUS,1,0,2004,NA,NA,3841,2428,1413,969,271,698,0.28,0.19,0.25,7504,363,792,3278
203517,Kent State University-Kent Campus,1,0,2005,NA,NA,3727,2325,1402,970,294,676,0.29,0.21,0.26,7954,366,841,3089
203517,Kent State University-Kent Campus,1,0,2006,NA,NA,3610,2214,1396,977,295,682,0.3,0.21,0.27,8430,392,856,2921
203517,Kent State University-Kent Campus,1,0,2007,NA,NA,3729,2300,1429,1031,308,723,0.31,0.22,0.28,8430,402,877,2984
203517,Kent State University Kent Campus,1,0,2008,NA,NA,3684,2261,1423,1135,325,810,0.35000000000000003,0.23,0.31,8430,450,901,3039
203517,Kent State University Kent Campus,1,0,2009,NA,NA,4003,2437,1566,1298,400,898,0.36,0.26,0.32,8726,475,886,3238
203517,Kent State University at Kent,1,0,2010,NA,NA,3887,2325,1562,1243,396,847,0.36,0.25,0.32,9030,600,885,2931
203535,KENYON COLLEGE,1,0,1991,NA,NA,420,218,202,347,167,180,0.8200000000000001,0.83,0.83,16050,36,125,367
203535,KENYON COLLEGE,1,0,1992,NA,NA,413,218,195,319,147,172,0.78,0.75,0.77,17060,37,123,363
203535,KENYON COLLEGE,1,0,1993,NA,NA,408,231,177,316,129,187,0.8,0.73,0.77,18140,40,131,348
203535,KENYON COLLEGE,1,0,1995,NA,NA,438,223,215,350,161,189,0.84,0.75,0.8,20270,46,122,380
203535,KENYON COLLEGE,1,0,1996,NA,NA,423,238,185,338,147,191,0.8,0.79,0.8,21370,47,140,375
203535,KENYON COLLEGE,1,0,1997,NA,NA,441,255,186,349,143,206,0.8,0.77,0.79,22200,39,127,394
203535,KENYON COLLEGE,1,0,1998,NA,NA,451,252,199,369,156,213,0.84,0.78,0.82,22990,41,131,397
203535,KENYON COLLEGE,1,0,1999,NA,NA,459,255,204,367,166,201,0.78,0.81,0.8,23900,44,141,403
203535,KENYON COLLEGE,1,0,2000,NA,NA,436,227,209,371,168,203,0.89,0.8,0.85,25370,48,141,351
203535,KENYON COLLEGE,1,0,2001,NA,NA,424,243,181,344,149,195,0.8,0.82,0.81,26800,53,142,347
203535,KENYON COLLEGE,1,0,2002,NA,NA,440,246,194,376,158,218,0.88,0.81,0.85,27900,57,148,381
203535,KENYON COLLEGE,1,0,2003,NA,NA,453,247,206,386,176,210,0.85,0.85,0.85,29500,61,151,387
203535,KENYON COLLEGE,1,0,2004,NA,NA,467,237,230,396,189,207,0.87,0.82,0.85,31260,63,146,375
203535,Kenyon College,1,0,2005,NA,NA,439,239,200,364,165,199,0.8300000000000001,0.82,0.83,32980,63,151,372
203535,Kenyon College,1,0,2006,NA,NA,457,226,231,397,190,207,0.91,0.82,0.87,34990,75,153,370
203535,Kenyon College,1,0,2007,NA,NA,458,249,209,395,175,220,0.88,0.84,0.86,37030,78,152,366
203535,Kenyon College,1,0,2008,NA,NA,455,237,218,404,192,212,0.89,0.88,0.89,39080,82,159,360
203535,Kenyon College,1,0,2009,NA,NA,468,248,220,393,176,217,0.87,0.8,0.84,39810,84,156,355
203535,Kenyon College,1,0,2010,NA,NA,483,265,218,429,191,238,0.89,0.88,0.89,39420,85,159,395
203580,LAKE ERIE COLLEGE,1,0,1991,NA,NA,61,49,12,18,3,15,0.3,0.25,0.3,8480,7,27,59
203580,LAKE ERIE COLLEGE,1,0,1992,NA,NA,36,29,7,14,1,13,0.44,0.14,0.39,8960,8,30,35
203580,LAKE ERIE COLLEGE,1,0,1993,NA,NA,51,39,12,12,1,11,0.28,0.08,0.24,9600,6,29,47
203580,LAKE ERIE COLLEGE,1,0,1995,NA,NA,66,50,16,26,5,21,0.42,0.31,0.39,12320,8,32,61
203580,LAKE ERIE COLLEGE,1,0,1996,NA,NA,61,44,17,32,10,22,0.5,0.59,0.52,12950,8,29,56
203580,LAKE ERIE COLLEGE,1,0,1997,NA,NA,70,47,23,29,13,16,0.34,0.57,0.41,13750,7,27,64
203580,LAKE ERIE COLLEGE,1,0,1998,NA,NA,68,62,6,32,3,29,0.46,0.5,0.47,14298,8,27,65
203580,LAKE ERIE COLLEGE,1,0,1999,NA,NA,103,70,33,36,8,28,0.4,0.24,0.35,14280,8,28,87
203580,LAKE ERIE COLLEGE,1,0,2000,NA,NA,86,63,23,26,6,20,0.31,0.26,0.3,15140,9,30,79
203580,LAKE ERIE COLLEGE,1,0,2001,NA,NA,127,98,29,46,7,39,0.39,0.24,0.36,15750,10,32,103
203580,LAKE ERIE COLLEGE,1,0,2002,NA,NA,133,102,31,38,4,34,0.33,0.13,0.29,16370,11,37,113
203580,LAKE ERIE COLLEGE,1,0,2003,NA,NA,120,86,34,41,13,28,0.32,0.38,0.34,16880,12,35,95
203580,LAKE ERIE COLLEGE,1,0,2004,NA,NA,141,104,37,48,10,38,0.36,0.27,0.34,17724,12,37,115
203580,Lake Erie College,1,0,2005,NA,NA,116,88,28,49,8,41,0.46,0.29,0.42,20500,13,32,94
203580,Lake Erie College,1,0,2006,NA,NA,131,89,42,48,13,35,0.39,0.31,0.37,21936,14,36,112
203580,Lake Erie College,1,0,2007,NA,NA,237,108,129,66,21,45,0.41000000000000003,0.16,0.28,22814,16,36,194
203580,Lake Erie College,1,0,2008,NA,NA,249,131,118,91,29,62,0.47000000000000003,0.25,0.37,23950,19,45,206
203580,Lake Erie College,1,0,2009,NA,NA,263,127,136,95,44,51,0.4,0.32,0.36,23950,24,45,201
203580,Lake Erie College,1,0,2010,NA,NA,256,123,133,78,28,50,0.4,0.21,0.3,24308,23,46,204
203775,MALONE COLLEGE,1,0,1991,NA,NA,312,206,106,89,21,68,0.33,0.2,0.29,7860,13,68,297
203775,MALONE COLLEGE,1,0,1992,NA,NA,363,236,127,114,33,81,0.34,0.26,0.31,8490,15,69,352
203775,MALONE COLLEGE,1,0,1993,NA,NA,427,218,209,110,34,76,0.34,0.16,0.26,9172,17,70,392
203775,MALONE COLLEGE,1,0,1995,NA,NA,408,261,147,131,39,92,0.35000000000000003,0.27,0.32,10345,21,83,390
203775,MALONE COLLEGE,1,0,1996,NA,NA,400,234,166,141,41,100,0.42,0.25,0.35,10765,26,85,384
203775,MALONE COLLEGE,1,0,1997,NA,NA,464,293,171,208,73,135,0.46,0.43,0.45,11280,14,89,446
203775,MALONE COLLEGE,1,0,1998,NA,NA,398,235,163,153,56,97,0.41000000000000003,0.34,0.38,11795,19,93,378
203775,MALONE COLLEGE,1,0,1999,NA,NA,406,248,158,160,47,113,0.45,0.3,0.39,12150,21,99,388
203775,MALONE COLLEGE,1,0,2000,NA,NA,388,240,148,157,49,108,0.45,0.33,0.4,12800,23,101,371
203775,MALONE COLLEGE,1,0,2001,NA,NA,355,214,141,145,46,99,0.46,0.33,0.41,13310,23,103,335
203775,MALONE COLLEGE,1,0,2002,NA,NA,348,219,129,148,54,94,0.42,0.42,0.43,13910,25,100,329
203775,MALONE COLLEGE,1,0,2003,NA,NA,389,238,151,173,48,125,0.52,0.32,0.44,14745,25,99,369
203775,MALONE COLLEGE,1,0,2004,NA,NA,400,239,161,181,53,128,0.53,0.33,0.45,15630,27,104,379
203775,Malone College,1,0,2005,NA,NA,357,199,158,165,61,104,0.52,0.39,0.46,16530,28,105,323
203775,Malone College,1,0,2006,NA,NA,341,208,133,159,58,101,0.48,0.44,0.47,17520,30,108,315
203775,Malone College,1,0,2007,NA,NA,387,235,152,177,58,119,0.5,0.38,0.46,18600,32,108,365
203775,Malone University,1,0,2008,NA,NA,389,233,156,147,44,103,0.44,0.28,0.38,19740,35,110,364
203775,Malone University,1,0,2009,NA,NA,477,275,202,230,80,150,0.54,0.4,0.48,20730,38,110,432
203775,Malone University,1,0,2010,NA,NA,375,196,179,167,68,99,0.5,0.38,0.45,21954,39,107,330
203845,MARIETTA COLLEGE,1,0,1991,NA,NA,215,108,107,102,41,61,0.56,0.38,0.47,11800,20,73,206
203845,MARIETTA COLLEGE,1,0,1992,NA,NA,370,150,220,165,82,83,0.55,0.37,0.45,12370,21,72,360
203845,MARIETTA COLLEGE,1,0,1993,NA,NA,342,145,197,174,84,90,0.62,0.43,0.51,13170,21,69,324
203845,MARIETTA COLLEGE,1,0,1995,NA,NA,292,120,172,124,51,73,0.6,0.3,0.42,14850,25,71,231
203845,MARIETTA COLLEGE,1,0,1996,NA,NA,271,111,160,110,50,60,0.54,0.31,0.41,15490,25,71,239
203845,MARIETTA COLLEGE,1,0,1997,NA,NA,331,163,168,157,72,85,0.52,0.43,0.47,15950,22,71,284
203845,MARIETTA COLLEGE,1,0,1998,NA,NA,338,177,161,146,46,100,0.56,0.29,0.43,16790,22,73,294
203845,MARIETTA COLLEGE,1,0,1999,NA,NA,302,136,166,149,70,79,0.58,0.42,0.49,17310,23,75,244
203845,MARIETTA COLLEGE,1,0,2000,NA,NA,303,141,162,154,75,79,0.56,0.46,0.51,18010,24,76,262
203845,MARIETTA COLLEGE,1,0,2001,NA,NA,362,151,211,164,77,87,0.5700000000000001,0.36,0.45,18838,25,77,300
203845,MARIETTA COLLEGE,1,0,2002,NA,NA,263,129,134,120,49,71,0.55,0.37,0.46,19762,26,76,231
203845,MARIETTA COLLEGE,1,0,2003,NA,NA,376,168,208,160,70,90,0.53,0.34,0.43,20356,28,78,328
203845,MARIETTA COLLEGE,1,0,2004,NA,NA,439,215,224,200,78,122,0.56,0.35,0.46,21170,29,94,365
203845,Marietta College,1,0,2005,NA,NA,387,179,208,162,68,94,0.52,0.33,0.42,22070,31,96,309
203845,Marietta College,1,0,2006,NA,NA,385,191,194,206,83,123,0.64,0.43,0.54,23200,33,94,315
203845,Marietta College,1,0,2007,NA,NA,415,201,214,182,75,107,0.53,0.35,0.44,24220,36,97,308
203845,Marietta College,1,0,2008,NA,NA,385,178,207,201,95,106,0.59,0.46,0.52,25430,39,103,308
203845,Marietta College,1,0,2009,NA,NA,386,178,208,218,109,109,0.61,0.52,0.56,26386,42,104,290
203845,Marietta College,1,0,2010,NA,NA,387,191,196,199,85,114,0.59,0.43,0.51,27640,41,108,276
204024,MIAMI UNIVERSITY OXFORD CAMPUS,1,0,1991,NA,NA,3241,1858,1383,2040,736,1304,0.7000000000000001,0.53,0.63,3692,185,769,3053
204024,MIAMI UNIVERSITY OXFORD CAMPUS,1,0,1992,NA,NA,2985,1653,1332,1815,700,1115,0.67,0.53,0.61,4024,198,750,2779
204024,MIAMI UNIVERSITY-OXFORD,1,0,1993,NA,NA,3264,1782,1482,1948,739,1209,0.67,0.5,0.6,4226,200,763,3021
204024,MIAMI UNIVERSITY-OXFORD,1,0,1995,NA,NA,3211,1817,1394,1990,750,1240,0.68,0.54,0.62,4810,216,766,2896
204024,MIAMI UNIVERSITY-OXFORD,1,0,1996,NA,NA,3342,1935,1407,2180,798,1382,0.71,0.57,0.65,5158,233,756,2984
204024,MIAMI UNIVERSITY-OXFORD,1,0,1997,NA,NA,3379,1914,1465,2180,855,1325,0.6900000000000001,0.58,0.65,5466,249,750,3039
204024,MIAMI UNIVERSITY-OXFORD,1,0,1998,NA,NA,3332,1904,1428,2182,856,1326,0.6900000000000001,0.6,0.65,5786,266,767,2983
204024,MIAMI UNIVERSITY-OXFORD,1,0,1999,NA,NA,3588,2030,1558,2351,922,1429,0.7000000000000001,0.59,0.66,5052,276,772,3185
204024,MIAMI UNIVERSITY-OXFORD,1,0,2000,NA,NA,3359,1947,1412,2271,870,1401,0.71,0.62,0.68,5358,302,793,2973
204024,MIAMI UNIVERSITY-OXFORD,1,0,2001,NA,NA,3440,1922,1518,2305,905,1400,0.72,0.6,0.67,5796,326,814,3005
204024,MIAMI UNIVERSITY-OXFORD,1,0,2002,NA,NA,3614,1998,1616,2461,1008,1453,0.72,0.62,0.68,6386,348,807,3168
204024,MIAMI UNIVERSITY-OXFORD,1,0,2003,NA,NA,3362,1844,1518,2371,1002,1369,0.74,0.66,0.71,7019,369,825,2927
204024,MIAMI UNIVERSITY-OXFORD,1,0,2004,NA,NA,3475,1950,1525,2354,961,1393,0.71,0.63,0.68,18236,393,849,2900
204024,Miami University-Oxford,1,0,2005,NA,NA,3150,1708,1442,2198,902,1296,0.75,0.63,0.7,19877,421,832,2679
204024,Miami University-Oxford,1,0,2006,NA,NA,3630,2017,1613,2472,1010,1462,0.72,0.63,0.68,20991,451,813,3155
204024,Miami University-Oxford,1,0,2007,NA,NA,3456,1902,1554,2359,968,1391,0.73,0.62,0.68,8443,481,828,2985
204024,Miami University-Oxford,1,0,2008,NA,NA,3598,1955,1643,2357,959,1398,0.71,0.58,0.66,8178,459,867,3052
204024,Miami University-Oxford,1,0,2009,NA,NA,3219,1745,1474,2104,855,1249,0.71,0.58,0.65,10122,479,827,2686
204024,Miami University-Oxford,1,0,2010,NA,NA,3574,1944,1630,2368,969,1399,0.71,0.59,0.66,10427,509,850,3029
204185,MOUNT UNION COLLEGE,1,0,1991,NA,NA,417,194,223,189,80,109,0.56,0.36,0.45,11320,23,79,374
204185,MOUNT UNION COLLEGE,1,0,1992,NA,NA,380,178,202,170,73,97,0.54,0.36,0.45,11200,23,79,340
204185,MOUNT UNION COLLEGE,1,0,1993,NA,NA,396,194,202,197,89,108,0.55,0.44,0.5,12320,24,78,370
204185,MOUNT UNION COLLEGE,1,0,1995,NA,NA,478,229,249,248,107,141,0.61,0.43,0.52,13480,29,85,445
204185,MOUNT UNION COLLEGE,1,0,1996,NA,NA,483,217,266,254,113,141,0.64,0.42,0.53,13880,31,90,451
204185,MOUNT UNION COLLEGE,1,0,1997,NA,NA,540,297,243,306,113,193,0.64,0.47,0.57,14290,24,98,517
204185,MOUNT UNION COLLEGE,1,0,1998,NA,NA,568,289,279,318,116,202,0.6900000000000001,0.42,0.56,14480,26,105,533
204185,MOUNT UNION COLLEGE,1,0,1999,NA,NA,601,323,278,292,86,206,0.63,0.31,0.49,14080,28,111,545
204185,MOUNT UNION COLLEGE,1,0,2000,NA,NA,555,315,240,277,93,184,0.58,0.39,0.5,14720,30,115,516
204185,MOUNT UNION COLLEGE,1,0,2001,NA,NA,591,329,262,298,89,209,0.63,0.34,0.5,15440,33,120,548
204185,MOUNT UNION COLLEGE,1,0,2002,NA,NA,579,299,280,299,115,184,0.61,0.41,0.52,16240,34,126,511
204185,MOUNT UNION COLLEGE,1,0,2003,NA,NA,579,276,303,287,114,173,0.62,0.38,0.5,16900,37,128,548
204185,MOUNT UNION COLLEGE,1,0,2004,NA,NA,547,256,291,292,128,164,0.64,0.44,0.53,18560,40,128,486
204185,Mount Union College,1,0,2005,NA,NA,503,260,243,274,104,170,0.65,0.43,0.54,19600,43,123,458
204185,Mount Union College,1,0,2006,NA,NA,636,284,352,343,149,194,0.68,0.42,0.54,20720,41,124,548
204185,Mount Union College,1,0,2007,NA,NA,593,282,311,316,130,186,0.65,0.42,0.53,21800,43,125,502
204185,Mount Union College,1,0,2008,NA,NA,663,321,342,336,126,210,0.65,0.37,0.51,22870,44,125,539
204185,Mount Union College,1,0,2009,NA,NA,578,286,292,315,124,191,0.66,0.42,0.54,23630,47,124,464
204185,University of Mount Union,1,0,2010,NA,NA,630,261,369,333,151,182,0.6900000000000001,0.41,0.53,24500,48,126,523
204194,MOUNT VERNON NAZARENE COLLEGE,1,0,1991,NA,NA,231,145,86,82,31,51,0.35000000000000003,0.36,0.35,5750,11,57,222
204194,MOUNT VERNON NAZARENE COLLEGE,1,0,1992,NA,NA,283,168,115,86,36,50,0.29,0.31,0.3,6230,12,55,274
204194,MOUNT VERNON NAZARENE COLLEGE,1,0,1993,NA,NA,335,201,134,108,35,73,0.36,0.26,0.32,7190,14,51,330
204194,MOUNT VERNON NAZARENE COLLEGE,1,0,1995,NA,NA,379,228,151,121,51,70,0.3,0.34,0.32,8590,18,61,366
204194,MOUNT VERNON NAZARENE COLLEGE,1,0,1996,NA,NA,407,252,155,154,43,111,0.44,0.28,0.38,9240,21,67,388
204194,MOUNT VERNON NAZARENE COLLEGE,1,0,1997,NA,NA,333,195,138,119,45,74,0.37,0.33,0.36,9430,20,66,325
204194,MOUNT VERNON NAZARENE COLLEGE,1,0,1998,NA,NA,345,205,140,141,44,97,0.47000000000000003,0.31,0.41,10124,21,66,335
204194,MOUNT VERNON NAZARENE COLLEGE,1,0,1999,NA,NA,393,231,162,145,49,96,0.41000000000000003,0.3,0.37,10792,22,74,375
204194,MOUNT VERNON NAZARENE COLLEGE,1,0,2000,NA,NA,365,228,137,139,39,100,0.43,0.28,0.38,11468,24,72,343
204194,MOUNT VERNON NAZARENE COLLEGE,1,0,2001,NA,NA,321,176,145,110,34,76,0.43,0.23,0.34,12122,27,71,310
204194,MOUNT VERNON NAZARENE UNIVERSITY,1,0,2002,NA,NA,332,203,129,129,48,81,0.39,0.37,0.39,12810,28,72,315
204194,MOUNT VERNON NAZARENE UNIVERSITY,1,0,2003,NA,NA,373,221,152,137,51,86,0.38,0.34,0.37,13794,30,87,357
204194,MOUNT VERNON NAZARENE UNIVERSITY,1,0,2004,NA,NA,303,184,119,130,44,86,0.46,0.37,0.43,14482,32,90,292
204194,Mount Vernon Nazarene University,1,0,2005,NA,NA,380,241,139,149,49,100,0.41000000000000003,0.35,0.39,15384,34,101,355
204194,Mount Vernon Nazarene University,1,0,2006,NA,NA,346,201,145,160,66,94,0.46,0.46,0.46,16366,37,112,324
204194,Mount Vernon Nazarene University,1,0,2007,NA,NA,350,210,140,171,56,115,0.54,0.4,0.49,17544,38,116,334
204194,Mount Vernon Nazarene University,1,0,2008,NA,NA,368,234,134,183,66,117,0.5,0.49,0.5,18770,36,119,348
204194,Mount Vernon Nazarene University,1,0,2009,NA,NA,300,190,110,172,61,111,0.58,0.55,0.57,19730,38,108,278
204194,Mount Vernon Nazarene University,1,0,2010,NA,NA,388,240,148,217,83,134,0.55,0.56,0.56,20700,38,106,355
204617,OHIO DOMINICAN COLLEGE,1,0,1991,NA,NA,205,108,97,54,24,30,0.27,0.25,0.26,7020,11,52,132
204617,OHIO DOMINICAN COLLEGE,1,0,1992,NA,NA,208,121,87,56,19,37,0.3,0.22,0.27,7370,12,53,141
204617,OHIO DOMINICAN COLLEGE,1,0,1993,NA,NA,225,123,102,61,16,45,0.36,0.16,0.27,7730,13,53,153
204617,OHIO DOMINICAN COLLEGE,1,0,1995,NA,NA,172,110,62,46,12,34,0.3,0.19,0.27,8490,16,57,119
204617,OHIO DOMINICAN COLLEGE,1,0,1996,NA,NA,180,113,67,52,11,41,0.36,0.16,0.29,8910,15,56,135
204617,OHIO DOMINICAN COLLEGE,1,0,1997,NA,NA,180,101,79,65,18,47,0.46,0.23,0.36,9350,14,54,143
204617,OHIO DOMINICAN COLLEGE,1,0,1998,NA,NA,184,118,66,73,18,55,0.46,0.27,0.4,9790,15,57,142
204617,OHIO DOMINICAN COLLEGE,1,0,1999,NA,NA,186,120,66,68,16,52,0.43,0.24,0.37,10250,16,55,129
204617,OHIO DOMINICAN COLLEGE,1,0,2000,NA,NA,179,118,61,48,15,33,0.27,0.25,0.27,10710,19,57,120
204617,OHIO DOMINICAN COLLEGE,1,0,2001,NA,NA,174,116,58,51,18,33,0.28,0.31,0.29,12530,21,60,133
204617,OHIO DOMINICAN UNIVERSITY,1,0,2002,NA,NA,251,163,88,94,34,60,0.36,0.39,0.37,16200,23,61,199
204617,OHIO DOMINICAN UNIVERSITY,1,0,2003,NA,NA,296,191,105,88,27,61,0.31,0.26,0.3,17200,25,60,221
204617,OHIO DOMINICAN UNIVERSITY,1,0,2004,NA,NA,415,202,213,143,57,86,0.42,0.27,0.34,18000,25,64,349
204617,Ohio Dominican University,1,0,2005,NA,NA,372,172,200,129,65,64,0.37,0.32,0.35,19400,27,66,298
204617,Ohio Dominican University,1,0,2006,NA,NA,354,177,177,107,51,56,0.31,0.29,0.3,20500,29,70,258
204617,Ohio Dominican University,1,0,2007,NA,NA,391,207,184,112,48,64,0.3,0.26,0.29,21720,30,68,307
204617,Ohio Dominican University,1,0,2008,NA,NA,356,194,162,113,49,64,0.32,0.3,0.32,22990,32,72,266
204617,Ohio Dominican University,1,0,2009,NA,NA,274,143,131,98,40,58,0.4,0.31,0.36,24116,34,75,201
204617,Ohio Dominican University,1,0,2010,NA,NA,272,146,126,78,30,48,0.32,0.24,0.29,24780,37,74,163
204796,OHIO STATE UNIVERSITY-MAIN CAMPUS,0,1,1991,Inf,0,5502,2705,2797,1061,375,686,0.25,0.13,0.19,2568,1182,1960,4641
204796,OHIO STATE UNIVERSITY-MAIN CAMPUS,0,1,1992,Inf,0,5389,2625,2764,1024,351,673,0.25,0.13,0.19,2799,1310,1925,4458
204796,OHIO STATE UNIVERSITY-MAIN CAMPUS,0,1,1993,Inf,0,5283,2710,2573,1074,371,703,0.25,0.14,0.2,2940,1291,1922,4340
204796,OHIO STATE UNIVERSITY-MAIN CAMPUS,0,1,1995,Inf,0,5788,2951,2837,1354,478,876,0.29,0.17,0.23,3273,1475,1794,4696
204796,OHIO STATE UNIVERSITY-MAIN CAMPUS,0,1,1996,Inf,0,6027,3018,3009,1526,565,961,0.31,0.19,0.25,3468,1449,1853,4920
204796,OHIO STATE UNIVERSITY-MAIN CAMPUS,0,1,1997,Inf,0,5897,3081,2816,1719,555,1164,0.37,0.2,0.29,3687,1488,1979,4671
204796,OHIO STATE UNIVERSITY-MAIN CAMPUS,0,1,1998,Inf,0,6151,3177,2974,1886,610,1276,0.4,0.21,0.31,3906,1634,1946,4950
204796,OHIO STATE UNIVERSITY-MAIN CAMPUS,0,1,1999,Inf,0,6067,3029,3038,2120,777,1343,0.44,0.26,0.35,3780,1720,2075,4806
204796,OHIO STATE UNIVERSITY-MAIN CAMPUS,0,1,2000,Inf,0,5831,3008,2823,2282,851,1431,0.47000000000000003,0.3,0.39,4005,1953,2044,4584
204796,OHIO STATE UNIVERSITY-MAIN CAMPUS,0,1,2001,Inf,0,5955,2935,3020,2381,906,1475,0.5,0.3,0.4,4410,2060,2014,4568
204796,OHIO STATE UNIVERSITY-MAIN CAMPUS,0,1,2002,Inf,0,5936,2945,2991,2511,989,1522,0.51,0.33,0.42,5304,2240,2006,4606
204796,OHIO STATE UNIVERSITY-MAIN CAMPUS,0,1,2003,Inf,0,6347,3201,3146,2938,1132,1806,0.56,0.36,0.46,6228,2428,2181,5067
204796,OHIO STATE UNIVERSITY-MAIN CAMPUS,0,1,2004,Inf,0,6031,2891,3140,2930,1241,1689,0.58,0.4,0.49,7077,2722,2178,4917
204796,Ohio State University-Main Campus,0,1,2005,Inf,0,5929,3005,2924,3032,1219,1813,0.6,0.42,0.51,7509,3003,2072,4783
204796,Ohio State University-Main Campus,0,1,2006,Inf,0,6262,3104,3158,3295,1373,1922,0.61,0.43,0.53,7983,3285,2158,5059
204796,Ohio State University-Main Campus,0,1,2007,Inf,0,6155,3039,3116,3602,1534,2068,0.68,0.49,0.59,7983,3578,2173,4978
204796,Ohio State University-Main Campus,0,1,2008,Inf,0,6151,3068,3083,3780,1643,2137,0.6900000000000001,0.53,0.61,7983,3827,2167,4905
204796,Ohio State University-Main Campus,0,1,2009,Inf,0,6724,3237,3487,3935,1699,2236,0.6900000000000001,0.49,0.59,7983,3990,2160,5297
204796,Ohio State University-Main Campus,0,1,2010,Inf,0,6651,3319,3332,3907,1657,2250,0.67,0.5,0.59,8541,4240,2133,4981
204857,OHIO UNIVERSITY MAIN CAMPUS,0,1,1991,Inf,0,3187,1819,1368,1308,448,860,0.47000000000000003,0.33,0.41,2967,213,693,2927
204857,OHIO UNIVERSITY MAIN CAMPUS,0,1,1992,Inf,0,3235,1952,1283,1396,427,969,0.49,0.33,0.43,3234,223,680,2985
204857,OHIO UNIVERSITY MAIN CAMPUS,0,1,1993,Inf,0,3148,1782,1366,1297,433,864,0.48,0.32,0.41,3384,229,687,2940
204857,OHIO UNIVERSITY MAIN CAMPUS,0,1,1995,Inf,0,3358,1939,1419,1459,479,980,0.5,0.34,0.43,3666,272,718,3114
204857,OHIO UNIVERSITY MAIN CAMPUS,0,1,1996,Inf,0,3123,1832,1291,1390,446,944,0.51,0.35,0.45,4080,291,739,2922
204857,OHIO UNIVERSITY-MAIN CAMPUS,0,1,1997,Inf,0,3255,1913,1342,1401,427,974,0.5,0.32,0.43,4275,305,723,3045
204857,OHIO UNIVERSITY-MAIN CAMPUS,0,1,1998,Inf,0,3369,1988,1381,1489,480,1009,0.5,0.35,0.44,4530,326,695,3123
204857,OHIO UNIVERSITY-MAIN CAMPUS,0,1,1999,Inf,0,3389,1977,1412,1553,490,1063,0.53,0.35,0.46,4800,349,697,3201
204857,OHIO UNIVERSITY-MAIN CAMPUS,0,1,2000,Inf,0,3586,2041,1545,1693,588,1105,0.54,0.38,0.47,5085,367,697,3359
204857,OHIO UNIVERSITY-MAIN CAMPUS,0,1,2001,Inf,0,3697,2200,1497,1778,594,1184,0.53,0.4,0.48,5493,384,698,3490
204857,OHIO UNIVERSITY-MAIN CAMPUS,0,1,2002,Inf,0,3628,2068,1560,1832,670,1162,0.56,0.43,0.5,6336,372,724,3406
204857,OHIO UNIVERSITY-MAIN CAMPUS,0,1,2003,Inf,0,3587,2026,1561,1722,638,1084,0.53,0.41,0.48,7128,385,746,3359
204857,OHIO UNIVERSITY-MAIN CAMPUS,0,1,2004,Inf,0,3734,2050,1684,1703,616,1087,0.53,0.37,0.46,7770,397,737,3498
204857,Ohio University-Main Campus,0,1,2005,Inf,0,4078,2148,1930,1788,697,1091,0.5,0.36,0.44,8235,422,869,3744
204857,Ohio University-Main Campus,0,1,2006,Inf,0,4009,2063,1946,1766,693,1073,0.52,0.36,0.44,8727,430,873,3668
204857,Ohio University-Main Campus,0,1,2007,Inf,0,3970,2059,1911,1902,781,1121,0.54,0.41,0.48,8907,462,854,3571
204857,Ohio University-Main Campus,0,1,2008,Inf,0,3908,2114,1794,1910,769,1141,0.53,0.43,0.49,8907,465,881,3457
204857,Ohio University-Main Campus,0,1,2009,Inf,0,4052,2217,1835,1954,702,1252,0.56,0.38,0.48,8973,498,907,3591
204857,Ohio University-Main Campus,0,1,2010,Inf,0,3949,2129,1820,1799,689,1110,0.52,0.38,0.46,9603,574,898,3476
206330,URBANA UNIVERSITY,1,0,1991,NA,NA,188,66,122,16,9,7,0.1,0.07,0.09,7155,9,33,122
206330,URBANA UNIVERSITY,1,0,1992,NA,NA,148,48,100,15,7,8,0.16,0.07,0.1,8075,10,34,95
206330,URBANA UNIVERSITY,1,0,1993,NA,NA,200,61,139,33,15,18,0.29,0.11,0.16,9025,11,37,131
206330,URBANA UNIVERSITY,1,0,1995,NA,NA,213,87,126,28,12,16,0.18,0.1,0.13,9454,12,36,140
206330,URBANA UNIVERSITY,1,0,1996,NA,NA,235,94,141,31,12,19,0.2,0.09,0.13,9824,13,36,166
206330,URBANA UNIVERSITY,1,0,1997,NA,NA,96,40,56,12,4,8,0.2,0.07,0.12,10172,7,32,75
206330,URBANA UNIVERSITY,1,0,1998,NA,NA,143,68,75,37,13,24,0.35000000000000003,0.17,0.26,10530,6,34,109
206330,URBANA UNIVERSITY,1,0,1999,NA,NA,121,40,81,45,20,25,0.62,0.25,0.37,10846,7,38,104
206330,URBANA UNIVERSITY,1,0,2000,NA,NA,215,84,131,38,19,19,0.22,0.15,0.18,11388,8,40,165
206330,URBANA UNIVERSITY,1,0,2001,NA,NA,202,67,135,42,19,23,0.34,0.14,0.21,11844,9,43,142
206330,URBANA UNIVERSITY,1,0,2002,NA,NA,150,51,99,22,11,11,0.21,0.11,0.15,12820,9,47,114
206330,URBANA UNIVERSITY,1,0,2003,NA,NA,216,72,144,27,6,21,0.29,0.04,0.12,13540,11,50,161
206330,URBANA UNIVERSITY,1,0,2004,NA,NA,177,70,107,38,18,20,0.28,0.17,0.21,14220,13,50,151
206330,Urbana University,1,0,2005,NA,NA,240,74,166,51,27,24,0.32,0.16,0.21,15050,14,52,204
206330,Urbana University,1,0,2006,NA,NA,238,91,147,61,19,42,0.46,0.13,0.26,16254,14,53,199
206330,Urbana University,1,0,2007,NA,NA,240,101,139,57,29,28,0.27,0.21,0.24,17544,15,52,171
206330,Urbana University,1,0,2008,NA,NA,226,72,154,67,32,35,0.48,0.21,0.3,18960,16,52,128
206330,Urbana University,1,0,2009,NA,NA,182,75,107,28,10,18,0.24,0.09,0.15,19600,16,55,132
206330,Urbana University,1,0,2010,NA,NA,145,68,77,36,17,19,0.27,0.22,0.25,20188,16,55,86
206589,COLLEGE OF WOOSTER,1,0,1991,NA,NA,466,219,247,290,135,155,0.7000000000000001,0.55,0.62,13410,45,131,385
206589,COLLEGE OF WOOSTER,1,0,1992,NA,NA,459,240,219,273,118,155,0.64,0.54,0.59,14380,47,127,377
206589,COLLEGE OF WOOSTER,1,0,1993,NA,NA,548,291,257,346,139,207,0.71,0.54,0.63,15425,48,122,454
206589,COLLEGE OF WOOSTER,1,0,1995,NA,NA,433,228,205,347,147,200,0.87,0.72,0.8,17600,51,123,381
206589,COLLEGE OF WOOSTER,1,0,1996,NA,NA,516,255,261,302,136,166,0.65,0.52,0.59,18380,56,127,429
206589,COLLEGE OF WOOSTER,1,0,1997,NA,NA,538,289,249,328,130,198,0.68,0.52,0.61,19230,47,128,448
206589,COLLEGE OF WOOSTER,1,0,1998,NA,NA,504,259,245,335,147,188,0.72,0.6,0.66,19940,49,127,436
206589,COLLEGE OF WOOSTER,1,0,1999,NA,NA,513,265,248,372,164,208,0.78,0.66,0.73,25950,53,130,432
206589,COLLEGE OF WOOSTER,1,0,2000,NA,NA,501,258,243,331,137,194,0.75,0.56,0.66,21520,55,132,416
206589,COLLEGE OF WOOSTER,1,0,2001,NA,NA,532,282,250,342,143,199,0.7000000000000001,0.57,0.64,22282,60,134,438
206589,COLLEGE OF WOOSTER,1,0,2002,NA,NA,514,281,233,354,140,214,0.76,0.6,0.69,23687,65,141,380
206589,COLLEGE OF WOOSTER,1,0,2003,NA,NA,552,281,271,373,169,204,0.72,0.62,0.68,24885,65,140,416
206589,COLLEGE OF WOOSTER,1,0,2004,NA,NA,478,239,239,334,147,187,0.78,0.62,0.7,26380,70,145,361
206589,The College of Wooster,1,0,2005,NA,NA,536,267,269,362,158,204,0.76,0.59,0.68,28030,68,133,431
206589,The College of Wooster,1,0,2006,NA,NA,494,242,252,345,163,182,0.75,0.65,0.7,29840,71,137,358
206589,The College of Wooster,1,0,2007,NA,NA,545,287,258,384,159,225,0.78,0.62,0.7,31630,74,167,395
206589,The College of Wooster,1,0,2008,NA,NA,518,267,251,364,160,204,0.76,0.64,0.7,33520,76,160,351
206589,The College of Wooster,1,0,2009,NA,NA,479,264,215,371,154,217,0.8200000000000001,0.72,0.77,34690,72,164,327
206589,The College of Wooster,1,0,2010,NA,NA,617,332,285,436,180,256,0.77,0.63,0.71,36320,72,167,432
206604,WRIGHT STATE UNIVERSITY MAIN CAMPUS,0,1,1991,Inf,0,2111,1061,1050,199,66,133,0.12,0.06,0.09,2674,154,495,1860
206604,WRIGHT STATE UNIVERSITY MAIN CAMPUS,0,1,1992,Inf,0,1941,1028,913,159,42,117,0.11,0.05,0.08,2934,156,493,1672
206604,WRIGHT STATE UNIVERSITY-MAIN CAMPUS,0,1,1993,Inf,0,2002,1045,957,190,73,117,0.11,0.08,0.09,3084,158,493,1658
206604,WRIGHT STATE UNIVERSITY-MAIN CAMPUS,0,1,1995,Inf,0,1910,1033,877,214,68,146,0.14,0.08,0.11,3429,174,480,1586
206604,WRIGHT STATE UNIVERSITY-MAIN CAMPUS,0,1,1996,Inf,0,1859,995,864,281,78,203,0.2,0.09,0.15,3600,185,489,1514
206604,WRIGHT STATE UNIVERSITY-MAIN CAMPUS,0,1,1997,Inf,0,2025,1103,922,336,126,210,0.19,0.14,0.17,3708,192,482,1605
206604,WRIGHT STATE UNIVERSITY-MAIN CAMPUS,0,1,1998,Inf,0,2101,1178,923,354,109,245,0.2,0.12,0.17,3930,202,481,1638
206604,WRIGHT STATE UNIVERSITY-MAIN CAMPUS,0,1,1999,Inf,0,2127,1202,925,352,99,253,0.21,0.11,0.17,4128,217,445,1617
206604,WRIGHT STATE UNIVERSITY-MAIN CAMPUS,0,1,2000,Inf,0,2124,1217,907,403,117,286,0.23,0.13,0.19,4335,231,465,1709
206604,WRIGHT STATE UNIVERSITY-MAIN CAMPUS,0,1,2001,Inf,0,2117,1165,952,373,129,244,0.2,0.14,0.18,4596,239,485,1709
206604,WRIGHT STATE UNIVERSITY-MAIN CAMPUS,0,1,2002,Inf,0,2169,1225,944,407,128,279,0.22,0.14,0.19,5262,243,530,1732
206604,WRIGHT STATE UNIVERSITY-MAIN CAMPUS,0,1,2003,Inf,0,2272,1312,960,78,16,62,0.04,0.02,0.03,5682,262,528,1739
206604,WRIGHT STATE UNIVERSITY-MAIN CAMPUS,0,1,2004,Inf,0,2289,1302,987,418,156,262,0.2,0.16,0.18,6245,279,595,1665
206604,Wright State University-Main Campus,0,1,2005,Inf,0,2302,1331,971,413,141,272,0.2,0.15,0.18,6619,301,597,1717
206604,Wright State University-Main Campus,0,1,2006,Inf,0,2178,1211,967,422,155,267,0.22,0.16,0.19,7018,313,625,1629
206604,Wright State University-Main Campus,0,1,2007,Inf,0,2371,1339,1032,447,160,287,0.21,0.16,0.19,7018,344,649,1726
206604,Wright State University-Main Campus,0,1,2008,Inf,0,2596,1496,1100,556,193,363,0.24,0.18,0.21,7018,360,665,1866
206604,Wright State University-Main Campus,0,1,2009,Inf,0,2463,1378,1085,515,196,319,0.23,0.18,0.21,7263,374,665,1790
206604,Wright State University-Main Campus,0,1,2010,Inf,0,2739,1586,1153,527,197,330,0.2,0.17,0.19,7518,397,657,1877
206622,XAVIER UNIVERSITY,1,0,1991,NA,NA,719,380,339,383,193,190,0.5,0.57,0.53,9700,54,229,634
206622,XAVIER UNIVERSITY,1,0,1992,NA,NA,672,331,341,345,166,179,0.54,0.49,0.51,10450,59,231,592
206622,XAVIER UNIVERSITY,1,0,1993,NA,NA,696,381,315,368,170,198,0.51,0.54,0.53,10970,63,230,623
206622,XAVIER UNIVERSITY,1,0,1995,NA,NA,698,396,302,394,177,217,0.54,0.59,0.56,12270,71,221,628
206622,XAVIER UNIVERSITY,1,0,1996,NA,NA,778,461,317,458,184,274,0.59,0.58,0.59,12950,76,231,697
206622,XAVIER UNIVERSITY,1,0,1997,NA,NA,757,439,318,512,220,292,0.66,0.69,0.68,13650,64,229,675
206622,XAVIER UNIVERSITY,1,0,1998,NA,NA,831,483,348,541,227,314,0.65,0.65,0.65,14400,69,223,755
206622,XAVIER UNIVERSITY,1,0,1999,NA,NA,771,464,307,540,213,327,0.7000000000000001,0.69,0.7,14950,72,230,681
206622,XAVIER UNIVERSITY,1,0,2000,NA,NA,776,436,340,515,223,292,0.66,0.66,0.66,15680,77,228,678
206622,XAVIER UNIVERSITY,1,0,2001,NA,NA,795,426,369,555,249,306,0.71,0.67,0.7,16540,89,227,708
206622,XAVIER UNIVERSITY,1,0,2002,NA,NA,757,424,333,518,224,294,0.6900000000000001,0.67,0.68,17780,95,268,659
206622,XAVIER UNIVERSITY,1,0,2003,NA,NA,786,428,358,526,230,296,0.6900000000000001,0.64,0.67,18850,102,278,672
206622,XAVIER UNIVERSITY,1,0,2004,NA,NA,878,470,408,611,268,343,0.72,0.66,0.7,20100,110,282,725
206622,Xavier University,1,0,2005,NA,NA,765,430,335,523,206,317,0.73,0.61,0.68,21850,113,294,607
206622,Xavier University,1,0,2006,NA,NA,812,459,353,574,244,330,0.71,0.69,0.71,23270,119,298,654
206622,Xavier University,1,0,2007,NA,NA,858,447,411,572,268,304,0.68,0.65,0.67,23990,124,309,706
206622,Xavier University,1,0,2008,NA,NA,859,436,423,542,244,298,0.68,0.58,0.63,26250,130,309,686
206622,Xavier University,1,0,2009,NA,NA,1178,637,541,779,352,427,0.67,0.65,0.66,27900,136,313,1019
206622,Xavier University,1,0,2010,NA,NA,1042,554,488,641,298,343,0.61,0.61,0.62,29300,144,330,836
206695,YOUNGSTOWN STATE UNIVERSITY,0,1,1991,2000,0,1904,981,923,88,31,57,0.05,0.03,0.05,2415,103,475,1665
206695,YOUNGSTOWN STATE UNIVERSITY,0,1,1992,2000,0,1908,962,946,129,59,70,0.07,0.06,0.07,2640,106,465,1649
206695,YOUNGSTOWN STATE UNIVERSITY,0,1,1993,2000,0,1967,1005,962,180,78,102,0.1,0.08,0.09,2772,105,459,1708
206695,YOUNGSTOWN STATE UNIVERSITY,0,1,1995,2000,0,1905,1004,901,208,85,123,0.12,0.09,0.11,3084,125,453,1661
206695,YOUNGSTOWN STATE UNIVERSITY,0,1,1996,2000,0,1685,859,826,212,88,124,0.14,0.11,0.13,3336,107,421,1429
206695,YOUNGSTOWN STATE UNIVERSITY,0,1,1997,2000,0,1764,924,840,231,85,146,0.15,0.1,0.13,3558,106,418,1480
206695,YOUNGSTOWN STATE UNIVERSITY,0,1,1998,2000,0,1839,954,885,250,81,169,0.17,0.09,0.14,3762,112,412,1553
206695,YOUNGSTOWN STATE UNIVERSITY,0,1,1999,2000,0,1911,954,957,241,89,152,0.15,0.09,0.13,3783,120,402,1580
206695,YOUNGSTOWN STATE UNIVERSITY,1,0,2000,2000,1,1853,943,910,220,95,125,0.13,0.1,0.12,3876,129,394,1563
206695,YOUNGSTOWN STATE UNIVERSITY,1,0,2001,2000,1,1951,1041,910,243,81,162,0.15,0.09,0.12,4083,146,387,1566
206695,YOUNGSTOWN STATE UNIVERSITY,1,0,2002,2000,1,1944,1058,886,234,76,158,0.14,0.09,0.12,4868,137,402,1548
206695,YOUNGSTOWN STATE UNIVERSITY,1,0,2003,2000,1,1976,1048,928,207,73,134,0.12,0.08,0.1,4320,151,407,1574
206695,YOUNGSTOWN STATE UNIVERSITY,1,0,2004,2000,1,2025,1081,944,247,91,156,0.14,0.1,0.12,4647,155,422,1561
206695,Youngstown State University,1,0,2005,2000,1,2012,1029,983,177,61,116,0.11,0.06,0.09,5000,164,427,1503
206695,Youngstown State University,1,0,2006,2000,1,2169,1095,1074,187,74,113,0.1,0.07,0.09,5364,171,426,1589
206695,Youngstown State University,1,0,2007,2000,1,2140,1101,1039,168,70,98,0.08,0.07,0.08,5364,176,429,1487
206695,Youngstown State University,1,0,2008,2000,1,2189,1090,1099,199,74,125,0.11,0.07,0.09,5364,185,440,1579
206695,Youngstown State University,1,0,2009,2000,1,2564,1306,1258,240,111,129,0.09,0.09,0.09,6727,194,447,1755
206695,Youngstown State University,1,0,2010,2000,1,2633,1330,1303,250,122,128,0.09,0.09,0.09,6970,209,456,1803
206914,CAMERON UNIVERSITY,1,0,1991,NA,NA,466,220,246,23,9,14,0.06,0.04,0.05,1377,24,186,329
206914,CAMERON UNIVERSITY,1,0,1992,NA,NA,577,323,254,27,6,21,0.06,0.02,0.05,1377,27,185,394
206914,CAMERON UNIVERSITY,1,0,1993,NA,NA,626,350,276,54,26,28,0.08,0.09,0.09,1510,28,177,447
206914,CAMERON UNIVERSITY,1,0,1995,NA,NA,620,358,262,61,26,35,0.09,0.1,0.1,1362,27,175,435
206914,CAMERON UNIVERSITY,1,0,1996,NA,NA,616,353,263,63,25,38,0.1,0.1,0.1,1759,28,165,441
206914,CAMERON UNIVERSITY,1,0,1997,NA,NA,615,322,293,50,21,29,0.09,0.07,0.08,1872,32,171,424
206914,CAMERON UNIVERSITY,1,0,1998,NA,NA,590,327,263,35,13,22,0.06,0.05,0.06,1895,32,168,406
206914,CAMERON UNIVERSITY,1,0,1999,NA,NA,673,355,318,54,16,38,0.1,0.05,0.08,1470,35,180,430
206914,CAMERON UNIVERSITY,1,0,2000,NA,NA,620,339,281,68,24,44,0.12,0.09,0.11,1470,36,185,367
206914,CAMERON UNIVERSITY,1,0,2001,NA,NA,673,355,318,55,16,39,0.1,0.05,0.08,1572,36,190,430
206914,CAMERON UNIVERSITY,1,0,2002,NA,NA,583,330,253,39,17,22,0.06,0.07,0.07,1682,38,190,372
206914,CAMERON UNIVERSITY,1,0,2003,NA,NA,667,375,292,34,15,19,0.05,0.05,0.05,1950,39,178,385
206914,CAMERON UNIVERSITY,1,0,2004,NA,NA,762,409,353,31,10,21,0.05,0.03,0.04,2100,41,180,466
206914,Cameron University,1,0,2005,NA,NA,714,430,284,37,22,15,0.03,0.08,0.05,2220,46,184,396
206914,Cameron University,1,0,2006,NA,NA,686,402,284,40,16,24,0.05,0.06,0.06,2352,49,172,376
206914,Cameron University,1,0,2007,NA,NA,716,382,334,50,22,28,0.07,0.07,0.07,2571,52,175,379
206914,Cameron University,1,0,2008,NA,NA,817,457,360,66,22,44,0.09,0.06,0.08,2805,56,167,389
206914,Cameron University,1,0,2009,NA,NA,855,489,366,73,28,45,0.09,0.08,0.09,2805,60,183,410
206914,Cameron University,1,0,2010,NA,NA,892,520,372,43,21,22,0.04,0.06,0.05,2963,62,184,378
207209,LANGSTON UNIVERSITY,1,0,1991,NA,NA,525,295,230,19,2,17,0.05,0.01,0.04,1347,21,70,53
207209,LANGSTON UNIVERSITY,1,0,1992,NA,NA,411,215,196,23,4,19,0.08,0.02,0.06,1360,25,69,55
207209,LANGSTON UNIVERSITY,1,0,1993,NA,NA,479,253,226,28,10,18,0.07,0.04,0.06,1441,24,110,36
207209,LANGSTON UNIVERSITY,1,0,1995,NA,NA,485,220,265,24,7,17,0.07,0.03,0.05,1707,26,103,29
207209,LANGSTON UNIVERSITY,1,0,1996,NA,NA,518,259,259,33,8,25,0.09,0.03,0.06,1707,28,112,29
207209,LANGSTON UNIVERSITY,1,0,1997,NA,NA,566,304,262,34,3,31,0.1,0.01,0.06,1893,32,110,18
207209,LANGSTON UNIVERSITY,1,0,1998,NA,NA,517,262,255,22,3,19,0.07,0.01,0.04,1896,31,130,9
207209,LANGSTON UNIVERSITY,1,0,1999,NA,NA,446,232,214,17,4,13,0.05,0.02,0.04,1410,34,126,9
207209,LANGSTON UNIVERSITY,1,0,2000,NA,NA,690,328,362,40,14,26,0.07,0.04,0.06,1485,26,126,19
207209,LANGSTON UNIVERSITY,1,0,2001,NA,NA,446,232,214,18,5,13,0.05,0.02,0.04,635,31,127,9
207209,LANGSTON UNIVERSITY,1,0,2002,NA,NA,492,248,244,31,8,23,0.09,0.03,0.06,1635,33,142,23
207209,LANGSTON UNIVERSITY,1,0,2003,NA,NA,553,256,297,23,9,14,0.05,0.03,0.04,1818,47,143,23
207209,LANGSTON UNIVERSITY,1,0,2004,NA,NA,530,245,285,16,6,10,0.04,0.02,0.03,1909,48,149,14
207209,Langston University,1,0,2005,NA,NA,670,316,354,31,3,28,0.08,0.01,0.05,1946,51,109,14
207209,Langston University,1,0,2006,NA,NA,533,271,262,32,8,24,0.08,0.03,0.06,2190,51,155,18
207209,Langston University,1,0,2007,NA,NA,559,270,289,48,8,40,0.14,0.03,0.09,2409,40,152,21
207209,Langston University,1,0,2008,NA,NA,593,281,312,19,2,17,0.06,0.01,0.03,2640,33,145,10
207209,Langston University,1,0,2009,NA,NA,561,253,308,17,6,11,0.04,0.02,0.03,2640,38,154,9
207209,Langston University,1,0,2010,NA,NA,469,226,243,11,2,9,0.03,0.01,0.02,2772,60,139,17
207306,NORTHWESTERN OKLAHOMA STATE UNIVERSITY,1,0,1991,NA,NA,356,176,180,43,18,25,0.14,0.1,0.12,1423,10,79,323
207306,NORTHWESTERN OKLAHOMA STATE UNIVERSITY,1,0,1992,NA,NA,317,164,153,36,13,23,0.14,0.08,0.11,1423,11,81,296
207306,NORTHWESTERN OKLAHOMA STATE UNIVERSITY,1,0,1993,NA,NA,228,119,109,33,12,21,0.17,0.11,0.14,1423,13,77,211
207306,NORTHWESTERN OKLAHOMA STATE UNIVERSITY,1,0,1995,NA,NA,240,127,113,39,11,28,0.22,0.1,0.16,1718,12,78,226
207306,NORTHWESTERN OKLAHOMA STATE UNIVERSITY,1,0,1996,NA,NA,234,110,124,22,11,11,0.1,0.09,0.09,1748,12,78,204
207306,NORTHWESTERN OKLAHOMA STATE UNIVERSITY,1,0,1997,NA,NA,293,148,145,35,11,24,0.16,0.08,0.12,1834,16,81,259
207306,NORTHWESTERN OKLAHOMA STATE UNIVERSITY,1,0,1998,NA,NA,290,147,143,35,15,20,0.13,0.1,0.12,1874,18,81,258
207306,NORTHWESTERN OKLAHOMA STATE UNIVERSITY,1,0,1999,NA,NA,310,138,172,36,16,20,0.14,0.09,0.12,1584,16,85,276
207306,NORTHWESTERN OKLAHOMA STATE UNIVERSITY,1,0,2000,NA,NA,329,159,170,46,15,31,0.19,0.09,0.14,1584,15,89,297
207306,NORTHWESTERN OKLAHOMA STATE UNIVERSITY,1,0,2001,NA,NA,310,138,172,36,16,20,0.14,0.09,0.12,1641,18,93,276
207306,NORTHWESTERN OKLAHOMA STATE UNIVERSITY,1,0,2002,NA,NA,298,164,134,56,19,37,0.22,0.14,0.19,1756,18,80,253
207306,NORTHWESTERN OKLAHOMA STATE UNIVERSITY,1,0,2003,NA,NA,308,139,169,45,20,25,0.17,0.12,0.15,2015,18,85,271
207306,NORTHWESTERN OKLAHOMA STATE UNIVERSITY,1,0,2004,NA,NA,292,156,136,40,12,28,0.17,0.09,0.14,2263,19,83,248
207306,Northwestern Oklahoma State University,1,0,2005,NA,NA,279,150,129,37,10,27,0.18,0.08,0.13,2604,19,86,229
207306,Northwestern Oklahoma State University,1,0,2006,NA,NA,243,121,122,29,9,20,0.16,0.07,0.12,2922,20,85,192
207306,Northwestern Oklahoma State University,1,0,2007,NA,NA,328,173,155,43,13,30,0.17,0.08,0.13,3232,21,87,272
207306,Northwestern Oklahoma State University,1,0,2008,NA,NA,317,162,155,47,14,33,0.2,0.09,0.15,3604,23,88,258
207306,Northwestern Oklahoma State University,1,0,2009,NA,NA,402,199,203,32,8,24,0.12,0.04,0.08,3604,26,87,280
207306,Northwestern Oklahoma State University,1,0,2010,NA,NA,382,182,200,51,16,35,0.19,0.08,0.13,3836,26,91,262
207324,OKLAHOMA CHRISTIAN UNIVERSITY OF SCIENCE AND ARTS,0,1,1991,2000,0,304,160,144,76,37,39,0.24,0.26,0.25,4840,17,73,233
207324,OKLAHOMA CHRISTIAN UNIVERSITY OF SCIENCE AND ARTS,0,1,1992,2000,0,355,183,172,97,41,56,0.3,0.24,0.27,5280,18,67,309
207324,OKLAHOMA CHRISTIAN UNIVERSITY OF SCIENCE AND ARTS,0,1,1993,2000,0,291,157,134,56,31,25,0.15,0.23,0.19,5780,18,80,251
207324,OKLAHOMA CHRISTIAN UNIVERSITY OF SCIENCE AND ARTS,0,1,1995,2000,0,320,158,162,78,28,50,0.31,0.17,0.24,7160,23,79,281
207324,OKLAHOMA CHRISTIAN UNIVERSITY OF SCIENCE AND ARTS,0,1,1996,2000,0,464,234,230,106,41,65,0.27,0.18,0.23,7500,30,69,409
207324,OKLAHOMA CHRISTIAN UNIVERSITY OF SCIENCE AND ARTS,0,1,1997,2000,0,453,222,231,73,32,41,0.18,0.14,0.16,7600,19,70,390
207324,OKLAHOMA CHRISTIAN UNIVERSITY OF SCIENCE AND ARTS,0,1,1998,2000,0,468,277,191,93,33,60,0.21,0.17,0.2,8200,31,81,400
207324,OKLAHOMA CHRISTIAN UNIVERSITY OF SCIENCE AND ARTS,0,1,1999,2000,0,391,219,172,123,44,79,0.36,0.26,0.31,8110,33,80,346
207324,OKLAHOMA CHRISTIAN UNIVERSITY,1,0,2000,2000,1,449,226,223,100,45,55,0.24,0.2,0.22,9700,34,83,402
207324,OKLAHOMA CHRISTIAN UNIVERSITY,1,0,2001,2000,1,465,234,231,107,42,65,0.27,0.18,0.23,10500,37,87,409
207324,OKLAHOMA CHRISTIAN UNIVERSITY,1,0,2002,2000,1,405,215,190,93,43,50,0.23,0.23,0.23,11100,36,108,343
207324,OKLAHOMA CHRISTIAN UNIVERSITY,1,0,2003,2000,1,356,199,157,99,38,61,0.3,0.24,0.28,11490,38,87,306
207324,OKLAHOMA CHRISTIAN UNIVERSITY,1,0,2004,2000,1,545,291,254,117,50,67,0.23,0.2,0.21,11780,33,84,469
207324,Oklahoma Christian University,1,0,2005,2000,1,523,270,253,144,57,87,0.32,0.23,0.28,12486,38,89,461
207324,Oklahoma Christian University,1,0,2006,2000,1,512,260,252,166,76,90,0.34,0.3,0.32,13422,44,102,443
207324,Oklahoma Christian University,1,0,2007,2000,1,521,269,252,148,63,85,0.31,0.25,0.28,14020,47,104,431
207324,Oklahoma Christian University,1,0,2008,2000,1,430,206,224,113,50,63,0.3,0.22,0.26,14690,51,106,347
207324,Oklahoma Christian University,1,0,2009,2000,1,471,218,253,148,67,81,0.37,0.26,0.31,14690,50,110,375
207324,Oklahoma Christian University,1,0,2010,2000,1,497,247,250,166,77,89,0.36,0.31,0.33,15600,50,110,379
207388,OKLAHOMA STATE UNIVERSITY MAIN CAMPUS,1,0,1991,NA,NA,2092,1038,1054,399,144,255,0.24,0.14,0.19,1758,252,843,1732
207388,OKLAHOMA STATE UNIVERSITY MAIN CAMPUS,1,0,1992,NA,NA,2148,1116,1032,400,130,270,0.24,0.13,0.19,1758,276,855,1746
207388,OKLAHOMA STATE UNIVERSITY-MAIN CAMPUS,1,0,1993,NA,NA,2050,999,1051,377,130,247,0.24,0.12,0.18,1882,277,810,1685
207388,OKLAHOMA STATE UNIVERSITY-MAIN CAMPUS,1,0,1995,NA,NA,2362,1185,1177,475,186,289,0.24,0.16,0.2,2148,292,824,1953
207388,OKLAHOMA STATE UNIVERSITY-MAIN CAMPUS,1,0,1996,NA,NA,2336,1223,1113,488,155,333,0.27,0.14,0.21,2161,300,927,1905
207388,OKLAHOMA STATE UNIVERSITY-MAIN CAMPUS,1,0,1997,NA,NA,2321,1214,1107,565,194,371,0.3,0.18,0.24,2356,335,913,1920
207388,OKLAHOMA STATE UNIVERSITY-MAIN CAMPUS,1,0,1998,NA,NA,2584,1301,1283,624,226,398,0.3,0.18,0.24,2356,370,844,2141
207388,OKLAHOMA STATE UNIVERSITY-MAIN CAMPUS,1,0,1999,NA,NA,2795,1491,1304,705,206,499,0.33,0.16,0.25,1890,398,845,2304
207388,OKLAHOMA STATE UNIVERSITY-MAIN CAMPUS,1,0,2000,NA,NA,2953,1615,1338,802,272,530,0.32,0.2,0.27,1890,430,843,2440
207388,OKLAHOMA STATE UNIVERSITY-MAIN CAMPUS,1,0,2001,NA,NA,3111,1594,1517,834,285,549,0.34,0.19,0.27,2022,445,841,2499
207388,OKLAHOMA STATE UNIVERSITY-MAIN CAMPUS,1,0,2002,NA,NA,3206,1698,1508,939,327,612,0.36,0.22,0.29,2163,453,848,2641
207388,OKLAHOMA STATE UNIVERSITY-MAIN CAMPUS,1,0,2003,NA,NA,3128,1666,1462,958,336,622,0.37,0.23,0.31,2596,488,835,2576
207388,OKLAHOMA STATE UNIVERSITY-MAIN CAMPUS,1,0,2004,NA,NA,3126,1601,1525,991,360,631,0.39,0.24,0.32,2910,507,908,2560
207388,Oklahoma State University-Main Campus,1,0,2005,NA,NA,3221,1662,1559,1106,436,670,0.4,0.28,0.34,3099,520,1023,2630
207388,Oklahoma State University-Main Campus,1,0,2006,NA,NA,3132,1658,1474,1068,383,685,0.41000000000000003,0.26,0.34,3263,554,1058,2567
207388,Oklahoma State University-Main Campus,1,0,2007,NA,NA,3111,1599,1512,1013,399,614,0.38,0.26,0.33,3585,596,1039,2450
207388,Oklahoma State University-Main Campus,1,0,2008,NA,NA,2946,1501,1445,992,361,631,0.42,0.25,0.34,3941,634,1052,2333
207388,Oklahoma State University-Main Campus,1,0,2009,NA,NA,2973,1544,1429,997,365,632,0.4,0.26,0.34,3941,684,1064,2248
207388,Oklahoma State University-Main Campus,1,0,2010,NA,NA,3403,1761,1642,1320,497,823,0.46,0.3,0.39,4103,706,1068,2519
207500,UNIVERSITY OF OKLAHOMA NORMAN CAMPUS,1,0,1991,NA,NA,2249,1082,1167,277,101,176,0.16,0.09,0.12,1722,237,785,1686
207500,UNIVERSITY OF OKLAHOMA NORMAN CAMPUS,1,0,1992,NA,NA,2376,1164,1212,264,110,154,0.13,0.09,0.11,1768,264,801,1705
207500,UNIVERSITY OF OKLAHOMA NORMAN CAMPUS,1,0,1993,NA,NA,2235,1072,1163,337,139,198,0.18,0.12,0.15,1901,261,778,1671
207500,UNIVERSITY OF OKLAHOMA NORMAN CAMPUS,1,0,1995,NA,NA,2712,1321,1391,519,191,328,0.24,0.14,0.19,2024,277,801,1960
207500,UNIVERSITY OF OKLAHOMA NORMAN CAMPUS,1,0,1996,NA,NA,2605,1264,1341,525,200,325,0.25,0.15,0.2,2178,298,809,1896
207500,UNIVERSITY OF OKLAHOMA NORMAN CAMPUS,1,0,1997,NA,NA,2895,1523,1372,552,195,357,0.23,0.14,0.19,2309,315,834,2083
207500,UNIVERSITY OF OKLAHOMA NORMAN CAMPUS,1,0,1998,NA,NA,3148,1618,1530,641,214,427,0.26,0.14,0.2,2313,357,876,2293
207500,UNIVERSITY OF OKLAHOMA NORMAN CAMPUS,1,0,1999,NA,NA,3206,1603,1603,619,237,382,0.23,0.15,0.19,1890,379,918,2326
207500,UNIVERSITY OF OKLAHOMA NORMAN CAMPUS,1,0,2000,NA,NA,3326,1760,1566,791,268,523,0.29,0.17,0.24,1890,410,927,2480
207500,UNIVERSITY OF OKLAHOMA NORMAN CAMPUS,1,0,2001,NA,NA,3629,1908,1721,897,332,565,0.29,0.19,0.25,2022,447,937,2782
207500,UNIVERSITY OF OKLAHOMA NORMAN CAMPUS,1,0,2002,NA,NA,3749,1940,1809,973,350,623,0.32,0.19,0.26,2163,472,963,2940
207500,UNIVERSITY OF OKLAHOMA NORMAN CAMPUS,1,0,2003,NA,NA,3729,1921,1808,1100,406,694,0.36,0.22,0.29,2541,488,971,2907
207500,UNIVERSITY OF OKLAHOMA NORMAN CAMPUS,1,0,2004,NA,NA,3537,1876,1661,1122,397,725,0.38,0.24,0.32,2778,494,976,2778
207500,University of Oklahoma Norman Campus,1,0,2005,NA,NA,3189,1695,1494,1107,418,689,0.4,0.28,0.35,2862,543,1003,2448
207500,University of Oklahoma Norman Campus,1,0,2006,NA,NA,3285,1732,1553,1190,457,733,0.42,0.29,0.36,3006,596,1059,2445
207500,University of Oklahoma Norman Campus,1,0,2007,NA,NA,3824,2043,1781,1331,452,879,0.43,0.25,0.35,3261,650,1113,2858
207500,University of Oklahoma Norman Campus,1,0,2008,NA,NA,3750,2058,1692,1394,525,869,0.42,0.31,0.37,3537,711,1131,2913
207500,University of Oklahoma Norman Campus,1,0,2009,NA,NA,3700,1917,1783,1411,555,856,0.44,0.31,0.38,3537,749,1142,2695
207500,University of Oklahoma Norman Campus,1,0,2010,NA,NA,3669,1945,1724,1455,549,906,0.46,0.32,0.4,3678,750,1135,2117
207722,UNIVERSITY OF SCIENCE AND ARTS OF OKLAHOMA,0,1,1991,Inf,0,203,143,60,16,2,14,0.09,0.03,0.08,1316,8,54,174
207722,UNIVERSITY OF SCIENCE AND ARTS OF OKLAHOMA,0,1,1992,Inf,0,219,151,68,33,10,23,0.15,0.15,0.15,1316,9,54,192
207722,UNIVERSITY OF SCIENCE AND ARTS OF OKLAHOMA,0,1,1993,Inf,0,207,128,79,21,6,15,0.11,0.08,0.1,1408,9,53,180
207722,UNIVERSITY OF SCIENCE AND ARTS OF OKLAHOMA,0,1,1995,Inf,0,259,164,95,33,6,27,0.16,0.06,0.13,1538,10,52,209
207722,UNIVERSITY OF SCIENCE AND ARTS OF OKLAHOMA,0,1,1996,Inf,0,261,138,123,26,11,15,0.1,0.09,0.1,1568,10,52,203
207722,UNIVERSITY OF SCIENCE AND ARTS OF OKLAHOMA,0,1,1997,Inf,0,222,133,89,32,9,23,0.17,0.1,0.14,1725,10,55,184
207722,UNIVERSITY OF SCIENCE AND ARTS OF OKLAHOMA,0,1,1998,Inf,0,279,159,120,48,19,29,0.18,0.16,0.17,1740,11,55,231
207722,UNIVERSITY OF SCIENCE AND ARTS OF OKLAHOMA,0,1,1999,Inf,0,229,133,96,32,12,20,0.15,0.12,0.14,1470,11,55,179
207722,UNIVERSITY OF SCIENCE AND ARTS OF OKLAHOMA,0,1,2000,Inf,0,206,135,71,29,6,23,0.17,0.08,0.14,1176,12,53,149
207722,UNIVERSITY OF SCIENCE AND ARTS OF OKLAHOMA,0,1,2001,Inf,0,261,138,123,26,11,15,0.1,0.09,0.1,1699,12,52,203
207722,UNIVERSITY OF SCIENCE AND ARTS OF OKLAHOMA,0,1,2002,Inf,0,280,186,94,44,11,33,0.17,0.12,0.16,1699,13,54,216
207722,UNIVERSITY OF SCIENCE AND ARTS OF OKLAHOMA,0,1,2003,Inf,0,282,172,110,54,11,43,0.25,0.1,0.19,1680,13,49,216
207722,UNIVERSITY OF SCIENCE AND ARTS OF OKLAHOMA,0,1,2004,Inf,0,244,148,96,45,13,32,0.21,0.14,0.18,1824,13,49,187
207722,University of Science and Arts of Oklahoma,0,1,2005,Inf,0,233,122,111,61,30,31,0.25,0.27,0.26,1992,14,51,182
207722,University of Science and Arts of Oklahoma,0,1,2006,Inf,0,208,139,69,58,16,42,0.3,0.23,0.28,2112,15,56,156
207722,University of Science and Arts of Oklahoma,0,1,2007,Inf,0,198,123,75,51,13,38,0.3,0.17,0.26,2304,17,58,150
207722,University of Science and Arts of Oklahoma,0,1,2008,Inf,0,203,126,77,88,28,60,0.47000000000000003,0.36,0.43,2616,17,56,142
207722,University of Science and Arts of Oklahoma,0,1,2009,Inf,0,166,113,53,49,12,37,0.32,0.23,0.3,2616,18,58,121
207722,University of Science and Arts of Oklahoma,0,1,2010,Inf,0,199,129,70,54,13,41,0.31,0.19,0.27,2808,19,57,143
207847,SOUTHEASTERN OKLAHOMA STATE UNIVERSITY,1,0,1991,NA,NA,537,291,246,55,21,34,0.11,0.09,0.1,1340,26,146,323
207847,SOUTHEASTERN OKLAHOMA STATE UNIVERSITY,1,0,1992,NA,NA,503,287,216,60,19,41,0.14,0.09,0.12,1350,28,151,298
207847,SOUTHEASTERN OKLAHOMA STATE UNIVERSITY,1,0,1993,NA,NA,541,295,246,77,31,46,0.15,0.13,0.14,1494,29,148,336
207847,SOUTHEASTERN OKLAHOMA STATE UNIVERSITY,1,0,1995,NA,NA,570,282,288,91,48,43,0.15,0.17,0.16,1665,30,148,347
207847,SOUTHEASTERN OKLAHOMA STATE UNIVERSITY,1,0,1996,NA,NA,579,266,313,78,41,37,0.13,0.13,0.13,1687,30,147,361
207847,SOUTHEASTERN OKLAHOMA STATE UNIVERSITY,1,0,1997,NA,NA,578,314,264,89,33,56,0.17,0.12,0.15,1879,31,148,339
207847,SOUTHEASTERN OKLAHOMA STATE UNIVERSITY,1,0,1998,NA,NA,499,260,239,59,21,38,0.14,0.09,0.12,1889,32,155,316
207847,SOUTHEASTERN OKLAHOMA STATE UNIVERSITY,1,0,1999,NA,NA,572,307,265,67,26,41,0.13,0.1,0.12,1485,34,149,316
207847,SOUTHEASTERN OKLAHOMA STATE UNIVERSITY,1,0,2000,NA,NA,509,261,248,54,21,33,0.12,0.08,0.11,1372,34,145,307
207847,SOUTHEASTERN OKLAHOMA STATE UNIVERSITY,1,0,2001,NA,NA,579,266,313,75,40,35,0.13,0.13,0.13,1467,39,142,361
207847,SOUTHEASTERN OKLAHOMA STATE UNIVERSITY,1,0,2002,NA,NA,577,287,290,64,29,35,0.12,0.1,0.11,1569,39,145,392
207847,SOUTHEASTERN OKLAHOMA STATE UNIVERSITY,1,0,2003,NA,NA,651,339,312,70,27,43,0.12,0.09,0.11,1950,39,139,395
207847,SOUTHEASTERN OKLAHOMA STATE UNIVERSITY,1,0,2004,NA,NA,609,310,299,59,29,30,0.09,0.1,0.1,2126,42,134,360
207847,Southeastern Oklahoma State University,1,0,2005,NA,NA,587,298,289,62,22,40,0.13,0.08,0.11,2195,42,135,352
207847,Southeastern Oklahoma State University,1,0,2006,NA,NA,586,313,273,67,26,41,0.13,0.1,0.11,2897,47,140,337
207847,Southeastern Oklahoma State University,1,0,2007,NA,NA,631,326,305,82,33,49,0.15,0.11,0.13,3249,51,141,376
207847,Southeastern Oklahoma State University,1,0,2008,NA,NA,583,296,287,68,29,39,0.13,0.1,0.12,3639,51,141,321
207847,Southeastern Oklahoma State University,1,0,2009,NA,NA,639,313,326,84,38,46,0.14,0.12,0.13,3639,53,142,355
207847,Southeastern Oklahoma State University,1,0,2010,NA,NA,651,344,307,55,20,35,0.1,0.07,0.08,3875,54,141,350
207865,SOUTHWESTERN OKLAHOMA STATE UNIVERSITY,1,0,1991,NA,NA,867,502,365,70,24,46,0.09,0.07,0.08,1295,29,221,767
207865,SOUTHWESTERN OKLAHOMA STATE UNIVERSITY,1,0,1992,NA,NA,945,534,411,79,21,58,0.1,0.05,0.08,1310,31,222,855
207865,SOUTHWESTERN OKLAHOMA STATE UNIVERSITY,1,0,1993,NA,NA,791,409,382,68,19,49,0.11,0.05,0.09,1392,30,214,704
207865,SOUTHWESTERN OKLAHOMA STATE UNIVERSITY,1,0,1995,NA,NA,769,470,299,123,34,89,0.18,0.11,0.16,1599,35,215,671
207865,SOUTHWESTERN OKLAHOMA STATE UNIVERSITY,1,0,1996,NA,NA,737,386,351,92,34,58,0.15,0.1,0.12,1599,34,210,671
207865,SOUTHWESTERN OKLAHOMA STATE UNIVERSITY,1,0,1997,NA,NA,717,386,331,107,28,79,0.2,0.08,0.15,1798,36,206,632
207865,SOUTHWESTERN OKLAHOMA STATE UNIVERSITY,1,0,1998,NA,NA,866,453,413,136,38,98,0.21,0.09,0.16,1798,38,198,752
207865,SOUTHWESTERN OKLAHOMA STATE UNIVERSITY,1,0,1999,NA,NA,779,448,331,116,35,81,0.18,0.11,0.15,1485,41,200,681
207865,SOUTHWESTERN OKLAHOMA STATE UNIVERSITY,1,0,2000,NA,NA,815,464,351,135,27,108,0.23,0.08,0.17,1485,42,198,688
207865,SOUTHWESTERN OKLAHOMA STATE UNIVERSITY,1,0,2001,NA,NA,853,481,372,128,45,83,0.17,0.12,0.15,1589,44,196,708
207865,SOUTHWESTERN OKLAHOMA STATE UNIVERSITY,1,0,2002,NA,NA,926,486,440,121,46,75,0.15,0.1,0.13,1700,45,200,771
207865,SOUTHWESTERN OKLAHOMA STATE UNIVERSITY,1,0,2003,NA,NA,980,492,488,119,38,81,0.16,0.08,0.12,1950,45,194,758
207865,SOUTHWESTERN OKLAHOMA STATE UNIVERSITY,1,0,2004,NA,NA,941,493,448,130,41,89,0.18,0.09,0.14,2100,46,193,744
207865,Southwestern Oklahoma State University,1,0,2005,NA,NA,766,403,363,127,43,84,0.2,0.12,0.17,2490,49,197,592
207865,Southwestern Oklahoma State University,1,0,2006,NA,NA,844,485,359,129,31,98,0.2,0.09,0.15,2700,51,194,640
207865,Southwestern Oklahoma State University,1,0,2007,NA,NA,896,552,344,116,32,84,0.15,0.09,0.13,3000,54,195,690
207865,Southwestern Oklahoma State University,1,0,2008,NA,NA,920,511,409,124,41,83,0.16,0.1,0.13,3360,57,198,724
207865,Southwestern Oklahoma State University,1,0,2009,NA,NA,900,481,419,105,30,75,0.15,0.07,0.12,3360,61,211,662
207865,Southwestern Oklahoma State University,1,0,2010,NA,NA,977,529,448,123,44,79,0.14,0.1,0.13,3405,65,215,697
208822,GEORGE FOX COLLEGE,1,0,1991,NA,NA,258,154,104,91,33,58,0.37,0.32,0.35,9114,12,59,239
208822,GEORGE FOX COLLEGE,1,0,1992,NA,NA,282,176,106,134,52,82,0.46,0.49,0.48,10040,14,68,264
208822,GEORGE FOX COLLEGE,1,0,1993,NA,NA,343,198,145,159,62,97,0.48,0.43,0.46,11740,18,77,313
208822,GEORGE FOX UNIVERSITY,1,0,1995,NA,NA,347,232,115,162,54,108,0.46,0.47,0.47,13690,25,92,312
208822,GEORGE FOX UNIVERSITY,1,0,1996,NA,NA,386,250,136,200,71,129,0.51,0.52,0.52,14520,28,105,356
208822,GEORGE FOX UNIVERSITY,1,0,1997,NA,NA,345,225,120,212,70,142,0.63,0.58,0.61,15520,25,108,277
208822,GEORGE FOX UNIVERSITY,1,0,1998,NA,NA,361,240,121,208,73,135,0.56,0.6,0.58,15950,27,116,223
208822,GEORGE FOX UNIVERSITY,1,0,1999,NA,NA,282,163,119,145,48,97,0.59,0.4,0.51,16600,29,121,265
208822,GEORGE FOX UNIVERSITY,1,0,2000,NA,NA,352,205,147,209,81,128,0.62,0.55,0.59,17300,32,115,295
208822,GEORGE FOX UNIVERSITY,1,0,2001,NA,NA,301,180,121,172,64,108,0.6,0.53,0.57,18000,34,110,268
208822,GEORGE FOX UNIVERSITY,1,0,2002,NA,NA,319,204,115,171,60,111,0.54,0.52,0.54,18575,35,127,286
208822,GEORGE FOX UNIVERSITY,1,0,2003,NA,NA,336,203,133,177,73,104,0.51,0.55,0.53,19500,37,135,293
208822,GEORGE FOX UNIVERSITY,1,0,2004,NA,NA,397,259,138,235,79,156,0.6,0.57,0.59,20280,41,133,339
208822,George Fox University,1,0,2005,NA,NA,460,287,173,241,86,155,0.54,0.5,0.52,21400,44,144,379
208822,George Fox University,1,0,2006,NA,NA,415,262,153,223,81,142,0.54,0.53,0.54,22250,48,156,325
208822,George Fox University,1,0,2007,NA,NA,435,279,156,225,61,164,0.58,0.39,0.52,23470,53,167,338
208822,George Fox University,1,0,2008,NA,NA,401,245,156,204,74,130,0.53,0.47,0.51,24870,56,156,291
208822,George Fox University,1,0,2009,NA,NA,411,239,172,249,102,147,0.61,0.59,0.61,25860,56,168,329
208822,George Fox University,1,0,2010,NA,NA,488,287,201,275,119,156,0.54,0.59,0.56,27640,59,170,342
209056,LEWIS AND CLARK COLLEGE,0,1,1991,1995,0,357,213,144,191,72,119,0.55,0.5,0.54,13470,46,175,309
209056,LEWIS AND CLARK COLLEGE,0,1,1992,1995,0,395,235,160,221,78,143,0.6,0.49,0.56,14265,48,182,341
209056,LEWIS AND CLARK COLLEGE,0,1,1993,1995,0,469,274,195,259,113,146,0.53,0.58,0.55,15051,50,174,396
209056,LEWIS AND CLARK COLLEGE,1,0,1995,1995,1,455,280,175,228,85,143,0.51,0.49,0.5,16820,58,177,333
209056,LEWIS AND CLARK COLLEGE,1,0,1996,1995,1,443,262,181,249,91,158,0.6,0.5,0.56,17740,62,179,318
209056,LEWIS AND CLARK COLLEGE,1,0,1997,1995,1,463,272,191,289,121,168,0.61,0.63,0.62,18530,48,181,298
209056,LEWIS AND CLARK COLLEGE,1,0,1998,1995,1,424,253,171,249,94,155,0.61,0.55,0.59,19356,55,179,295
209056,LEWIS AND CLARK COLLEGE,1,0,1999,1995,1,510,307,203,330,127,203,0.66,0.63,0.65,20136,59,190,325
209056,LEWIS AND CLARK COLLEGE,1,0,2000,1995,1,426,263,163,251,91,160,0.6,0.56,0.59,21330,62,193,291
209056,LEWIS & CLARK COLLEGE,1,0,2001,1995,1,415,240,175,277,109,168,0.7000000000000001,0.62,0.67,22410,67,196,283
209056,LEWIS & CLARK COLLEGE,1,0,2002,1995,1,503,309,194,339,123,216,0.6900000000000001,0.63,0.67,23530,72,213,303
209056,LEWIS & CLARK COLLEGE,1,0,2003,1995,1,493,308,185,352,127,225,0.73,0.69,0.71,24486,75,202,351
209056,LEWIS & CLARK COLLEGE,1,0,2004,1995,1,537,329,208,366,143,223,0.67,0.69,0.68,25938,81,212,364
209056,Lewis & Clark College,1,0,2005,1995,1,490,294,196,324,125,199,0.67,0.64,0.66,27494,87,205,339
209056,Lewis & Clark College,1,0,2006,1995,1,508,318,190,349,129,220,0.6900000000000001,0.68,0.69,29556,92,214,307
209056,Lewis & Clark College,1,0,2007,1995,1,506,322,184,338,108,230,0.71,0.59,0.67,31624,97,221,312
209056,Lewis & Clark College,1,0,2008,1995,1,534,323,211,381,135,246,0.76,0.64,0.71,33490,103,222,295
209056,Lewis & Clark College,1,0,2009,1995,1,494,298,196,327,122,205,0.68,0.62,0.66,34995,109,231,266
209056,Lewis & Clark College,1,0,2010,1995,1,491,306,185,364,125,239,0.78,0.68,0.74,36394,107,230,311
209065,LINFIELD COLLEGE,1,0,1991,NA,NA,429,242,187,234,89,145,0.59,0.48,0.55,11150,25,122,371
209065,LINFIELD COLLEGE,1,0,1992,NA,NA,428,265,163,234,68,166,0.62,0.42,0.55,11870,30,126,380
209065,LINFIELD COLLEGE,1,0,1993,NA,NA,436,235,201,254,110,144,0.61,0.55,0.58,12700,33,129,382
209065,LINFIELD COLLEGE,1,0,1995,NA,NA,438,260,178,276,105,171,0.65,0.59,0.63,14300,37,128,377
209065,LINFIELD COLLEGE,1,0,1996,NA,NA,445,238,207,272,109,163,0.68,0.53,0.61,15096,39,129,393
209065,LINFIELD COLLEGE,1,0,1997,NA,NA,410,235,175,244,91,153,0.65,0.52,0.6,15994,30,134,352
209065,LINFIELD COLLEGE,1,0,1998,NA,NA,415,232,183,238,81,157,0.67,0.44,0.57,16960,32,125,356
209065,LINFIELD COLLEGE,1,0,1999,NA,NA,397,227,170,227,74,153,0.67,0.44,0.57,17590,35,94,314
209065,LINFIELD COLLEGE,1,0,2000,NA,NA,434,228,206,281,113,168,0.73,0.55,0.65,18450,29,95,338
209065,LINFIELD COLLEGE,1,0,2001,NA,NA,422,232,190,250,89,161,0.6900000000000001,0.47,0.59,19380,32,96,363
209065,LINFIELD COLLEGE,1,0,2002,NA,NA,425,245,180,258,92,166,0.67,0.51,0.61,20160,33,100,361
209065,LINFIELD COLLEGE,1,0,2003,NA,NA,448,243,205,286,101,185,0.76,0.49,0.64,20770,34,104,372
209065,LINFIELD COLLEGE,1,0,2004,NA,NA,432,222,210,249,106,143,0.64,0.5,0.58,21800,36,103,333
209065,Linfield College,1,0,2005,NA,NA,481,260,221,293,113,180,0.6900000000000001,0.51,0.61,22790,46,105,399
209065,Linfield College,1,0,2006,NA,NA,445,243,202,265,104,161,0.66,0.51,0.6,23930,49,103,346
209065,Linfield College,1,0,2007,NA,NA,476,276,200,281,96,185,0.67,0.48,0.59,25390,52,107,310
209065,Linfield College,1,0,2008,NA,NA,474,274,200,290,106,184,0.67,0.53,0.61,27150,54,108,314
209065,Linfield College,1,0,2009,NA,NA,420,252,168,226,76,150,0.59,0.45,0.54,28760,55,107,294
209065,Linfield College,1,0,2010,NA,NA,528,310,218,302,117,185,0.59,0.54,0.57,30300,57,110,369
209542,OREGON STATE UNIVERSITY,0,1,1991,Inf,0,1543,696,847,403,184,219,0.31,0.22,0.26,2505,290,618,1224
209542,OREGON STATE UNIVERSITY,0,1,1992,Inf,0,1703,771,932,442,179,263,0.34,0.19,0.26,2691,302,607,1385
209542,OREGON STATE UNIVERSITY,0,1,1993,Inf,0,1625,705,920,395,169,226,0.32,0.18,0.24,2877,319,622,1269
209542,OREGON STATE UNIVERSITY,0,1,1995,Inf,0,2018,965,1053,561,194,367,0.38,0.18,0.28,3312,342,603,1615
209542,OREGON STATE UNIVERSITY,0,1,1996,Inf,0,1833,883,950,492,181,311,0.35000000000000003,0.19,0.27,3447,366,597,1450
209542,OREGON STATE UNIVERSITY,0,1,1997,Inf,0,1869,860,1009,525,212,313,0.36,0.21,0.28,3510,375,592,1516
209542,OREGON STATE UNIVERSITY,0,1,1998,Inf,0,2229,1105,1124,615,210,405,0.36,0.19,0.28,3549,370,601,1756
209542,OREGON STATE UNIVERSITY,0,1,1999,Inf,0,2772,1319,1453,847,333,514,0.38,0.23,0.31,3561,392,594,2188
209542,OREGON STATE UNIVERSITY,0,1,2000,Inf,0,2652,1250,1402,770,311,459,0.36,0.22,0.29,2694,425,613,2080
209542,OREGON STATE UNIVERSITY,0,1,2001,Inf,0,2982,1467,1515,885,356,529,0.36,0.23,0.3,2802,457,633,2374
209542,OREGON STATE UNIVERSITY,0,1,2002,Inf,0,2864,1437,1427,906,319,587,0.4,0.22,0.32,2886,500,639,2249
209542,OREGON STATE UNIVERSITY,0,1,2003,Inf,0,2862,1371,1491,811,321,490,0.35000000000000003,0.22,0.28,3642,494,591,2228
209542,OREGON STATE UNIVERSITY,0,1,2004,Inf,0,2803,1367,1436,860,320,540,0.39,0.22,0.31,4113,510,634,2199
209542,Oregon State University,0,1,2005,Inf,0,2817,1385,1432,819,306,513,0.37,0.21,0.29,4176,558,676,2120
209542,Oregon State University,0,1,2006,Inf,0,2898,1413,1485,872,341,531,0.37,0.23,0.3,4320,609,685,2085
209542,Oregon State University,0,1,2007,Inf,0,2974,1436,1538,879,333,546,0.38,0.22,0.3,4464,625,689,2072
209542,Oregon State University,0,1,2008,Inf,0,3006,1422,1584,922,373,549,0.38,0.24,0.31,4608,650,699,2058
209542,Oregon State University,0,1,2009,Inf,0,3314,1620,1694,1072,400,672,0.41000000000000003,0.24,0.32,5436,704,713,2330
209542,Oregon State University,0,1,2010,Inf,0,3480,1677,1803,1145,447,698,0.41000000000000003,0.25,0.33,5760,698,738,2467
209551,UNIVERSITY OF OREGON,0,1,1991,Inf,0,1919,1068,851,683,238,445,0.41000000000000003,0.28,0.36,2598,205,657,1540
209551,UNIVERSITY OF OREGON,0,1,1992,Inf,0,2279,1179,1100,808,315,493,0.41000000000000003,0.29,0.35,2721,218,643,1724
209551,UNIVERSITY OF OREGON,0,1,1993,Inf,0,2513,1422,1091,951,346,605,0.42,0.32,0.38,2916,231,671,1978
209551,UNIVERSITY OF OREGON,0,1,1995,Inf,0,2583,1429,1154,950,329,621,0.43,0.29,0.37,3381,259,680,2012
209551,UNIVERSITY OF OREGON,0,1,1996,Inf,0,2580,1444,1136,958,349,609,0.42,0.31,0.37,3540,274,620,2001
209551,UNIVERSITY OF OREGON,0,1,1997,Inf,0,2384,1307,1077,856,314,542,0.41000000000000003,0.29,0.36,3648,294,686,1835
209551,UNIVERSITY OF OREGON,0,1,1998,Inf,0,2304,1289,1015,839,280,559,0.43,0.28,0.36,3771,293,636,1720
209551,UNIVERSITY OF OREGON,0,1,1999,Inf,0,2453,1393,1060,931,314,617,0.44,0.3,0.38,2694,306,668,1844
209551,UNIVERSITY OF OREGON,0,1,2000,Inf,0,2809,1527,1282,1089,384,705,0.46,0.3,0.39,2694,326,665,2171
209551,UNIVERSITY OF OREGON,0,1,2001,Inf,0,3049,1687,1362,1244,464,780,0.46,0.34,0.41,2802,345,662,2386
209551,UNIVERSITY OF OREGON,0,1,2002,Inf,0,3272,1834,1438,1353,500,853,0.46,0.35,0.41,2907,389,704,2565
209551,UNIVERSITY OF OREGON,0,1,2003,Inf,0,2826,1594,1232,1300,519,781,0.49,0.42,0.46,3543,404,706,2158
209551,UNIVERSITY OF OREGON,0,1,2004,Inf,0,3138,1734,1404,1377,539,838,0.48,0.38,0.44,4077,430,703,2466
209551,University of Oregon,0,1,2005,Inf,0,3138,1721,1417,1282,506,776,0.45,0.36,0.41,4164,437,734,2457
209551,University of Oregon,0,1,2006,Inf,0,3349,1821,1528,1468,575,893,0.49,0.38,0.44,4341,489,713,2555
209551,University of Oregon,0,1,2007,Inf,0,3505,1839,1666,1528,629,899,0.48,0.38,0.44,4494,513,750,2622
209551,University of Oregon,0,1,2008,Inf,0,4191,2129,2062,1903,824,1079,0.5,0.4,0.45,5202,557,761,3198
209551,University of Oregon,0,1,2009,Inf,0,3788,2027,1761,1900,778,1122,0.55,0.44,0.5,6180,610,782,2814
209551,University of Oregon,0,1,2010,Inf,0,3911,2065,1846,1953,790,1163,0.56,0.43,0.5,6930,651,836,2808
209612,PACIFIC UNIVERSITY,1,0,1991,NA,NA,261,154,107,93,38,55,0.35000000000000003,0.36,0.36,11200,23,101,220
209612,PACIFIC UNIVERSITY,1,0,1992,NA,NA,226,142,84,103,39,64,0.45,0.46,0.46,12320,25,101,170
209612,PACIFIC UNIVERSITY,1,0,1993,NA,NA,280,164,116,126,47,79,0.48,0.41,0.45,13470,28,108,195
209612,PACIFIC UNIVERSITY,1,0,1995,NA,NA,242,153,89,108,33,75,0.49,0.37,0.45,14920,32,123,182
209612,PACIFIC UNIVERSITY,1,0,1996,NA,NA,268,179,89,117,36,81,0.45,0.4,0.44,15654,34,131,200
209612,PACIFIC UNIVERSITY,1,0,1997,NA,NA,261,175,86,129,39,90,0.51,0.45,0.49,16220,30,126,208
209612,PACIFIC UNIVERSITY,1,0,1998,NA,NA,246,157,89,133,39,94,0.59,0.44,0.54,16694,31,139,175
209612,PACIFIC UNIVERSITY,1,0,1999,NA,NA,292,175,117,164,70,94,0.53,0.6,0.56,16800,32,163,190
209612,PACIFIC UNIVERSITY,1,0,2000,NA,NA,303,198,105,158,58,100,0.5,0.55,0.52,17305,37,157,229
209612,PACIFIC UNIVERSITY,1,0,2001,NA,NA,310,206,104,171,47,124,0.6,0.45,0.55,18000,41,151,224
209612,PACIFIC UNIVERSITY,1,0,2002,NA,NA,275,166,109,171,64,107,0.64,0.59,0.62,18766,42,179,201
209612,PACIFIC UNIVERSITY,1,0,2003,NA,NA,303,174,129,158,58,100,0.5700000000000001,0.45,0.52,19330,42,174,212
209612,PACIFIC UNIVERSITY,1,0,2004,NA,NA,294,181,113,164,62,102,0.56,0.55,0.56,20104,44,173,184
209612,Pacific University,1,0,2005,NA,NA,324,204,120,165,52,113,0.55,0.43,0.51,20908,46,175,223
209612,Pacific University,1,0,2006,NA,NA,360,206,154,194,72,122,0.59,0.47,0.54,21954,54,196,202
209612,Pacific University,1,0,2007,NA,NA,372,242,130,194,59,135,0.55,0.45,0.52,25830,58,201,233
209612,Pacific University,1,0,2008,NA,NA,345,227,118,174,60,114,0.5,0.51,0.5,27604,68,205,207
209612,Pacific University,1,0,2009,NA,NA,333,204,129,213,82,131,0.64,0.64,0.64,29290,77,208,199
209612,Pacific University,1,0,2010,NA,NA,474,231,243,229,109,120,0.51,0.45,0.48,30990,78,216,259
209807,PORTLAND STATE UNIVERSITY,0,1,1991,Inf,0,670,330,340,86,34,52,0.15,0.1,0.13,2538,99,423,411
209807,PORTLAND STATE UNIVERSITY,0,1,1992,Inf,0,651,343,308,94,42,52,0.15,0.14,0.14,2658,106,441,417
209807,PORTLAND STATE UNIVERSITY,0,1,1993,Inf,0,684,330,354,74,31,43,0.13,0.09,0.11,2826,112,411,430
209807,PORTLAND STATE UNIVERSITY,0,1,1995,Inf,0,682,358,324,82,29,53,0.14,0.09,0.12,3183,127,450,463
209807,PORTLAND STATE UNIVERSITY,0,1,1996,Inf,0,726,351,375,97,34,63,0.17,0.09,0.13,3342,135,473,436
209807,PORTLAND STATE UNIVERSITY,0,1,1997,Inf,0,743,368,375,96,37,59,0.16,0.1,0.13,3357,143,468,481
209807,PORTLAND STATE UNIVERSITY,0,1,1998,Inf,0,800,419,381,101,28,73,0.17,0.07,0.13,3438,152,469,511
209807,PORTLAND STATE UNIVERSITY,0,1,1999,Inf,0,896,496,400,118,39,79,0.15,0.1,0.13,2694,163,462,581
209807,PORTLAND STATE UNIVERSITY,0,1,2000,Inf,0,915,480,435,133,50,83,0.17,0.11,0.15,2694,185,509,564
209807,PORTLAND STATE UNIVERSITY,0,1,2001,Inf,0,1020,548,472,129,42,87,0.15,0.09,0.13,2808,196,557,622
209807,PORTLAND STATE UNIVERSITY,0,1,2002,Inf,0,1177,632,545,153,43,110,0.17,0.08,0.13,2892,215,581,787
209807,PORTLAND STATE UNIVERSITY,0,1,2003,Inf,0,1264,668,596,159,55,104,0.15,0.09,0.13,3240,226,518,799
209807,PORTLAND STATE UNIVERSITY,0,1,2004,Inf,0,1173,627,546,167,51,116,0.18,0.09,0.14,3690,242,551,778
209807,Portland State University,0,1,2005,Inf,0,1200,636,564,172,66,106,0.16,0.12,0.14,3810,263,583,734
209807,Portland State University,0,1,2006,Inf,0,1283,695,588,200,67,133,0.19,0.11,0.16,3930,294,627,828
209807,Portland State University,0,1,2007,Inf,0,1427,759,668,252,93,159,0.2,0.14,0.18,4314,305,644,904
209807,Portland State University,0,1,2008,Inf,0,1567,839,728,264,105,159,0.18,0.14,0.17,4905,336,687,982
209807,Portland State University,0,1,2009,Inf,0,1551,800,751,296,109,187,0.23,0.15,0.19,5321,385,680,957
209807,Portland State University,0,1,2010,Inf,0,1366,733,633,288,123,165,0.22,0.19,0.21,5648,397,711,783
209922,REED COLLEGE,1,0,1991,NA,NA,292,146,146,139,71,68,0.46,0.49,0.48,16700,23,113,226
209922,REED COLLEGE,1,0,1992,NA,NA,310,173,137,148,58,90,0.52,0.42,0.48,18190,29,109,218
209922,REED COLLEGE,1,0,1993,NA,NA,328,171,157,148,80,68,0.39,0.51,0.45,19250,28,96,251
209922,REED COLLEGE,1,0,1995,NA,NA,352,188,164,166,78,88,0.46,0.48,0.47,20760,32,111,249
209922,REED COLLEGE,1,0,1996,NA,NA,357,200,157,159,59,100,0.5,0.38,0.45,21490,41,108,252
209922,REED COLLEGE,1,0,1997,NA,NA,315,176,139,146,59,87,0.49,0.42,0.46,22340,34,104,212
209922,REED COLLEGE,1,0,1998,NA,NA,338,164,174,165,86,79,0.48,0.49,0.49,23120,39,111,220
209922,REED COLLEGE,1,0,1999,NA,NA,331,182,149,172,78,94,0.51,0.52,0.52,23880,39,111,254
209922,REED COLLEGE,1,0,2000,NA,NA,358,202,156,204,79,125,0.61,0.51,0.57,24820,47,116,234
209922,REED COLLEGE,1,0,2001,NA,NA,349,198,151,203,84,119,0.6,0.56,0.58,26060,46,122,229
209922,REED COLLEGE,1,0,2002,NA,NA,307,160,147,182,79,103,0.64,0.54,0.59,27360,55,122,207
209922,REED COLLEGE,1,0,2003,NA,NA,297,153,144,169,74,95,0.62,0.51,0.57,29000,61,137,195
209922,REED COLLEGE,1,0,2004,NA,NA,333,186,147,199,78,121,0.65,0.53,0.6,30670,59,122,192
209922,Reed College,1,0,2005,NA,NA,348,197,151,204,80,124,0.62,0.53,0.59,32360,61,135,222
209922,Reed College,1,0,2006,NA,NA,371,207,164,222,91,131,0.63,0.55,0.6,34300,58,140,229
209922,Reed College,1,0,2007,NA,NA,337,187,150,236,99,137,0.73,0.66,0.7,36190,65,149,189
209922,Reed College,1,0,2008,NA,NA,329,194,135,219,88,131,0.67,0.65,0.67,37960,69,155,164
209922,Reed College,1,0,2009,NA,NA,367,192,175,253,122,131,0.68,0.7,0.69,39440,71,145,193
209922,Reed College,1,0,2010,NA,NA,373,212,161,247,105,142,0.66,0.65,0.66,40940,72,141,246
210146,SOUTHERN OREGON STATE COLLEGE,0,1,1991,Inf,0,553,303,250,66,26,40,0.13,0.1,0.12,2415,40,176,491
210146,SOUTHERN OREGON STATE COLLEGE,0,1,1992,Inf,0,588,301,287,63,24,39,0.12,0.08,0.11,2487,41,171,510
210146,SOUTHERN OREGON STATE COLLEGE,0,1,1993,Inf,0,601,324,277,75,19,56,0.17,0.07,0.12,2667,44,161,523
210146,SOUTHERN OREGON STATE COLLEGE,0,1,1995,Inf,0,661,362,299,89,33,56,0.15,0.11,0.13,2949,45,164,554
210146,SOUTHERN OREGON STATE COLLEGE,0,1,1996,Inf,0,701,388,313,111,48,63,0.16,0.15,0.16,3147,50,182,605
210146,SOUTHERN OREGON UNIVERSITY,0,1,1997,Inf,0,759,426,333,142,47,95,0.22,0.14,0.19,3204,50,170,631
210146,SOUTHERN OREGON UNIVERSITY,0,1,1998,Inf,0,670,403,267,124,40,84,0.2,0.15,0.19,3198,52,165,554
210146,SOUTHERN OREGON UNIVERSITY,0,1,1999,Inf,0,754,431,323,136,46,90,0.2,0.14,0.18,2520,57,175,611
210146,SOUTHERN OREGON UNIVERSITY,0,1,2000,Inf,0,681,390,291,130,45,85,0.21,0.15,0.19,2520,61,182,565
210146,SOUTHERN OREGON UNIVERSITY,0,1,2001,Inf,0,759,436,323,149,47,102,0.23,0.15,0.2,2628,64,190,618
210146,SOUTHERN OREGON UNIVERSITY,0,1,2002,Inf,0,787,412,375,166,56,110,0.26,0.15,0.21,2706,65,190,646
210146,SOUTHERN OREGON UNIVERSITY,0,1,2003,Inf,0,896,497,399,158,51,107,0.21,0.13,0.18,3138,64,182,734
210146,SOUTHERN OREGON UNIVERSITY,0,1,2004,Inf,0,744,409,335,100,30,70,0.17,0.09,0.13,3609,70,185,599
210146,Southern Oregon University,0,1,2005,Inf,0,707,417,290,110,30,80,0.19,0.1,0.16,3720,67,190,598
210146,Southern Oregon University,0,1,2006,Inf,0,707,401,306,110,31,79,0.19,0.1,0.16,3831,73,194,568
210146,Southern Oregon University,0,1,2007,Inf,0,703,405,298,127,37,90,0.22,0.12,0.18,3960,76,185,571
210146,Southern Oregon University,0,1,2008,Inf,0,675,407,268,147,46,101,0.24,0.17,0.22,4326,79,185,517
210146,Southern Oregon University,0,1,2009,Inf,0,652,378,274,131,37,94,0.24,0.14,0.2,4788,83,196,516
210146,Southern Oregon University,0,1,2010,Inf,0,735,435,300,176,55,121,0.27,0.18,0.24,4914,82,196,557
210401,WILLAMETTE UNIVERSITY,1,0,1991,NA,NA,390,221,169,253,99,154,0.6900000000000001,0.59,0.65,12480,36,145,304
210401,WILLAMETTE UNIVERSITY,1,0,1992,NA,NA,385,231,154,256,103,153,0.66,0.67,0.66,13030,39,154,308
210401,WILLAMETTE UNIVERSITY,1,0,1993,NA,NA,381,218,163,249,101,148,0.67,0.62,0.65,13665,43,145,297
210401,WILLAMETTE UNIVERSITY,1,0,1995,NA,NA,432,248,184,330,132,198,0.79,0.72,0.76,16400,50,164,349
210401,WILLAMETTE UNIVERSITY,1,0,1996,NA,NA,419,241,178,304,115,189,0.78,0.65,0.73,18300,51,153,321
210401,WILLAMETTE UNIVERSITY,1,0,1997,NA,NA,410,224,186,299,131,168,0.75,0.7,0.73,20200,44,168,295
210401,WILLAMETTE UNIVERSITY,1,0,1998,NA,NA,406,236,170,263,105,158,0.66,0.62,0.65,21000,46,170,293
210401,WILLAMETTE UNIVERSITY,1,0,1999,NA,NA,363,190,173,242,100,142,0.74,0.58,0.67,21700,47,172,224
210401,WILLAMETTE UNIVERSITY,1,0,2000,NA,NA,506,292,214,336,124,212,0.72,0.58,0.66,22700,49,165,312
210401,WILLAMETTE UNIVERSITY,1,0,2001,NA,NA,476,261,215,345,143,202,0.77,0.67,0.72,23150,54,158,328
210401,WILLAMETTE UNIVERSITY,1,0,2002,NA,NA,353,181,172,210,92,118,0.65,0.53,0.59,24050,58,176,207
210401,WILLAMETTE UNIVERSITY,1,0,2003,NA,NA,541,312,229,383,143,240,0.76,0.62,0.71,25300,58,185,330
210401,WILLAMETTE UNIVERSITY,1,0,2004,NA,NA,510,284,226,361,155,206,0.72,0.69,0.71,26690,63,193,315
210401,Willamette University,1,0,2005,NA,NA,440,240,200,307,130,177,0.73,0.65,0.7,28250,66,210,270
210401,Willamette University,1,0,2006,NA,NA,482,260,222,333,139,194,0.74,0.63,0.69,29850,70,215,286
210401,Willamette University,1,0,2007,NA,NA,444,238,206,315,130,185,0.77,0.63,0.71,31760,76,200,271
210401,Willamette University,1,0,2008,NA,NA,482,278,204,333,129,204,0.73,0.63,0.69,33750,81,203,307
210401,Willamette University,1,0,2009,NA,NA,541,294,247,384,165,219,0.74,0.67,0.71,35400,85,214,358
210401,Willamette University,1,0,2010,NA,NA,427,235,192,301,119,182,0.77,0.62,0.7,37150,88,226,300
210429,WESTERN OREGON STATE COLLEGE,0,1,1991,Inf,0,576,367,209,98,22,76,0.2,0.11,0.17,2406,37,146,519
210429,WESTERN OREGON STATE COLLEGE,0,1,1992,Inf,0,626,394,232,112,36,76,0.19,0.16,0.18,2481,38,155,569
210429,WESTERN OREGON STATE COLLEGE,0,1,1993,Inf,0,675,404,271,133,31,102,0.25,0.11,0.2,2637,41,155,599
210429,WESTERN OREGON STATE COLLEGE,0,1,1995,Inf,0,641,380,261,95,22,73,0.19,0.08,0.15,2985,43,148,563
210429,WESTERN OREGON STATE COLLEGE,0,1,1996,Inf,0,742,448,294,107,33,74,0.16,0.11,0.14,3099,45,160,640
210429,WESTERN OREGON UNIVERSITY,0,1,1997,Inf,0,759,481,278,103,35,68,0.14,0.13,0.14,3153,46,161,645
210429,WESTERN OREGON UNIVERSITY,0,1,1998,Inf,0,700,425,275,116,26,90,0.21,0.09,0.17,3198,47,158,609
210429,WESTERN OREGON UNIVERSITY,0,1,1999,Inf,0,770,460,310,141,45,96,0.2,0.15,0.18,2520,49,159,664
210429,WESTERN OREGON UNIVERSITY,0,1,2000,Inf,0,825,524,301,176,55,121,0.23,0.18,0.21,2520,53,158,692
210429,WESTERN OREGON UNIVERSITY,0,1,2001,Inf,0,811,536,275,144,25,119,0.22,0.09,0.18,2622,57,158,653
210429,WESTERN OREGON UNIVERSITY,0,1,2002,Inf,0,769,466,303,142,36,106,0.22,0.12,0.18,2700,58,162,649
210429,WESTERN OREGON UNIVERSITY,0,1,2003,Inf,0,903,555,348,144,37,107,0.19,0.11,0.16,3240,62,156,771
210429,WESTERN OREGON UNIVERSITY,0,1,2004,Inf,0,795,447,348,138,55,83,0.18,0.16,0.17,3240,63,164,635
210429,Western Oregon University,0,1,2005,Inf,0,849,511,338,132,36,96,0.18,0.11,0.16,3366,69,175,658
210429,Western Oregon University,0,1,2006,Inf,0,750,485,265,150,40,110,0.22,0.15,0.2,3510,70,162,557
210429,Western Oregon University,0,1,2007,Inf,0,916,527,389,184,54,130,0.24,0.14,0.2,4500,70,176,679
210429,Western Oregon University,0,1,2008,Inf,0,882,524,358,197,58,139,0.26,0.16,0.22,5175,82,189,658
210429,Western Oregon University,0,1,2009,Inf,0,933,553,380,192,39,153,0.27,0.1,0.21,5640,87,195,691
210429,Western Oregon University,0,1,2010,Inf,0,1039,636,403,204,45,159,0.25,0.11,0.2,6135,88,190,722
210571,ALBRIGHT COLLEGE,1,0,1991,NA,NA,236,120,116,143,58,85,0.7000000000000001,0.5,0.61,13560,25,89,199
210571,ALBRIGHT COLLEGE,1,0,1992,NA,NA,310,135,175,160,81,79,0.58,0.46,0.52,13960,26,85,267
210571,ALBRIGHT COLLEGE,1,0,1993,NA,NA,227,140,87,147,50,97,0.6900000000000001,0.57,0.65,15010,27,79,204
210571,ALBRIGHT COLLEGE,1,0,1995,NA,NA,312,153,159,169,66,103,0.67,0.42,0.54,16575,25,60,260
210571,ALBRIGHT COLLEGE,1,0,1996,NA,NA,354,190,164,215,77,138,0.72,0.47,0.61,17395,28,63,310
210571,ALBRIGHT COLLEGE,1,0,1997,NA,NA,295,137,158,176,83,93,0.67,0.53,0.6,18310,23,67,248
210571,ALBRIGHT COLLEGE,1,0,1998,NA,NA,355,187,168,176,71,105,0.56,0.42,0.5,18890,25,71,301
210571,ALBRIGHT COLLEGE,1,0,1999,NA,NA,392,242,150,203,61,142,0.58,0.41,0.52,18910,27,73,311
210571,ALBRIGHT COLLEGE,1,0,2000,NA,NA,407,231,176,207,84,123,0.53,0.48,0.51,19760,30,82,319
210571,ALBRIGHT COLLEGE,1,0,2001,NA,NA,402,243,159,215,75,140,0.5700000000000001,0.47,0.53,20750,33,91,323
210571,ALBRIGHT COLLEGE,1,0,2002,NA,NA,453,250,203,254,104,150,0.6,0.51,0.56,21790,35,104,352
210571,ALBRIGHT COLLEGE,1,0,2003,NA,NA,456,259,197,252,96,156,0.6,0.49,0.55,22880,39,109,363
210571,ALBRIGHT COLLEGE,1,0,2004,NA,NA,505,319,186,268,86,182,0.5700000000000001,0.46,0.53,24030,42,115,389
210571,Albright College,1,0,2005,NA,NA,450,254,196,234,85,149,0.58,0.43,0.52,25232,43,113,350
210571,Albright College,1,0,2006,NA,NA,458,233,225,210,87,123,0.52,0.39,0.46,26620,44,118,347
210571,Albright College,1,0,2007,NA,NA,512,307,205,247,90,157,0.51,0.44,0.48,28084,44,114,412
210571,Albright College,1,0,2008,NA,NA,505,260,245,224,86,138,0.53,0.35,0.44,29770,46,125,347
210571,Albright College,1,0,2009,NA,NA,541,317,224,268,83,185,0.58,0.37,0.5,30800,48,121,376
210571,Albright College,1,0,2010,NA,NA,485,255,230,230,90,140,0.54,0.39,0.47,31940,49,124,325
210669,ALLEGHENY COLLEGE,1,0,1991,NA,NA,606,289,317,354,173,181,0.62,0.55,0.58,14850,41,139,545
210669,ALLEGHENY COLLEGE,1,0,1992,NA,NA,471,251,220,295,114,181,0.72,0.52,0.63,15750,44,137,428
210669,ALLEGHENY COLLEGE,1,0,1993,NA,NA,481,247,234,301,126,175,0.7000000000000001,0.54,0.63,16700,43,144,446
210669,ALLEGHENY COLLEGE,1,0,1995,NA,NA,564,284,280,353,162,191,0.67,0.58,0.63,18020,49,141,516
210669,ALLEGHENY COLLEGE,1,0,1996,NA,NA,523,311,212,346,125,221,0.71,0.59,0.66,18720,50,142,505
210669,ALLEGHENY COLLEGE,1,0,1997,NA,NA,541,289,252,328,139,189,0.65,0.55,0.61,19360,38,133,510
210669,ALLEGHENY COLLEGE,1,0,1998,NA,NA,545,272,273,321,144,177,0.65,0.53,0.59,20020,41,128,487
210669,ALLEGHENY COLLEGE,1,0,1999,NA,NA,562,284,278,374,167,207,0.72,0.6,0.67,20410,42,131,521
210669,ALLEGHENY COLLEGE,1,0,2000,NA,NA,561,291,270,393,175,218,0.74,0.65,0.7,21290,42,133,538
210669,ALLEGHENY COLLEGE,1,0,2001,NA,NA,486,271,215,312,128,184,0.67,0.6,0.64,22210,44,135,443
210669,ALLEGHENY COLLEGE,1,0,2002,NA,NA,536,271,265,374,165,209,0.77,0.62,0.7,23100,49,137,500
210669,ALLEGHENY COLLEGE,1,0,2003,NA,NA,478,234,244,317,143,174,0.74,0.59,0.66,24100,52,139,434
210669,ALLEGHENY COLLEGE,1,0,2004,NA,NA,647,341,306,465,206,259,0.75,0.67,0.72,25250,52,145,604
210669,Allegheny College,1,0,2005,NA,NA,561,311,250,424,181,243,0.78,0.72,0.76,26650,54,143,515
210669,Allegheny College,1,0,2006,NA,NA,570,322,248,398,159,239,0.74,0.64,0.7,28000,56,149,528
210669,Allegheny College,1,0,2007,NA,NA,581,351,230,431,159,272,0.77,0.69,0.74,29680,59,157,517
210669,Allegheny College,1,0,2008,NA,NA,562,306,256,412,179,233,0.76,0.7,0.73,31680,63,163,481
210669,Allegheny College,1,0,2009,NA,NA,580,299,281,395,177,218,0.72,0.63,0.68,33240,65,160,493
210669,Allegheny College,1,0,2010,NA,NA,594,332,262,415,173,242,0.72,0.66,0.7,34490,70,166,489
210775,ALVERNIA COLLEGE,1,0,1991,NA,NA,194,128,66,56,16,40,0.31,0.24,0.29,6935,7,51,188
210775,ALVERNIA COLLEGE,1,0,1992,NA,NA,182,103,79,26,7,19,0.18,0.09,0.14,7995,9,57,172
210775,ALVERNIA COLLEGE,1,0,1993,NA,NA,157,103,54,48,14,34,0.33,0.26,0.31,8419,11,60,152
210775,ALVERNIA COLLEGE,1,0,1995,NA,NA,150,76,74,46,14,32,0.42,0.19,0.31,9850,13,62,133
210775,ALVERNIA COLLEGE,1,0,1996,NA,NA,143,73,70,44,16,28,0.38,0.23,0.31,10700,14,57,137
210775,ALVERNIA COLLEGE,1,0,1997,NA,NA,155,95,60,64,26,38,0.4,0.43,0.41,11320,11,54,145
210775,ALVERNIA COLLEGE,1,0,1998,NA,NA,168,93,75,56,16,40,0.43,0.21,0.33,11680,12,51,149
210775,ALVERNIA COLLEGE,1,0,1999,NA,NA,204,101,103,79,34,45,0.44,0.33,0.39,11730,13,52,169
210775,ALVERNIA COLLEGE,1,0,2000,NA,NA,236,149,87,70,22,48,0.32,0.25,0.3,12950,15,55,197
210775,ALVERNIA COLLEGE,1,0,2001,NA,NA,248,159,89,90,28,62,0.38,0.31,0.36,14000,17,58,213
210775,ALVERNIA COLLEGE,1,0,2002,NA,NA,242,153,89,89,29,60,0.39,0.33,0.37,15000,18,58,197
210775,ALVERNIA COLLEGE,1,0,2003,NA,NA,278,165,113,99,32,67,0.4,0.28,0.36,16200,22,65,240
210775,ALVERNIA COLLEGE,1,0,2004,NA,NA,310,197,113,123,29,94,0.47000000000000003,0.26,0.4,17500,24,69,242
210775,Alvernia College,1,0,2005,NA,NA,262,149,113,100,35,65,0.43,0.31,0.38,18900,28,74,213
210775,Alvernia College,1,0,2006,NA,NA,300,188,112,114,43,71,0.37,0.38,0.38,20220,31,75,237
210775,Alvernia College,1,0,2007,NA,NA,302,165,137,107,48,59,0.35000000000000003,0.35,0.35,21400,35,81,268
210775,Alvernia College,1,0,2008,NA,NA,383,233,150,148,44,104,0.44,0.29,0.39,22800,36,85,329
210775,Alvernia University,1,0,2009,NA,NA,328,188,140,124,53,71,0.37,0.38,0.38,23900,40,85,264
210775,Alvernia University,1,0,2010,NA,NA,388,268,120,142,39,103,0.38,0.32,0.37,24980,41,89,322
211088,BEAVER COLLEGE,1,0,1991,NA,NA,140,110,30,92,13,79,0.71,0.43,0.66,10960,27,72,117
211088,BEAVER COLLEGE,1,0,1992,NA,NA,163,120,43,81,15,66,0.55,0.35,0.5,11710,30,66,140
211088,BEAVER COLLEGE,1,0,1993,NA,NA,227,166,61,131,35,96,0.5700000000000001,0.57,0.58,12510,30,68,187
211088,BEAVER COLLEGE,1,0,1995,NA,NA,257,186,71,145,36,109,0.58,0.51,0.56,13970,34,73,213
211088,BEAVER COLLEGE,1,0,1996,NA,NA,292,219,73,131,29,102,0.46,0.4,0.45,14870,37,83,217
211088,BEAVER COLLEGE,1,0,1997,NA,NA,260,191,69,142,34,108,0.56,0.49,0.55,15840,36,78,203
211088,BEAVER COLLEGE,1,0,1998,NA,NA,334,248,86,189,46,143,0.5700000000000001,0.53,0.57,16520,39,88,272
211088,BEAVER COLLEGE,1,0,1999,NA,NA,307,238,69,154,28,126,0.52,0.41,0.5,16880,28,95,262
211088,BEAVER COLLEGE,1,0,2000,NA,NA,294,228,66,147,27,120,0.52,0.41,0.5,17550,32,91,228
211088,ARCADIA UNIVERSITY,1,0,2001,NA,NA,293,203,90,158,47,111,0.54,0.52,0.54,18390,34,87,244
211088,ARCADIA UNIVERSITY,1,0,2002,NA,NA,399,308,91,237,55,182,0.59,0.6,0.59,19660,38,90,327
211088,ARCADIA UNIVERSITY,1,0,2003,NA,NA,489,360,129,259,77,182,0.5,0.6,0.53,20990,40,93,409
211088,ARCADIA UNIVERSITY,1,0,2004,NA,NA,476,343,133,247,67,180,0.52,0.5,0.52,22440,45,107,398
211088,Arcadia University,1,0,2005,NA,NA,432,315,117,232,59,173,0.54,0.5,0.54,23990,49,108,353
211088,Arcadia University,1,0,2006,NA,NA,572,452,120,336,72,264,0.58,0.6,0.59,25650,55,108,470
211088,Arcadia University,1,0,2007,NA,NA,476,364,112,253,53,200,0.54,0.47,0.53,27440,60,118,395
211088,Arcadia University,1,0,2008,NA,NA,593,434,159,294,73,221,0.5,0.46,0.5,29340,64,125,302
211088,Arcadia University,1,0,2009,NA,NA,529,381,148,257,70,187,0.49,0.47,0.49,30780,66,125,398
211088,Arcadia University,1,0,2010,NA,NA,552,397,155,317,75,242,0.6,0.48,0.57,32140,68,125,404
211158,BLOOMSBURG UNIVERSITY OF PENNSYLVANIA,1,0,1991,NA,NA,1080,664,416,443,132,311,0.46,0.32,0.41,2968,63,339,1010
211158,BLOOMSBURG UNIVERSITY OF PENNSYLVANIA,1,0,1992,NA,NA,1047,696,351,423,87,336,0.48,0.25,0.4,3068,67,338,951
211158,BLOOMSBURG UNIVERSITY OF PENNSYLVANIA,1,0,1993,NA,NA,1017,615,402,379,115,264,0.42,0.29,0.37,3458,69,348,925
211158,BLOOMSBURG UNIVERSITY OF PENNSYLVANIA,1,0,1995,NA,NA,1054,689,365,372,88,284,0.41000000000000003,0.24,0.35,3915,77,338,974
211158,BLOOMSBURG UNIVERSITY OF PENNSYLVANIA,1,0,1996,NA,NA,1556,994,562,567,147,420,0.42,0.26,0.36,4162,85,330,1469
211158,BLOOMSBURG UNIVERSITY OF PENNSYLVANIA,1,0,1997,NA,NA,1355,893,462,459,125,334,0.37,0.27,0.34,4277,84,337,1242
211158,BLOOMSBURG UNIVERSITY OF PENNSYLVANIA,1,0,1998,NA,NA,1377,890,487,465,102,363,0.4,0.21,0.34,4277,90,334,1261
211158,BLOOMSBURG UNIVERSITY OF PENNSYLVANIA,1,0,1999,NA,NA,1402,891,511,527,164,363,0.4,0.32,0.38,3618,90,325,1299
211158,BLOOMSBURG UNIVERSITY OF PENNSYLVANIA,1,0,2000,NA,NA,1414,912,502,587,153,434,0.47000000000000003,0.3,0.42,3792,100,326,1325
211158,BLOOMSBURG UNIVERSITY OF PENNSYLVANIA,1,0,2001,NA,NA,1684,1021,663,646,183,463,0.45,0.28,0.38,4016,99,327,1564
211158,BLOOMSBURG UNIVERSITY OF PENNSYLVANIA,1,0,2002,NA,NA,1478,938,540,650,169,481,0.51,0.31,0.44,4378,100,350,1337
211158,BLOOMSBURG UNIVERSITY OF PENNSYLVANIA,1,0,2003,NA,NA,1665,1000,665,677,201,476,0.47000000000000003,0.3,0.41,4598,104,352,1481
211158,BLOOMSBURG UNIVERSITY OF PENNSYLVANIA,1,0,2004,NA,NA,1533,947,586,631,198,433,0.45,0.34,0.41,4810,109,350,1296
211158,Bloomsburg University of Pennsylvania,1,0,2005,NA,NA,1690,1050,640,693,207,486,0.46,0.32,0.41,4906,113,357,1411
211158,Bloomsburg University of Pennsylvania,1,0,2006,NA,NA,1630,987,643,696,221,475,0.48,0.34,0.43,5038,119,366,1329
211158,Bloomsburg University of Pennsylvania,1,0,2007,NA,NA,1679,969,710,710,237,473,0.48,0.33,0.42,5177,128,379,1332
211158,Bloomsburg University of Pennsylvania,1,0,2008,NA,NA,1805,1028,777,781,263,518,0.5,0.34,0.43,5358,136,378,1432
211158,Bloomsburg University of Pennsylvania,1,0,2009,NA,NA,2031,1221,810,772,252,520,0.42,0.31,0.38,5554,143,397,1554
211158,Bloomsburg University of Pennsylvania,1,0,2010,NA,NA,2136,1263,873,808,251,557,0.44,0.29,0.38,5804,155,403,1768
211291,BUCKNELL UNIVERSITY,1,0,1991,NA,NA,907,410,497,776,408,368,0.89,0.82,0.86,15650,79,238,827
211291,BUCKNELL UNIVERSITY,1,0,1992,NA,NA,890,426,464,739,376,363,0.85,0.81,0.83,16670,84,239,835
211291,BUCKNELL UNIVERSITY,1,0,1993,NA,NA,854,454,400,717,324,393,0.86,0.81,0.84,17730,88,243,785
211291,BUCKNELL UNIVERSITY,1,0,1995,NA,NA,910,474,436,736,342,394,0.8300000000000001,0.78,0.81,19470,97,253,788
211291,BUCKNELL UNIVERSITY,1,0,1996,NA,NA,895,440,455,761,365,396,0.9,0.8,0.85,20360,104,261,798
211291,BUCKNELL UNIVERSITY,1,0,1997,NA,NA,898,426,472,752,380,372,0.87,0.81,0.84,21210,89,261,788
211291,BUCKNELL UNIVERSITY,1,0,1998,NA,NA,954,468,486,840,427,413,0.88,0.88,0.88,22005,93,270,829
211291,BUCKNELL UNIVERSITY,1,0,1999,NA,NA,886,425,461,764,396,368,0.86,0.86,0.86,22740,99,280,763
211291,BUCKNELL UNIVERSITY,1,0,2000,NA,NA,914,454,460,773,376,397,0.87,0.82,0.85,23698,103,284,774
211291,BUCKNELL UNIVERSITY,1,0,2001,NA,NA,913,468,445,784,367,417,0.89,0.82,0.86,25144,109,289,787
211291,BUCKNELL UNIVERSITY,1,0,2002,NA,NA,914,455,459,764,371,393,0.86,0.81,0.84,27340,116,323,772
211291,BUCKNELL UNIVERSITY,1,0,2003,NA,NA,906,462,444,794,374,420,0.9,0.84,0.88,28764,122,319,752
211291,BUCKNELL UNIVERSITY,1,0,2004,NA,NA,906,447,459,813,397,416,0.93,0.86,0.9,30534,127,313,735
211291,Bucknell University,1,0,2005,NA,NA,920,504,416,804,352,452,0.89,0.85,0.87,32592,136,323,727
211291,Bucknell University,1,0,2006,NA,NA,921,458,463,792,383,409,0.89,0.83,0.86,34731,139,323,736
211291,Bucknell University,1,0,2007,NA,NA,887,441,446,774,373,401,0.9,0.84,0.87,37934,151,335,743
211291,Bucknell University,1,0,2008,NA,NA,956,529,427,814,357,457,0.86,0.84,0.85,39434,166,369,789
211291,Bucknell University,1,0,2009,NA,NA,920,466,454,780,371,409,0.87,0.82,0.85,40594,173,368,765
211291,Bucknell University,1,0,2010,NA,NA,929,491,438,782,355,427,0.86,0.81,0.84,42112,172,371,741
211352,CABRINI COLLEGE,1,0,1991,NA,NA,137,93,44,73,19,54,0.58,0.43,0.53,8830,13,43,129
211352,CABRINI COLLEGE,1,0,1992,NA,NA,161,115,46,91,24,67,0.58,0.52,0.57,9500,14,43,145
211352,CABRINI COLLEGE,1,0,1993,NA,NA,224,158,66,115,29,86,0.54,0.44,0.51,10232,15,41,210
211352,CABRINI COLLEGE,1,0,1995,NA,NA,218,150,68,110,25,85,0.56,0.37,0.5,11600,19,42,183
211352,CABRINI COLLEGE,1,0,1996,NA,NA,247,186,61,114,23,91,0.48,0.38,0.46,12160,22,43,205
211352,CABRINI COLLEGE,1,0,1997,NA,NA,339,231,108,160,39,121,0.52,0.36,0.47,12700,17,49,301
211352,CABRINI COLLEGE,1,0,1998,NA,NA,304,209,95,152,35,117,0.55,0.37,0.5,14650,19,54,261
211352,CABRINI COLLEGE,1,0,1999,NA,NA,248,163,85,124,30,94,0.5700000000000001,0.35,0.5,15250,21,58,183
211352,CABRINI COLLEGE,1,0,2000,NA,NA,359,221,138,161,50,111,0.5,0.36,0.45,16150,22,54,298
211352,CABRINI COLLEGE,1,0,2001,NA,NA,374,221,153,166,50,116,0.52,0.33,0.44,17340,25,50,297
211352,CABRINI COLLEGE,1,0,2002,NA,NA,408,277,131,191,53,138,0.49,0.4,0.47,18470,27,59,329
211352,CABRINI COLLEGE,1,0,2003,NA,NA,401,270,131,184,55,129,0.47000000000000003,0.42,0.46,19670,30,62,344
211352,CABRINI COLLEGE,1,0,2004,NA,NA,390,257,133,155,45,110,0.42,0.34,0.4,21450,32,63,303
211352,Cabrini College,1,0,2005,NA,NA,526,385,141,257,60,197,0.51,0.43,0.49,23200,34,64,468
211352,Cabrini College,1,0,2006,NA,NA,529,337,192,232,63,169,0.5,0.33,0.44,25120,38,61,449
211352,Cabrini College,1,0,2007,NA,NA,513,329,184,202,66,136,0.41000000000000003,0.36,0.39,27200,42,65,416
211352,Cabrini College,1,0,2008,NA,NA,503,341,162,210,62,148,0.43,0.38,0.42,29100,49,68,405
211352,Cabrini College,1,0,2009,NA,NA,357,237,120,178,57,121,0.51,0.48,0.5,30120,52,70,245
211352,Cabrini College,1,0,2010,NA,NA,339,222,117,174,47,127,0.5700000000000001,0.4,0.51,31174,48,72,259
211361,CALIFORNIA UNIVERSITY OF PENNSYLVANIA,1,0,1991,NA,NA,1107,565,542,141,48,93,0.16,0.09,0.13,3128,55,389,1018
211361,CALIFORNIA UNIVERSITY OF PENNSYLVANIA,1,0,1992,NA,NA,962,436,526,139,45,94,0.21,0.09,0.14,3384,59,325,888
211361,CALIFORNIA UNIVERSITY OF PENNSYLVANIA,1,0,1993,NA,NA,951,401,550,145,55,90,0.22,0.1,0.15,3760,61,309,893
211361,CALIFORNIA UNIVERSITY OF PENNSYLVANIA,1,0,1995,NA,NA,892,465,427,124,45,79,0.16,0.11,0.14,4136,66,317,825
211361,CALIFORNIA UNIVERSITY OF PENNSYLVANIA,1,0,1996,NA,NA,805,398,407,140,47,93,0.23,0.12,0.17,4304,67,291,731
211361,CALIFORNIA UNIVERSITY OF PENNSYLVANIA,1,0,1997,NA,NA,942,446,496,163,64,99,0.22,0.13,0.17,4475,67,298,857
211361,CALIFORNIA UNIVERSITY OF PENNSYLVANIA,1,0,1998,NA,NA,931,480,451,180,68,112,0.23,0.15,0.19,4545,69,302,868
211361,CALIFORNIA UNIVERSITY OF PENNSYLVANIA,1,0,1999,NA,NA,924,484,440,162,48,114,0.23,0.11,0.18,3618,71,278,869
211361,CALIFORNIA UNIVERSITY OF PENNSYLVANIA,1,0,2000,NA,NA,840,398,442,187,83,104,0.26,0.19,0.22,3792,74,279,789
211361,CALIFORNIA UNIVERSITY OF PENNSYLVANIA,1,0,2001,NA,NA,817,413,404,208,84,124,0.3,0.21,0.25,4016,78,280,754
211361,CALIFORNIA UNIVERSITY OF PENNSYLVANIA,1,0,2002,NA,NA,893,464,429,224,95,129,0.27,0.22,0.25,4378,77,259,622
211361,CALIFORNIA UNIVERSITY OF PENNSYLVANIA,1,0,2003,NA,NA,982,520,462,251,105,146,0.28,0.23,0.26,4598,82,255,708
211361,CALIFORNIA UNIVERSITY OF PENNSYLVANIA,1,0,2004,NA,NA,1038,519,519,293,127,166,0.31,0.24,0.28,4810,83,255,780
211361,California University of Pennsylvania,1,0,2005,NA,NA,1247,640,607,298,119,179,0.27,0.2,0.24,4906,84,263,950
211361,California University of Pennsylvania,1,0,2006,NA,NA,1260,685,575,313,124,189,0.27,0.22,0.25,5038,93,276,897
211361,California University of Pennsylvania,1,0,2007,NA,NA,1250,622,628,281,124,157,0.25,0.2,0.22,5178,106,289,946
211361,California University of Pennsylvania,1,0,2008,NA,NA,1363,748,615,355,130,225,0.3,0.21,0.26,5358,118,292,1091
211361,California University of Pennsylvania,1,0,2009,NA,NA,1373,679,694,323,156,167,0.24,0.22,0.24,5554,123,287,1009
211361,California University of Pennsylvania,1,0,2010,NA,NA,1351,711,640,332,136,196,0.27,0.21,0.25,5804,136,278,1107
211431,CARLOW COLLEGE,1,0,1991,NA,NA,144,138,6,59,2,57,0.41000000000000003,0.33,0.41,8752,11,46,129
211431,CARLOW COLLEGE,1,0,1992,NA,NA,159,148,11,50,2,48,0.32,0.18,0.31,9190,12,53,140
211431,CARLOW COLLEGE,1,0,1993,NA,NA,169,158,11,80,3,77,0.48,0.27,0.47,9650,15,53,151
211431,CARLOW COLLEGE,1,0,1995,NA,NA,125,122,3,57,2,55,0.45,0.67,0.46,10588,20,60,106
211431,CARLOW COLLEGE,1,0,1996,NA,NA,148,145,3,65,0,65,0.44,0,0.44,11064,23,68,119
211431,CARLOW COLLEGE,1,0,1997,NA,NA,142,139,3,50,1,49,0.35000000000000003,0.33,0.35,11708,22,66,117
211431,CARLOW COLLEGE,1,0,1998,NA,NA,163,157,6,43,3,40,0.25,0.5,0.26,12332,20,62,118
211431,CARLOW COLLEGE,1,0,1999,NA,NA,130,128,2,47,0,47,0.36,0,0.36,12450,21,61,102
211431,CARLOW COLLEGE,1,0,2000,NA,NA,180,178,2,85,0,85,0.47000000000000003,0,0.47,12950,21,60,140
211431,CARLOW COLLEGE,1,0,2001,NA,NA,177,170,7,65,0,65,0.38,0,0.37,13468,22,59,146
211431,CARLOW COLLEGE,1,0,2002,NA,NA,238,231,7,79,0,79,0.34,0,0.33,14006,23,60,179
211431,CARLOW COLLEGE,1,0,2003,NA,NA,236,229,7,71,3,68,0.29,0.43,0.3,14776,24,69,183
211431,CARLOW UNIVERSITY,1,0,2004,NA,NA,231,226,5,87,1,86,0.38,0.2,0.38,15806,25,75,187
211431,Carlow University,1,0,2005,NA,NA,273,264,9,102,3,99,0.37,0.33,0.37,16754,27,70,234
211431,Carlow University,1,0,2006,NA,NA,262,250,12,114,3,111,0.44,0.25,0.44,17760,29,77,201
211431,Carlow University,1,0,2007,NA,NA,199,194,5,93,0,93,0.47000000000000003,0,0.47,18736,31,84,149
211431,Carlow University,1,0,2008,NA,NA,226,215,11,99,2,97,0.45,0.18,0.44,19860,34,93,153
211431,Carlow University,1,0,2009,NA,NA,250,245,5,100,1,99,0.4,0.2,0.4,20854,35,96,183
211431,Carlow University,1,0,2010,NA,NA,189,181,8,76,1,75,0.41000000000000003,0.12,0.4,22400,38,98,103
211440,CARNEGIE MELLON UNIVERSITY,1,0,1991,NA,NA,1170,335,835,657,464,193,0.5700000000000001,0.56,0.56,15350,302,507,721
211440,CARNEGIE MELLON UNIVERSITY,1,0,1992,NA,NA,1141,354,787,666,440,226,0.63,0.56,0.58,16000,317,518,626
211440,CARNEGIE MELLON UNIVERSITY,1,0,1993,NA,NA,1189,358,831,752,510,242,0.67,0.61,0.63,16960,329,523,590
211440,CARNEGIE MELLON UNIVERSITY,1,0,1995,NA,NA,1233,376,857,772,515,257,0.68,0.6,0.63,18600,358,513,605
211440,CARNEGIE MELLON UNIVERSITY,1,0,1996,NA,NA,1386,472,914,903,563,340,0.72,0.62,0.65,19500,386,515,667
211440,CARNEGIE MELLON UNIVERSITY,1,0,1997,NA,NA,1270,464,806,841,522,319,0.68,0.65,0.66,20375,382,527,597
211440,CARNEGIE MELLON UNIVERSITY,1,0,1998,NA,NA,1303,445,858,848,539,309,0.6900000000000001,0.63,0.65,21405,405,527,574
211440,CARNEGIE MELLON UNIVERSITY,1,0,1999,NA,NA,1255,487,768,833,491,342,0.7000000000000001,0.64,0.66,22100,429,546,564
211440,CARNEGIE MELLON UNIVERSITY,1,0,2000,NA,NA,1325,516,809,920,537,383,0.74,0.66,0.69,24600,465,556,548
211440,CARNEGIE MELLON UNIVERSITY,1,0,2001,NA,NA,1317,534,783,927,526,401,0.75,0.67,0.7,25670,505,566,565
211440,CARNEGIE MELLON UNIVERSITY,1,0,2002,NA,NA,1364,542,822,957,557,400,0.73,0.68,0.7,26910,574,747,603
211440,CARNEGIE MELLON UNIVERSITY,1,0,2003,NA,NA,1338,528,810,903,532,371,0.7000000000000001,0.66,0.67,28766,560,783,563
211440,CARNEGIE MELLON UNIVERSITY,1,0,2004,NA,NA,1359,510,849,940,579,361,0.7000000000000001,0.68,0.69,30650,622,797,562
211440,Carnegie Mellon University,1,0,2005,NA,NA,1408,533,875,1000,611,389,0.72,0.7,0.71,31650,684,810,600
211440,Carnegie Mellon University,1,0,2006,NA,NA,1421,552,869,1033,630,403,0.73,0.72,0.73,33050,744,826,567
211440,Carnegie Mellon University,1,0,2007,NA,NA,1407,554,853,1046,612,434,0.78,0.72,0.74,35580,762,822,570
211440,Carnegie Mellon University,1,0,2008,NA,NA,1462,625,837,1050,580,470,0.75,0.69,0.72,38430,822,854,565
211440,Carnegie Mellon University,1,0,2009,NA,NA,1423,611,812,1026,558,468,0.76,0.69,0.72,39470,867,872,623
211440,Carnegie Mellon University,1,0,2010,NA,NA,1484,619,865,1119,630,489,0.79,0.73,0.75,41500,890,889,616
211468,CEDAR CREST COLLEGE,1,0,1991,NA,NA,120,120,0,62,0,62,0.51,NA,0.52,12210,12,58,110
211468,CEDAR CREST COLLEGE,1,0,1992,NA,NA,187,186,1,74,0,74,0.39,0,0.4,12940,13,62,157
211468,CEDAR CREST COLLEGE,1,0,1993,NA,NA,198,196,2,83,1,82,0.41000000000000003,0.5,0.42,13720,16,60,177
211468,CEDAR CREST COLLEGE,1,0,1995,NA,NA,164,164,0,90,0,90,0.54,NA,0.55,14770,21,65,140
211468,CEDAR CREST COLLEGE,1,0,1996,NA,NA,329,328,1,189,0,189,0.5700000000000001,0,0.57,15210,21,67,274
211468,CEDAR CREST COLLEGE,1,0,1997,NA,NA,195,194,1,122,1,121,0.62,1,0.63,15920,19,63,155
211468,CEDAR CREST COLLEGE,1,0,1998,NA,NA,187,185,2,104,1,103,0.55,0.5,0.56,16550,19,63,156
211468,CEDAR CREST COLLEGE,1,0,1999,NA,NA,218,218,0,115,0,115,0.52,NA,0.53,17100,20,67,166
211468,CEDAR CREST COLLEGE,1,0,2000,NA,NA,200,198,2,109,0,109,0.55,0,0.54,17790,19,69,141
211468,CEDAR CREST COLLEGE,1,0,2001,NA,NA,170,170,0,78,0,78,0.45,NA,0.46,18680,20,71,143
211468,CEDAR CREST COLLEGE,1,0,2002,NA,NA,185,185,0,89,0,89,0.48,NA,0.48,19615,21,71,152
211468,CEDAR CREST COLLEGE,1,0,2003,NA,NA,233,233,0,105,0,105,0.45,NA,0.45,20596,21,70,198
211468,CEDAR CREST COLLEGE,1,0,2004,NA,NA,237,237,0,114,0,114,0.48,NA,0.48,21630,23,75,205
211468,Cedar Crest College,1,0,2005,NA,NA,203,202,1,82,1,81,0.4,1,0.4,22712,25,79,179
211468,Cedar Crest College,1,0,2006,NA,NA,254,251,3,124,1,123,0.49,0.33,0.49,23848,27,84,220
211468,Cedar Crest College,1,0,2007,NA,NA,222,221,1,112,0,112,0.5,0,0.5,25040,29,92,193
211468,Cedar Crest College,1,0,2008,NA,NA,194,194,0,114,0,114,0.58,NA,0.59,26668,31,90,156
211468,Cedar Crest College,1,0,2009,NA,NA,195,194,1,84,0,84,0.43,0,0.43,27735,31,87,157
211468,Cedar Crest College,1,0,2010,NA,NA,91,90,1,36,0,36,0.4,0,0.4,28567,31,87,62
211556,CHATHAM COLLEGE,1,0,1991,NA,NA,100,100,0,52,0,52,0.52,NA,0.52,11065,12,45,80
211556,CHATHAM COLLEGE,1,0,1992,NA,NA,89,89,0,42,0,42,0.47000000000000003,NA,0.47,11990,14,45,75
211556,CHATHAM COLLEGE,1,0,1993,NA,NA,87,87,0,41,0,41,0.47000000000000003,NA,0.47,12630,14,50,81
211556,CHATHAM COLLEGE,1,0,1995,NA,NA,109,109,0,48,0,48,0.44,NA,0.44,14196,15,50,94
211556,CHATHAM COLLEGE,1,0,1996,NA,NA,102,102,0,60,0,60,0.58,NA,0.59,14616,17,54,87
211556,CHATHAM COLLEGE,1,0,1997,NA,NA,92,92,0,51,0,51,0.55,NA,0.55,15340,15,55,79
211556,CHATHAM COLLEGE,1,0,1998,NA,NA,142,142,0,63,0,63,0.44,NA,0.44,16406,17,54,118
211556,CHATHAM COLLEGE,1,0,1999,NA,NA,126,126,0,62,0,62,0.49,NA,0.49,17388,20,57,87
211556,CHATHAM COLLEGE,1,0,2000,NA,NA,138,138,0,54,0,54,0.39,NA,0.39,18080,21,64,112
211556,CHATHAM COLLEGE,1,0,2001,NA,NA,133,133,0,56,0,56,0.42,NA,0.42,18804,22,71,99
211556,CHATHAM COLLEGE,1,0,2002,NA,NA,108,108,0,49,0,49,0.45,NA,0.45,19576,24,70,77
211556,CHATHAM COLLEGE,1,0,2003,NA,NA,74,74,0,38,0,38,0.51,NA,0.51,20360,23,71,58
211556,CHATHAM COLLEGE,1,0,2004,NA,NA,90,90,0,50,0,50,0.55,NA,0.56,21780,27,71,52
211556,Chatham College,1,0,2005,NA,NA,116,116,0,57,0,57,0.49,NA,0.49,22870,28,73,78
211556,Chatham University,1,0,2006,NA,NA,147,147,0,75,0,75,0.51,NA,0.51,24014,31,78,100
211556,Chatham University,1,0,2007,NA,NA,175,175,0,77,0,77,0.44,NA,0.44,25216,35,85,122
211556,Chatham University,1,0,2008,NA,NA,176,176,0,82,0,82,0.46,NA,0.47,26476,40,88,104
211556,Chatham University,1,0,2009,NA,NA,131,131,0,66,0,66,0.5,NA,0.5,27270,43,88,78
211556,Chatham University,1,0,2010,NA,NA,150,150,0,72,0,72,0.48,NA,0.48,28088,46,90,73
211583,CHESTNUT HILL COLLEGE,1,0,1991,NA,NA,111,111,0,54,0,54,0.48,NA,0.49,8250,9,33,71
211583,CHESTNUT HILL COLLEGE,1,0,1992,NA,NA,145,145,0,76,0,76,0.52,NA,0.52,8950,10,35,116
211583,CHESTNUT HILL COLLEGE,1,0,1993,NA,NA,132,132,0,73,0,73,0.55,NA,0.55,9525,11,37,91
211583,CHESTNUT HILL COLLEGE,1,0,1995,NA,NA,83,83,0,53,0,53,0.63,NA,0.64,11865,13,36,57
211583,CHESTNUT HILL COLLEGE,1,0,1996,NA,NA,77,77,0,46,0,46,0.59,NA,0.6,13148,15,37,47
211583,CHESTNUT HILL COLLEGE,1,0,1997,NA,NA,92,92,0,51,0,51,0.55,NA,0.55,14585,13,35,67
211583,CHESTNUT HILL COLLEGE,1,0,1998,NA,NA,95,93,2,42,0,42,0.45,0,0.44,15198,12,38,48
211583,CHESTNUT HILL COLLEGE,1,0,1999,NA,NA,102,101,1,45,1,44,0.43,1,0.44,15454,14,34,63
211583,CHESTNUT HILL COLLEGE,1,0,2000,NA,NA,104,98,6,51,1,50,0.51,0.17,0.49,16200,15,36,51
211583,CHESTNUT HILL COLLEGE,1,0,2001,NA,NA,94,94,0,50,0,50,0.53,NA,0.53,16990,16,39,55
211583,CHESTNUT HILL COLLEGE,1,0,2002,NA,NA,105,104,1,27,0,27,0.25,0,0.26,17500,16,38,52
211583,CHESTNUT HILL COLLEGE,1,0,2003,NA,NA,188,125,63,66,19,47,0.37,0.3,0.35,18375,18,43,122
211583,CHESTNUT HILL COLLEGE,1,0,2004,NA,NA,197,115,82,62,24,38,0.33,0.29,0.31,19660,20,50,115
211583,Chestnut Hill College,1,0,2005,NA,NA,219,150,69,73,23,50,0.33,0.33,0.33,20840,22,50,124
211583,Chestnut Hill College,1,0,2006,NA,NA,214,155,59,78,22,56,0.36,0.37,0.36,23600,24,53,144
211583,Chestnut Hill College,1,0,2007,NA,NA,234,128,106,63,24,39,0.3,0.23,0.27,24900,27,52,154
211583,Chestnut Hill College,1,0,2008,NA,NA,194,115,79,72,24,48,0.41000000000000003,0.3,0.37,26000,30,57,113
211583,Chestnut Hill College,1,0,2009,NA,NA,273,164,109,101,27,74,0.45,0.25,0.37,27000,32,57,155
211583,Chestnut Hill College,1,0,2010,NA,NA,219,125,94,82,31,51,0.4,0.33,0.37,28100,35,64,145
211608,CHEYNEY UNIVERSITY OF PENNSYLVANIA,1,0,1991,NA,NA,324,139,185,33,14,19,0.13,0.08,0.1,2838,22,82,7
211608,CHEYNEY UNIVERSITY OF PENNSYLVANIA,1,0,1992,NA,NA,375,184,191,19,2,17,0.09,0.01,0.05,2938,24,87,2
211608,CHEYNEY UNIVERSITY OF PENNSYLVANIA,1,0,1993,NA,NA,287,128,159,23,11,12,0.09,0.07,0.08,3319,23,96,2
211608,CHEYNEY UNIVERSITY OF PENNSYLVANIA,1,0,1995,NA,NA,256,131,125,20,5,15,0.11,0.04,0.08,3729,26,93,1
211608,CHEYNEY UNIVERSITY OF PENNSYLVANIA,1,0,1996,NA,NA,236,124,112,16,2,14,0.11,0.02,0.07,3922,27,93,0
211608,CHEYNEY UNIVERSITY OF PENNSYLVANIA,1,0,1997,NA,NA,236,122,114,18,4,14,0.11,0.04,0.08,4023,26,86,2
211608,CHEYNEY UNIVERSITY OF PENNSYLVANIA,1,0,1998,NA,NA,235,147,88,23,3,20,0.13,0.03,0.1,4023,28,90,1
211608,CHEYNEY UNIVERSITY OF PENNSYLVANIA,1,0,1999,NA,NA,254,152,102,37,9,28,0.18,0.09,0.15,3618,29,92,0
211608,CHEYNEY UNIVERSITY OF PENNSYLVANIA,1,0,2000,NA,NA,291,151,140,34,9,25,0.16,0.06,0.12,3792,33,91,0
211608,CHEYNEY UNIVERSITY OF PENNSYLVANIA,1,0,2001,NA,NA,292,146,146,32,7,25,0.17,0.05,0.11,4016,35,90,0
211608,CHEYNEY UNIVERSITY OF PENNSYLVANIA,1,0,2002,NA,NA,247,132,115,25,5,20,0.15,0.04,0.1,4378,33,94,1
211608,CHEYNEY UNIVERSITY OF PENNSYLVANIA,1,0,2003,NA,NA,378,208,170,51,13,38,0.18,0.08,0.13,4598,32,86,1
211608,CHEYNEY UNIVERSITY OF PENNSYLVANIA,1,0,2004,NA,NA,422,225,197,56,20,36,0.16,0.1,0.13,4810,34,93,0
211608,Cheyney University of Pennsylvania,1,0,2005,NA,NA,397,219,178,51,21,30,0.13,0.12,0.13,4906,37,91,3
211608,Cheyney University of Pennsylvania,1,0,2006,NA,NA,437,238,199,47,15,32,0.13,0.08,0.11,5038,42,95,1
211608,Cheyney University of Pennsylvania,1,0,2007,NA,NA,278,166,112,26,5,21,0.12,0.04,0.09,5177,42,89,1
211608,Cheyney University of Pennsylvania,1,0,2008,NA,NA,280,157,123,31,6,25,0.15,0.05,0.11,5358,46,78,2
211608,Cheyney University of Pennsylvania,1,0,2009,NA,NA,372,199,173,22,7,15,0.07,0.04,0.06,5554,46,76,2
211608,Cheyney University of Pennsylvania,1,0,2010,NA,NA,471,258,213,25,5,20,0.07,0.02,0.05,5804,44,79,7
211644,CLARION UNIVERSITY OF PENNSYLVANIA,1,0,1991,NA,NA,973,584,389,232,64,168,0.28,0.16,0.24,3147,57,348,923
211644,CLARION UNIVERSITY OF PENNSYLVANIA,1,0,1992,NA,NA,1093,679,414,246,60,186,0.27,0.14,0.23,3328,60,336,1037
211644,CLARION UNIVERSITY OF PENNSYLVANIA,1,0,1993,NA,NA,1081,650,431,246,70,176,0.27,0.16,0.23,3710,61,289,1035
211644,CLARION UNIVERSITY OF PENNSYLVANIA,1,0,1995,NA,NA,1241,768,473,210,46,164,0.21,0.1,0.17,4054,68,290,1156
211644,CLARION UNIVERSITY OF PENNSYLVANIA,1,0,1996,NA,NA,1215,711,504,284,79,205,0.28,0.16,0.23,4268,72,292,1141
211644,CLARION UNIVERSITY OF PENNSYLVANIA,1,0,1997,NA,NA,1220,751,469,294,84,210,0.27,0.18,0.24,4378,73,293,1145
211644,CLARION UNIVERSITY OF PENNSYLVANIA,1,0,1998,NA,NA,1191,717,474,250,64,186,0.25,0.14,0.21,4569,77,280,1110
211644,CLARION UNIVERSITY OF PENNSYLVANIA,1,0,1999,NA,NA,1286,806,480,295,80,215,0.26,0.17,0.23,3618,79,280,1194
211644,CLARION UNIVERSITY OF PENNSYLVANIA,1,0,2000,NA,NA,1305,813,492,330,99,231,0.28,0.2,0.25,3792,82,286,1191
211644,CLARION UNIVERSITY OF PENNSYLVANIA,1,0,2001,NA,NA,1286,814,472,313,82,231,0.28,0.17,0.24,4016,89,292,1176
211644,CLARION UNIVERSITY OF PENNSYLVANIA,1,0,2002,NA,NA,1249,745,504,367,117,250,0.33,0.23,0.29,4378,85,289,1144
211644,CLARION UNIVERSITY OF PENNSYLVANIA,1,0,2003,NA,NA,1219,729,490,366,113,253,0.34,0.23,0.3,4598,90,290,1125
211644,CLARION UNIVERSITY OF PENNSYLVANIA,1,0,2004,NA,NA,1203,683,520,296,103,193,0.28,0.2,0.25,4810,93,285,1071
211644,Clarion University of Pennsylvania,1,0,2005,NA,NA,1173,731,442,288,92,196,0.26,0.21,0.25,4906,92,261,1066
211644,Clarion University of Pennsylvania,1,0,2006,NA,NA,1295,758,537,323,110,213,0.28,0.2,0.25,5038,90,253,1173
211644,Clarion University of Pennsylvania,1,0,2007,NA,NA,1381,799,582,417,142,275,0.34,0.24,0.3,5176,93,242,1246
211644,Clarion University of Pennsylvania,1,0,2008,NA,NA,1305,747,558,355,116,239,0.31,0.21,0.27,5358,97,253,1134
211644,Clarion University of Pennsylvania,1,0,2009,NA,NA,1384,805,579,395,122,273,0.33,0.21,0.29,5554,105,254,1195
211644,Clarion University of Pennsylvania,1,0,2010,NA,NA,1309,811,498,430,127,303,0.37,0.26,0.33,5804,105,255,1117
211981,DELAWARE VALLEY COLLEGE OF SCIENCE AND AGRICULTURE,1,0,1991,NA,NA,332,140,192,98,43,55,0.39,0.22,0.3,10126,16,66,314
211981,DELAWARE VALLEY COLLEGE OF SCIENCE AND AGRICULTURE,1,0,1992,NA,NA,347,146,201,132,61,71,0.48,0.3,0.38,11090,17,64,326
211981,DELAWARE VALLEY COLLEGE OF SCIENCE AND AGRICULTURE,1,0,1993,NA,NA,435,212,223,142,65,77,0.36,0.29,0.33,11645,21,73,413
211981,DELAWARE VALLEY COLLEGE,1,0,1995,NA,NA,384,193,191,138,45,93,0.48,0.24,0.36,13208,27,77,363
211981,DELAWARE VALLEY COLLEGE,1,0,1996,NA,NA,385,177,208,149,67,82,0.46,0.32,0.39,13708,30,82,353
211981,DELAWARE VALLEY COLLEGE,1,0,1997,NA,NA,407,185,222,149,58,91,0.49,0.26,0.37,14256,24,78,372
211981,DELAWARE VALLEY COLLEGE,1,0,1998,NA,NA,400,203,197,172,70,102,0.5,0.36,0.43,14826,25,77,380
211981,DELAWARE VALLEY COLLEGE,1,0,1999,NA,NA,327,172,155,109,41,68,0.39,0.26,0.33,15300,26,80,292
211981,DELAWARE VALLEY COLLEGE,1,0,2000,NA,NA,380,188,192,160,63,97,0.51,0.33,0.42,16148,27,78,339
211981,DELAWARE VALLEY COLLEGE,1,0,2001,NA,NA,355,157,198,126,53,73,0.46,0.27,0.35,16874,28,77,311
211981,DELAWARE VALLEY COLLEGE,1,0,2002,NA,NA,406,204,202,159,59,100,0.49,0.29,0.39,17680,29,76,366
211981,DELAWARE VALLEY COLLEGE,1,0,2003,NA,NA,438,198,240,164,70,94,0.47000000000000003,0.29,0.37,18654,29,76,316
211981,DELAWARE VALLEY COLLEGE,1,0,2004,NA,NA,450,257,193,186,48,138,0.53,0.25,0.41,19588,30,79,389
211981,Delaware Valley College,1,0,2005,NA,NA,448,271,177,206,54,152,0.56,0.31,0.46,20664,34,78,384
211981,Delaware Valley College,1,0,2006,NA,NA,447,264,183,220,68,152,0.5700000000000001,0.37,0.49,21800,38,81,389
211981,Delaware Valley College,1,0,2007,NA,NA,475,270,205,221,79,142,0.52,0.39,0.47,23110,41,83,433
211981,Delaware Valley College,1,0,2008,NA,NA,429,253,176,220,78,142,0.56,0.44,0.51,24728,44,84,380
211981,Delaware Valley College,1,0,2009,NA,NA,452,252,200,227,74,153,0.6,0.37,0.5,25692,45,82,395
211981,Delaware Valley College,1,0,2010,NA,NA,490,297,193,238,66,172,0.5700000000000001,0.34,0.49,27234,46,82,429
212009,DICKINSON COLLEGE,1,0,1991,NA,NA,557,317,240,433,184,249,0.78,0.77,0.78,15565,48,143,513
212009,DICKINSON COLLEGE,1,0,1992,NA,NA,569,342,227,428,178,250,0.73,0.78,0.75,16760,52,145,519
212009,DICKINSON COLLEGE,1,0,1993,NA,NA,482,277,205,330,124,206,0.74,0.6,0.68,17775,56,144,441
212009,DICKINSON COLLEGE,1,0,1995,NA,NA,520,286,234,393,174,219,0.76,0.74,0.76,19750,59,147,468
212009,DICKINSON COLLEGE,1,0,1996,NA,NA,491,264,227,371,168,203,0.76,0.74,0.76,20750,61,137,445
212009,DICKINSON COLLEGE,1,0,1997,NA,NA,563,354,209,429,148,281,0.79,0.71,0.76,21600,62,149,523
212009,DICKINSON COLLEGE,1,0,1998,NA,NA,541,334,207,417,155,262,0.78,0.75,0.77,22600,72,147,513
212009,DICKINSON COLLEGE,1,0,1999,NA,NA,620,399,221,505,178,327,0.81,0.81,0.81,23120,57,156,577
212009,DICKINSON COLLEGE,1,0,2000,NA,NA,594,340,254,464,188,276,0.81,0.74,0.78,24050,63,158,550
212009,DICKINSON COLLEGE,1,0,2001,NA,NA,611,321,290,484,218,266,0.8200000000000001,0.75,0.79,25250,67,160,559
212009,DICKINSON COLLEGE,1,0,2002,NA,NA,572,328,244,459,185,274,0.8300000000000001,0.76,0.8,26400,72,176,501
212009,DICKINSON COLLEGE,1,0,2003,NA,NA,624,356,268,496,205,291,0.81,0.76,0.79,28380,78,188,541
212009,DICKINSON COLLEGE,1,0,2004,NA,NA,605,329,276,472,197,275,0.8300000000000001,0.71,0.78,30000,85,196,489
212009,Dickinson College,1,0,2005,NA,NA,647,359,288,530,227,303,0.84,0.79,0.82,31800,88,192,511
212009,Dickinson College,1,0,2006,NA,NA,617,360,257,499,199,300,0.8300000000000001,0.77,0.81,33470,92,202,477
212009,Dickinson College,1,0,2007,NA,NA,619,319,300,515,237,278,0.87,0.79,0.83,35450,96,211,483
212009,Dickinson College,1,0,2008,NA,NA,613,337,276,495,204,291,0.86,0.74,0.81,37900,102,209,467
212009,Dickinson College,1,0,2009,NA,NA,581,340,241,472,191,281,0.8200000000000001,0.79,0.81,39780,108,208,462
212009,Dickinson College,1,0,2010,NA,NA,657,355,302,535,240,295,0.8300000000000001,0.79,0.81,41170,107,210,504
212054,DREXEL UNIVERSITY,0,1,1991,Inf,0,1207,364,843,115,31,84,0.23,0.04,0.1,10860,132,429,823
212054,DREXEL UNIVERSITY,0,1,1992,Inf,0,1054,340,714,94,30,64,0.18,0.04,0.09,11635,135,361,721
212054,DREXEL UNIVERSITY,0,1,1993,Inf,0,1126,383,743,86,27,59,0.15,0.04,0.08,12326,138,286,709
212054,DREXEL UNIVERSITY,0,1,1995,Inf,0,935,341,594,111,40,71,0.2,0.07,0.12,13844,137,294,629
212054,DREXEL UNIVERSITY,0,1,1996,Inf,0,1348,476,872,172,76,96,0.2,0.09,0.13,14472,146,285,894
212054,DREXEL UNIVERSITY,0,1,1997,Inf,0,1776,729,1047,231,73,158,0.21,0.07,0.13,14036,146,388,1027
212054,DREXEL UNIVERSITY,0,1,1998,Inf,0,2087,792,1295,247,73,174,0.21,0.06,0.12,15574,164,395,1350
212054,DREXEL UNIVERSITY,0,1,1999,Inf,0,1898,725,1173,269,94,175,0.24,0.08,0.14,15240,184,449,1257
212054,DREXEL UNIVERSITY,0,1,2000,Inf,0,2125,810,1315,275,97,178,0.21,0.07,0.13,15927,198,467,1317
212054,DREXEL UNIVERSITY,0,1,2001,Inf,0,1934,759,1175,313,124,189,0.24,0.11,0.16,16644,218,485,1117
212054,DREXEL UNIVERSITY,0,1,2002,Inf,0,1937,709,1228,374,150,224,0.31,0.12,0.19,17393,476,683,1394
212054,DREXEL UNIVERSITY,0,1,2003,Inf,0,1980,768,1212,486,176,310,0.4,0.15,0.25,19700,513,656,1433
212054,DREXEL UNIVERSITY,0,1,2004,Inf,0,2069,732,1337,477,193,284,0.38,0.14,0.23,20800,535,689,1514
212054,Drexel University,0,1,2005,Inf,0,2346,916,1430,663,274,389,0.42,0.19,0.28,21700,543,719,1530
212054,Drexel University,0,1,2006,Inf,0,2256,930,1326,598,219,379,0.4,0.17,0.27,26000,584,778,1526
212054,Drexel University,0,1,2007,Inf,0,2260,945,1315,640,254,386,0.4,0.19,0.28,27200,633,826,1461
212054,Drexel University,0,1,2008,Inf,0,2402,992,1410,579,206,373,0.37,0.15,0.24,28500,687,870,1468
212054,Drexel University,0,1,2009,Inf,0,2268,898,1370,516,209,307,0.34,0.15,0.23,29800,746,928,1253
212054,Drexel University,0,1,2010,Inf,0,2696,1200,1496,735,275,460,0.38,0.18,0.27,30900,782,977,1616
212106,DUQUESNE UNIVERSITY,1,0,1991,NA,NA,870,475,395,381,166,215,0.45,0.42,0.44,9750,78,304,812
212106,DUQUESNE UNIVERSITY,1,0,1992,NA,NA,1026,588,438,441,165,276,0.46,0.38,0.43,10470,88,323,925
212106,DUQUESNE UNIVERSITY,1,0,1993,NA,NA,971,547,424,418,182,236,0.43,0.43,0.43,11328,97,336,848
212106,DUQUESNE UNIVERSITY,1,0,1995,NA,NA,1215,703,512,523,193,330,0.46,0.38,0.43,12578,119,343,1055
212106,DUQUESNE UNIVERSITY,1,0,1996,NA,NA,1196,690,506,558,204,354,0.51,0.4,0.47,13396,137,344,957
212106,DUQUESNE UNIVERSITY,1,0,1997,NA,NA,1211,716,495,599,225,374,0.52,0.45,0.49,14066,113,379,951
212106,DUQUESNE UNIVERSITY,1,0,1998,NA,NA,1253,771,482,615,210,405,0.52,0.44,0.49,14699,122,369,1027
212106,DUQUESNE UNIVERSITY,1,0,1999,NA,NA,1211,686,525,590,216,374,0.54,0.41,0.49,14378,135,376,996
212106,DUQUESNE UNIVERSITY,1,0,2000,NA,NA,1257,733,524,650,243,407,0.55,0.46,0.52,15169,143,383,1091
212106,DUQUESNE UNIVERSITY,1,0,2001,NA,NA,1176,684,492,596,219,377,0.55,0.45,0.51,16049,148,390,1038
212106,DUQUESNE UNIVERSITY,1,0,2002,NA,NA,1429,875,554,748,253,495,0.56,0.46,0.52,17012,157,388,1253
212106,DUQUESNE UNIVERSITY,1,0,2003,NA,NA,1485,899,586,774,283,491,0.54,0.48,0.52,17837,167,407,1258
212106,DUQUESNE UNIVERSITY,1,0,2004,NA,NA,1208,700,508,656,251,405,0.5700000000000001,0.49,0.54,18693,177,428,1017
212106,Duquesne University,1,0,2005,NA,NA,1325,811,514,711,244,467,0.5700000000000001,0.47,0.54,19721,187,429,1156
212106,Duquesne University,1,0,2006,NA,NA,1321,779,542,700,268,432,0.55,0.49,0.53,20855,202,442,1168
212106,Duquesne University,1,0,2007,NA,NA,1354,785,569,796,307,489,0.62,0.54,0.59,22054,211,447,1204
212106,Duquesne University,1,0,2008,NA,NA,1425,838,587,801,308,493,0.58,0.52,0.56,23470,224,463,1270
212106,Duquesne University,1,0,2009,NA,NA,1425,814,611,787,296,491,0.6,0.48,0.55,24385,235,472,1221
212106,Duquesne University,1,0,2010,NA,NA,1411,821,590,834,318,516,0.62,0.54,0.59,25336,239,480,1221
212115,EAST STROUDSBURG UNIVERSITY OF PENNSYLVANIA,1,0,1991,NA,NA,699,382,317,129,31,98,0.25,0.1,0.18,3088,45,249,636
212115,EAST STROUDSBURG UNIVERSITY OF PENNSYLVANIA,1,0,1992,NA,NA,628,368,260,143,39,104,0.28,0.15,0.23,3352,48,239,581
212115,EAST STROUDSBURG UNIVERSITY OF PENNSYLVANIA,1,0,1993,NA,NA,799,446,353,161,39,122,0.27,0.11,0.2,3664,51,234,733
212115,EAST STROUDSBURG UNIVERSITY OF PENNSYLVANIA,1,0,1995,NA,NA,820,457,363,169,45,124,0.27,0.12,0.21,4016,57,233,776
212115,EAST STROUDSBURG UNIVERSITY OF PENNSYLVANIA,1,0,1996,NA,NA,872,499,373,198,50,148,0.29,0.13,0.23,4194,61,233,808
212115,EAST STROUDSBURG UNIVERSITY OF PENNSYLVANIA,1,0,1997,NA,NA,886,532,354,166,34,132,0.24,0.1,0.19,4322,62,227,799
212115,EAST STROUDSBURG UNIVERSITY OF PENNSYLVANIA,1,0,1998,NA,NA,856,475,381,182,53,129,0.27,0.14,0.21,4314,66,235,767
212115,EAST STROUDSBURG UNIVERSITY OF PENNSYLVANIA,1,0,1999,NA,NA,843,522,321,163,42,121,0.23,0.13,0.19,3618,69,237,744
212115,EAST STROUDSBURG UNIVERSITY OF PENNSYLVANIA,1,0,2000,NA,NA,878,522,356,193,57,136,0.26,0.16,0.22,3792,72,241,791
212115,EAST STROUDSBURG UNIVERSITY OF PENNSYLVANIA,1,0,2001,NA,NA,969,564,405,259,66,193,0.34,0.16,0.27,4016,76,246,880
212115,EAST STROUDSBURG UNIVERSITY OF PENNSYLVANIA,1,0,2002,NA,NA,1123,587,536,314,100,214,0.36,0.19,0.28,4378,76,249,1020
212115,EAST STROUDSBURG UNIVERSITY OF PENNSYLVANIA,1,0,2003,NA,NA,1076,650,426,394,107,287,0.44,0.25,0.37,4598,83,245,993
212115,EAST STROUDSBURG UNIVERSITY OF PENNSYLVANIA,1,0,2004,NA,NA,1165,709,456,420,122,298,0.42,0.27,0.36,4810,84,255,1059
212115,East Stroudsburg University of Pennsylvania,1,0,2005,NA,NA,1087,634,453,392,110,282,0.44,0.24,0.36,4906,84,267,1001
212115,East Stroudsburg University of Pennsylvania,1,0,2006,NA,NA,1239,716,523,454,147,307,0.42,0.28,0.37,5038,89,280,975
212115,East Stroudsburg University of Pennsylvania,1,0,2007,NA,NA,1183,612,571,422,156,266,0.43,0.27,0.36,5178,97,285,922
212115,East Stroudsburg University of Pennsylvania,1,0,2008,NA,NA,1262,655,607,458,167,291,0.44,0.28,0.36,5358,101,306,945
212115,East Stroudsburg University of Pennsylvania,1,0,2009,NA,NA,1342,737,605,466,167,299,0.4,0.28,0.35,5554,111,305,955
212115,East Stroudsburg University of Pennsylvania,1,0,2010,NA,NA,1144,658,486,422,137,285,0.43,0.28,0.37,5804,116,301,899
212133,EASTERN COLLEGE,1,0,1991,NA,NA,134,87,47,55,16,39,0.44,0.34,0.41,9525,12,41,97
212133,EASTERN COLLEGE,1,0,1992,NA,NA,183,130,53,82,20,62,0.47000000000000003,0.38,0.45,9875,14,48,146
212133,EASTERN COLLEGE,1,0,1993,NA,NA,162,113,49,76,22,54,0.47000000000000003,0.45,0.47,10620,17,57,126
212133,EASTERN COLLEGE,1,0,1995,NA,NA,226,171,55,103,21,82,0.47000000000000003,0.38,0.46,11780,22,61,179
212133,EASTERN COLLEGE,1,0,1996,NA,NA,245,168,77,138,34,104,0.61,0.44,0.56,12250,24,59,197
212133,EASTERN COLLEGE,1,0,1997,NA,NA,305,211,94,171,40,131,0.62,0.43,0.56,12735,25,65,259
212133,EASTERN COLLEGE,1,0,1998,NA,NA,317,220,97,168,48,120,0.54,0.49,0.53,13235,27,70,254
212133,EASTERN COLLEGE,1,0,1999,NA,NA,379,274,105,190,41,149,0.54,0.39,0.5,13728,31,74,346
212133,EASTERN COLLEGE,1,0,2000,NA,NA,400,279,121,229,60,169,0.6,0.5,0.57,14560,35,80,346
212133,EASTERN UNIVERSITY,1,0,2001,NA,NA,427,287,140,216,69,147,0.51,0.49,0.51,15150,42,87,342
212133,EASTERN UNIVERSITY,1,0,2002,NA,NA,405,288,117,211,49,162,0.56,0.42,0.52,15832,46,85,322
212133,EASTERN UNIVERSITY,1,0,2003,NA,NA,438,298,140,242,74,168,0.56,0.53,0.55,16780,47,82,355
212133,EASTERN UNIVERSITY,1,0,2004,NA,NA,450,294,156,243,82,161,0.54,0.53,0.54,17700,49,91,360
212133,Eastern University,1,0,2005,NA,NA,445,300,145,239,70,169,0.56,0.48,0.54,18830,58,114,350
212133,Eastern University,1,0,2006,NA,NA,494,336,158,230,70,160,0.47000000000000003,0.44,0.47,20030,64,126,377
212133,Eastern University,1,0,2007,NA,NA,483,319,164,206,58,148,0.46,0.35,0.43,21350,70,126,318
212133,Eastern University,1,0,2008,NA,NA,550,367,183,233,68,165,0.44,0.37,0.42,22670,75,128,342
212133,Eastern University,1,0,2009,NA,NA,489,318,171,213,61,152,0.47000000000000003,0.36,0.44,23770,82,139,328
212133,Eastern University,1,0,2010,NA,NA,449,302,147,195,67,128,0.42,0.46,0.43,24550,85,146,264
212160,EDINBORO UNIVERSITY OF PENNSYLVANIA,1,0,1991,NA,NA,1456,853,603,243,65,178,0.2,0.11,0.17,3013,63,416,1302
212160,EDINBORO UNIVERSITY OF PENNSYLVANIA,1,0,1992,NA,NA,1500,857,643,257,75,182,0.21,0.12,0.17,3161,69,399,1375
212160,EDINBORO UNIVERSITY OF PENNSYLVANIA,1,0,1993,NA,NA,1315,763,552,221,65,156,0.2,0.12,0.17,3531,72,392,1209
212160,EDINBORO UNIVERSITY OF PENNSYLVANIA,1,0,1995,NA,NA,1332,763,569,213,69,144,0.18,0.12,0.16,3924,77,390,1186
212160,EDINBORO UNIVERSITY OF PENNSYLVANIA,1,0,1996,NA,NA,1250,707,543,214,69,145,0.2,0.13,0.17,4082,78,391,1160
212160,EDINBORO UNIVERSITY OF PENNSYLVANIA,1,0,1997,NA,NA,1251,729,522,234,63,171,0.23,0.12,0.19,4192,79,383,1143
212160,EDINBORO UNIVERSITY OF PENNSYLVANIA,1,0,1998,NA,NA,1205,691,514,210,54,156,0.22,0.11,0.17,3468,84,368,1107
212160,EDINBORO UNIVERSITY OF PENNSYLVANIA,1,0,1999,NA,NA,1256,749,507,227,48,179,0.23,0.09,0.18,3618,86,381,1139
212160,EDINBORO UNIVERSITY OF PENNSYLVANIA,1,0,2000,NA,NA,1304,731,573,297,88,209,0.28,0.15,0.23,3792,88,365,1160
212160,EDINBORO UNIVERSITY OF PENNSYLVANIA,1,0,2001,NA,NA,1409,831,578,323,99,224,0.26,0.17,0.23,4016,94,350,1228
212160,EDINBORO UNIVERSITY OF PENNSYLVANIA,1,0,2002,NA,NA,1372,788,584,297,86,211,0.26,0.15,0.22,4378,91,351,1204
212160,EDINBORO UNIVERSITY OF PENNSYLVANIA,1,0,2003,NA,NA,1392,818,574,304,103,201,0.24,0.18,0.22,4598,90,343,1219
212160,EDINBORO UNIVERSITY OF PENNSYLVANIA,1,0,2004,NA,NA,1232,712,520,272,81,191,0.26,0.16,0.22,4810,90,356,1062
212160,Edinboro University of Pennsylvania,1,0,2005,NA,NA,1268,719,549,297,82,215,0.29,0.15,0.23,4906,92,346,1104
212160,Edinboro University of Pennsylvania,1,0,2006,NA,NA,1212,671,541,230,63,167,0.24,0.12,0.19,5038,96,346,1036
212160,Edinboro University of Pennsylvania,1,0,2007,NA,NA,1243,707,536,239,75,164,0.23,0.14,0.19,5177,100,322,1005
212160,Edinboro University of Pennsylvania,1,0,2008,NA,NA,1219,697,522,245,77,168,0.24,0.15,0.2,5358,106,325,1041
212160,Edinboro University of Pennsylvania,1,0,2009,NA,NA,1407,803,604,266,82,184,0.22,0.14,0.19,5554,110,336,1221
212160,Edinboro University of Pennsylvania,1,0,2010,NA,NA,1551,927,624,340,103,237,0.25,0.17,0.22,5804,112,341,1337
212197,ELIZABETHTOWN COLLEGE,1,0,1991,NA,NA,455,309,146,265,78,187,0.6,0.53,0.58,11650,27,110,427
212197,ELIZABETHTOWN COLLEGE,1,0,1992,NA,NA,442,318,124,256,52,204,0.64,0.42,0.58,12550,29,105,429
212197,ELIZABETHTOWN COLLEGE,1,0,1993,NA,NA,424,276,148,270,76,194,0.7000000000000001,0.51,0.64,13600,31,105,412
212197,ELIZABETHTOWN COLLEGE,1,0,1995,NA,NA,434,307,127,282,72,210,0.68,0.57,0.65,15490,36,104,411
212197,ELIZABETHTOWN COLLEGE,1,0,1996,NA,NA,429,295,134,263,73,190,0.64,0.54,0.61,15890,39,100,403
212197,ELIZABETHTOWN COLLEGE,1,0,1997,NA,NA,438,298,140,265,74,191,0.64,0.53,0.61,16680,30,100,409
212197,ELIZABETHTOWN COLLEGE,1,0,1998,NA,NA,422,271,151,265,87,178,0.65,0.58,0.63,17500,32,101,400
212197,ELIZABETHTOWN COLLEGE,1,0,1999,NA,NA,477,298,179,277,102,175,0.58,0.57,0.58,17770,33,103,438
212197,ELIZABETHTOWN COLLEGE,1,0,2000,NA,NA,474,318,156,310,98,212,0.66,0.63,0.65,19100,34,108,436
212197,ELIZABETHTOWN COLLEGE,1,0,2001,NA,NA,514,319,195,326,116,210,0.65,0.59,0.63,20200,37,114,482
212197,ELIZABETHTOWN COLLEGE,1,0,2002,NA,NA,456,304,152,293,85,208,0.68,0.56,0.64,21350,39,120,418
212197,ELIZABETHTOWN COLLEGE,1,0,2003,NA,NA,495,326,169,328,100,228,0.6900000000000001,0.59,0.66,22500,40,118,458
212197,ELIZABETHTOWN COLLEGE,1,0,2004,NA,NA,535,344,191,385,125,260,0.75,0.65,0.72,23710,44,120,508
212197,Elizabethtown College,1,0,2005,NA,NA,500,337,163,356,104,252,0.74,0.64,0.71,25200,48,125,466
212197,Elizabethtown College,1,0,2006,NA,NA,528,345,183,372,125,247,0.71,0.68,0.7,26950,52,126,497
212197,Elizabethtown College,1,0,2007,NA,NA,487,324,163,344,113,231,0.71,0.69,0.71,29000,54,130,446
212197,Elizabethtown College,1,0,2008,NA,NA,508,331,177,328,114,214,0.64,0.64,0.65,30650,58,129,457
212197,Elizabethtown College,1,0,2009,NA,NA,544,340,204,391,133,258,0.75,0.65,0.72,31800,60,125,489
212197,Elizabethtown College,1,0,2010,NA,NA,491,303,188,339,104,235,0.77,0.55,0.69,33250,61,130,426
212577,FRANKLIN AND MARSHALL COLLEGE,1,0,1991,NA,NA,504,228,276,355,173,182,0.79,0.63,0.7,16385,44,148,398
212577,FRANKLIN AND MARSHALL COLLEGE,1,0,1992,NA,NA,486,222,264,351,182,169,0.76,0.69,0.72,22370,47,146,385
212577,FRANKLIN AND MARSHALL COLLEGE,1,0,1993,NA,NA,507,229,278,364,190,174,0.75,0.68,0.72,23655,51,152,387
212577,FRANKLIN AND MARSHALL COLLEGE,1,0,1995,NA,NA,498,234,264,372,179,193,0.8200000000000001,0.68,0.75,21350,56,160,406
212577,FRANKLIN AND MARSHALL COLLEGE,1,0,1996,NA,NA,522,272,250,408,175,233,0.85,0.7,0.78,21990,67,158,430
212577,FRANKLIN AND MARSHALL COLLEGE,1,0,1997,NA,NA,504,251,253,402,202,200,0.79,0.8,0.8,22714,47,155,410
212577,FRANKLIN AND MARSHALL COLLEGE,1,0,1998,NA,NA,502,257,245,394,175,219,0.85,0.71,0.78,23214,51,158,399
212577,FRANKLIN AND MARSHALL COLLEGE,1,0,1999,NA,NA,515,253,262,387,181,206,0.81,0.69,0.75,23720,55,161,443
212577,FRANKLIN AND MARSHALL COLLEGE,1,0,2000,NA,NA,510,251,259,382,179,203,0.8,0.69,0.75,24816,58,164,421
212577,FRANKLIN AND MARSHALL COLLEGE,1,0,2001,NA,NA,510,248,262,401,190,211,0.85,0.73,0.79,26060,61,168,410
212577,FRANKLIN AND MARSHALL COLLEGE,1,0,2002,NA,NA,534,248,286,388,189,199,0.8,0.66,0.73,27230,62,184,403
212577,FRANKLIN AND MARSHALL COLLEGE,1,0,2003,NA,NA,503,233,270,398,198,200,0.85,0.73,0.79,28810,68,183,379
212577,FRANKLIN AND MARSHALL COLLEGE,1,0,2004,NA,NA,529,241,288,424,219,205,0.85,0.76,0.8,30390,71,180,422
212577,Franklin and Marshall College,1,0,2005,NA,NA,581,298,283,468,211,257,0.86,0.75,0.81,32480,77,194,447
212577,Franklin and Marshall College,1,0,2006,NA,NA,523,274,249,413,196,217,0.79,0.79,0.79,34400,84,200,321
212577,Franklin and Marshall College,1,0,2007,NA,NA,569,301,268,477,214,263,0.87,0.8,0.84,36430,88,201,417
212577,Franklin and Marshall College,1,0,2008,NA,NA,588,321,267,485,210,275,0.85,0.79,0.82,38580,96,206,443
212577,Franklin and Marshall College,1,0,2009,NA,NA,629,334,295,511,229,282,0.84,0.78,0.81,39930,105,223,475
212577,Franklin and Marshall College,1,0,2010,NA,NA,629,345,284,525,227,298,0.86,0.8,0.83,41090,106,233,473
212601,GANNON UNIVERSITY,1,0,1991,NA,NA,465,264,201,186,79,107,0.4,0.39,0.4,8719,43,185,440
212601,GANNON UNIVERSITY,1,0,1992,NA,NA,406,244,162,152,54,98,0.4,0.33,0.37,9198,47,182,383
212601,GANNON UNIVERSITY,1,0,1993,NA,NA,450,257,193,177,79,98,0.38,0.41,0.39,9842,48,171,427
212601,GANNON UNIVERSITY,1,0,1995,NA,NA,394,225,169,174,73,101,0.44,0.43,0.44,11114,49,169,369
212601,GANNON UNIVERSITY,1,0,1996,NA,NA,504,305,199,229,72,157,0.51,0.36,0.45,11694,50,157,474
212601,GANNON UNIVERSITY,1,0,1997,NA,NA,533,318,215,244,74,170,0.53,0.34,0.46,12264,35,146,503
212601,GANNON UNIVERSITY,1,0,1998,NA,NA,608,360,248,282,95,187,0.51,0.38,0.46,12744,35,150,556
212601,GANNON UNIVERSITY,1,0,1999,NA,NA,503,314,189,246,67,179,0.5700000000000001,0.35,0.49,13820,38,157,476
212601,GANNON UNIVERSITY,1,0,2000,NA,NA,563,327,236,257,87,170,0.51,0.37,0.46,13670,39,158,524
212601,GANNON UNIVERSITY,1,0,2001,NA,NA,525,313,212,244,83,161,0.51,0.39,0.46,14490,45,160,479
212601,GANNON UNIVERSITY,1,0,2002,NA,NA,536,311,225,255,80,175,0.56,0.36,0.48,15330,47,165,496
212601,GANNON UNIVERSITY,1,0,2003,NA,NA,587,339,248,246,91,155,0.45,0.37,0.42,16220,49,164,539
212601,GANNON UNIVERSITY,1,0,2004,NA,NA,522,317,205,248,84,164,0.51,0.41,0.48,17550,52,169,458
212601,Gannon University,1,0,2005,NA,NA,619,375,244,292,104,188,0.5,0.43,0.47,18775,54,175,558
212601,Gannon University,1,0,2006,NA,NA,600,352,248,280,97,183,0.51,0.39,0.47,20090,53,175,529
212601,Gannon University,1,0,2007,NA,NA,610,365,245,276,96,180,0.49,0.39,0.45,21480,54,184,509
212601,Gannon University,1,0,2008,NA,NA,620,367,253,289,106,183,0.49,0.42,0.47,22830,60,193,544
212601,Gannon University,1,0,2009,NA,NA,648,382,266,310,106,204,0.53,0.4,0.48,23745,64,196,523
212601,Gannon University,1,0,2010,NA,NA,617,362,255,276,100,176,0.48,0.39,0.45,24765,65,192,503
212832,GWYNEDD-MERCY COLLEGE,1,0,1991,NA,NA,89,79,10,25,1,24,0.3,0.1,0.28,8600,12,93,70
212832,GWYNEDD-MERCY COLLEGE,1,0,1992,NA,NA,89,72,17,34,2,32,0.44,0.12,0.38,10150,13,96,77
212832,GWYNEDD-MERCY COLLEGE,1,0,1993,NA,NA,86,74,12,32,2,30,0.4,0.17,0.37,10960,14,98,68
212832,GWYNEDD-MERCY COLLEGE,1,0,1995,NA,NA,40,35,5,16,0,16,0.45,0,0.4,12017,17,91,33
212832,GWYNEDD-MERCY COLLEGE,1,0,1996,NA,NA,44,32,12,16,3,13,0.4,0.25,0.36,12650,16,91,36
212832,GWYNEDD MERCY COLLEGE,1,0,1997,NA,NA,65,54,11,26,4,22,0.4,0.36,0.4,13180,16,85,50
212832,GWYNEDD MERCY COLLEGE,1,0,1998,NA,NA,143,100,43,44,9,35,0.35000000000000003,0.21,0.31,13710,18,78,129
212832,GWYNEDD MERCY COLLEGE,1,0,1999,NA,NA,146,114,32,56,13,43,0.37,0.41,0.38,13500,19,74,131
212832,GWYNEDD MERCY COLLEGE,1,0,2000,NA,NA,179,141,38,70,10,60,0.42,0.26,0.39,14400,21,69,156
212832,GWYNEDD MERCY COLLEGE,1,0,2001,NA,NA,176,140,36,85,15,70,0.5,0.42,0.48,15100,22,65,158
212832,GWYNEDD MERCY COLLEGE,1,0,2002,NA,NA,261,211,50,62,18,44,0.2,0.36,0.24,15600,21,72,215
212832,GWYNEDD MERCY COLLEGE,1,0,2003,NA,NA,322,245,77,105,26,79,0.32,0.34,0.33,16200,23,77,281
212832,GWYNEDD MERCY COLLEGE,1,0,2004,NA,NA,280,218,62,87,23,64,0.29,0.37,0.31,16900,26,80,261
212832,Gwynedd Mercy College,1,0,2005,NA,NA,280,210,70,21,15,6,0.02,0.21,0.07,17580,28,78,226
212832,Gwynedd Mercy College,1,0,2006,NA,NA,272,202,70,54,19,35,0.17,0.27,0.2,18720,31,81,218
212832,Gwynedd Mercy College,1,0,2007,NA,NA,291,208,83,58,23,35,0.16,0.28,0.2,20500,32,82,256
212832,Gwynedd Mercy College,1,0,2008,NA,NA,339,223,116,56,23,33,0.14,0.2,0.17,22340,32,81,284
212832,Gwynedd Mercy College,1,0,2009,NA,NA,313,214,99,47,18,29,0.13,0.18,0.15,23730,32,75,224
212832,Gwynedd Mercy College,1,0,2010,NA,NA,284,190,94,38,13,25,0.13,0.14,0.13,25160,33,76,218
212911,HAVERFORD COLLEGE,1,0,1991,NA,NA,295,147,148,256,124,132,0.89,0.84,0.87,16150,31,91,239
212911,HAVERFORD COLLEGE,1,0,1992,NA,NA,301,145,156,253,132,121,0.8300000000000001,0.85,0.84,17125,33,95,244
212911,HAVERFORD COLLEGE,1,0,1993,NA,NA,292,143,149,243,122,121,0.84,0.82,0.83,18000,35,95,247
212911,HAVERFORD COLLEGE,1,0,1995,NA,NA,306,162,144,269,126,143,0.88,0.88,0.88,20075,39,97,267
212911,HAVERFORD COLLEGE,1,0,1996,NA,NA,313,172,141,267,116,151,0.87,0.82,0.85,20890,42,95,253
212911,HAVERFORD COLLEGE,1,0,1997,NA,NA,298,150,148,264,127,137,0.91,0.86,0.89,21740,39,96,229
212911,HAVERFORD COLLEGE,1,0,1998,NA,NA,322,170,152,277,130,147,0.86,0.86,0.86,22860,41,97,267
212911,HAVERFORD COLLEGE,1,0,1999,NA,NA,301,160,141,244,113,131,0.81,0.8,0.81,23556,43,102,222
212911,HAVERFORD COLLEGE,1,0,2000,NA,NA,334,181,153,305,140,165,0.91,0.92,0.91,24706,46,102,237
212911,HAVERFORD COLLEGE,1,0,2001,NA,NA,296,154,142,256,120,136,0.88,0.85,0.86,25826,50,103,199
212911,HAVERFORD COLLEGE,1,0,2002,NA,NA,312,168,144,283,128,155,0.92,0.89,0.91,27006,55,112,221
212911,HAVERFORD COLLEGE,1,0,2003,NA,NA,313,164,149,275,132,143,0.87,0.89,0.88,28612,59,108,236
212911,HAVERFORD COLLEGE,1,0,2004,NA,NA,330,179,151,291,130,161,0.89,0.86,0.88,29990,61,110,226
212911,Haverford College,1,0,2005,NA,NA,316,168,148,287,131,156,0.92,0.89,0.91,31466,63,111,225
212911,Haverford College,1,0,2006,NA,NA,314,174,140,281,123,158,0.9,0.88,0.89,33394,68,123,214
212911,Haverford College,1,0,2007,NA,NA,315,169,146,287,131,156,0.92,0.9,0.91,35058,74,121,215
212911,Haverford College,1,0,2008,NA,NA,327,182,145,287,124,163,0.89,0.86,0.88,37175,77,128,234
212911,Haverford College,1,0,2009,NA,NA,323,186,137,275,121,154,0.8200000000000001,0.88,0.85,38735,81,127,232
212911,Haverford College,1,0,2010,NA,NA,325,166,159,281,138,143,0.86,0.87,0.86,40260,77,139,215
213020,INDIANA UNIVERSITY OF PENNSYLVANIA,1,0,1991,NA,NA,2516,1452,1064,604,180,424,0.29,0.17,0.24,2980,133,649,2181
213020,INDIANA UNIVERSITY OF PENNSYLVANIA,1,0,1992,NA,NA,2423,1423,1000,665,197,468,0.32,0.2,0.27,3157,146,656,2123
213020,INDIANA UNIVERSITY OF PENNSYLVANIA,1,0,1993,NA,NA,2366,1365,1001,495,154,341,0.24,0.15,0.21,3539,144,658,2131
213020,INDIANA UNIVERSITY OF PENNSYLVANIA,1,0,1995,NA,NA,2661,1552,1109,652,187,465,0.29,0.17,0.25,3891,163,675,2470
213020,INDIANA UNIVERSITY OF PENNSYLVANIA,1,0,1996,NA,NA,2617,1493,1124,613,163,450,0.3,0.15,0.23,4064,163,680,2431
213020,INDIANA UNIVERSITY OF PENNSYLVANIA,1,0,1997,NA,NA,2620,1479,1141,618,176,442,0.29,0.15,0.24,4204,165,692,2399
213020,INDIANA UNIVERSITY OF PENNSYLVANIA,1,0,1998,NA,NA,2757,1643,1114,661,161,500,0.3,0.14,0.24,4244,173,688,2484
213020,INDIANA UNIVERSITY OF PENNSYLVANIA-MAIN CAMPUS,1,0,1999,NA,NA,2552,1468,1084,561,165,396,0.26,0.15,0.22,3618,183,671,2203
213020,INDIANA UNIVERSITY OF PENNSYLVANIA-MAIN CAMPUS,1,0,2000,NA,NA,2776,1607,1169,605,167,438,0.27,0.14,0.22,3792,182,660,2473
213020,INDIANA UNIVERSITY OF PENNSYLVANIA-MAIN CAMPUS,1,0,2001,NA,NA,2557,1460,1097,624,190,434,0.29,0.17,0.24,4016,191,649,2261
213020,INDIANA UNIVERSITY OF PENNSYLVANIA-MAIN CAMPUS,1,0,2002,NA,NA,2666,1536,1130,697,207,490,0.31,0.18,0.26,4378,192,634,2338
213020,INDIANA UNIVERSITY OF PENNSYLVANIA-MAIN CAMPUS,1,0,2003,NA,NA,2847,1669,1178,822,242,580,0.34,0.21,0.29,4598,193,616,2380
213020,INDIANA UNIVERSITY OF PENNSYLVANIA-MAIN CAMPUS,1,0,2004,NA,NA,2645,1567,1078,768,234,534,0.34,0.22,0.29,4810,197,628,2109
213020,Indiana University of Pennsylvania-Main Campus,1,0,2005,NA,NA,2462,1335,1127,713,245,468,0.35000000000000003,0.22,0.29,4906,200,639,1888
213020,Indiana University of Pennsylvania-Main Campus,1,0,2006,NA,NA,2538,1400,1138,726,225,501,0.35000000000000003,0.2,0.29,5038,209,641,2030
213020,Indiana University of Pennsylvania-Main Campus,1,0,2007,NA,NA,2524,1450,1074,786,257,529,0.36,0.24,0.31,5178,221,633,1886
213020,Indiana University of Pennsylvania-Main Campus,1,0,2008,NA,NA,3065,1790,1275,1041,323,718,0.4,0.25,0.34,5358,225,616,2445
213020,Indiana University of Pennsylvania-Main Campus,1,0,2009,NA,NA,2993,1774,1219,1068,329,739,0.41000000000000003,0.27,0.36,5554,232,608,2497
213020,Indiana University of Pennsylvania-Main Campus,1,0,2010,NA,NA,2984,1751,1233,1087,333,754,0.43,0.27,0.36,5804,237,625,2375
213251,JUNIATA COLLEGE,1,0,1991,NA,NA,261,129,132,164,78,86,0.66,0.59,0.63,12570,22,75,254
213251,JUNIATA COLLEGE,1,0,1992,NA,NA,258,132,126,161,68,93,0.7000000000000001,0.54,0.62,13350,23,78,251
213251,JUNIATA COLLEGE,1,0,1993,NA,NA,301,166,135,198,87,111,0.66,0.64,0.66,14250,25,74,266
213251,JUNIATA COLLEGE,1,0,1995,NA,NA,282,175,107,196,73,123,0.7000000000000001,0.68,0.7,16010,26,73,252
213251,JUNIATA COLLEGE,1,0,1996,NA,NA,349,182,167,237,100,137,0.75,0.6,0.68,16750,27,70,314
213251,JUNIATA COLLEGE,1,0,1997,NA,NA,342,186,156,232,89,143,0.76,0.57,0.68,17300,21,77,321
213251,JUNIATA COLLEGE,1,0,1998,NA,NA,337,192,145,227,88,139,0.72,0.61,0.67,17820,22,75,315
213251,JUNIATA COLLEGE,1,0,1999,NA,NA,324,184,140,217,81,136,0.73,0.58,0.67,18030,23,83,302
213251,JUNIATA COLLEGE,1,0,2000,NA,NA,359,207,152,265,105,160,0.77,0.69,0.74,18940,25,84,342
213251,JUNIATA COLLEGE,1,0,2001,NA,NA,340,205,135,242,87,155,0.75,0.64,0.71,20170,27,85,327
213251,JUNIATA COLLEGE,1,0,2002,NA,NA,375,215,160,285,119,166,0.77,0.74,0.76,21160,29,90,354
213251,JUNIATA COLLEGE,1,0,2003,NA,NA,381,200,181,284,135,149,0.74,0.75,0.75,22240,31,94,357
213251,JUNIATA COLLEGE,1,0,2004,NA,NA,390,213,177,273,129,144,0.67,0.73,0.7,23720,34,88,362
213251,Juniata College,1,0,2005,NA,NA,387,212,175,279,120,159,0.75,0.69,0.72,25260,36,95,358
213251,Juniata College,1,0,2006,NA,NA,362,195,167,257,111,146,0.74,0.66,0.71,26900,36,95,338
213251,Juniata College,1,0,2007,NA,NA,377,220,157,271,104,167,0.75,0.66,0.72,28250,41,104,336
213251,Juniata College,1,0,2008,NA,NA,461,260,201,332,134,198,0.76,0.67,0.72,29610,45,98,402
213251,Juniata College,1,0,2009,NA,NA,366,207,159,246,98,148,0.71,0.62,0.67,30880,47,99,315
213251,Juniata College,1,0,2010,NA,NA,421,227,194,303,130,173,0.76,0.67,0.72,32120,47,97,345
213321,KING'S COLLEGE,1,0,1991,NA,NA,359,164,195,232,115,117,0.71,0.59,0.65,8740,21,92,343
213321,KING'S COLLEGE,1,0,1992,NA,NA,467,213,254,310,159,151,0.7000000000000001,0.63,0.66,9770,23,96,438
213321,KING'S COLLEGE,1,0,1993,NA,NA,380,166,214,241,127,114,0.68,0.59,0.63,10600,26,95,364
213321,KING'S COLLEGE,1,0,1995,NA,NA,426,180,246,247,126,121,0.67,0.51,0.58,12260,30,99,400
213321,KING'S COLLEGE,1,0,1996,NA,NA,432,236,196,284,116,168,0.71,0.59,0.66,12980,34,96,398
213321,KINGS COLLEGE,1,0,1997,NA,NA,435,195,240,260,121,139,0.71,0.5,0.6,14000,28,93,403
213321,KINGS COLLEGE,1,0,1998,NA,NA,396,189,207,240,113,127,0.67,0.55,0.61,14970,28,106,371
213321,KINGS COLLEGE,1,0,1999,NA,NA,420,218,202,268,112,156,0.71,0.55,0.64,15240,28,105,374
213321,KINGS COLLEGE,1,0,2000,NA,NA,457,199,258,285,133,152,0.76,0.52,0.62,16000,30,108,407
213321,KINGS COLLEGE,1,0,2001,NA,NA,441,217,224,286,121,165,0.76,0.54,0.65,16720,32,112,372
213321,KINGS COLLEGE,1,0,2002,NA,NA,409,195,214,263,125,138,0.7000000000000001,0.58,0.64,17390,34,114,357
213321,KINGS COLLEGE,1,0,2003,NA,NA,448,166,282,284,164,120,0.72,0.58,0.63,18260,36,114,371
213321,KINGS COLLEGE,1,0,2004,NA,NA,449,178,271,268,139,129,0.72,0.51,0.6,19260,38,108,377
213321,King's College,1,0,2005,NA,NA,479,198,281,282,149,133,0.67,0.53,0.59,20320,36,109,397
213321,King's College,1,0,2006,NA,NA,478,202,276,295,153,142,0.7000000000000001,0.55,0.62,22280,39,116,414
213321,King's College,1,0,2007,NA,NA,555,268,287,338,173,165,0.61,0.6,0.61,23450,42,121,467
213321,King's College,1,0,2008,NA,NA,559,295,264,315,134,181,0.61,0.51,0.56,24680,47,129,441
213321,King's College,1,0,2009,NA,NA,499,233,266,303,142,161,0.6900000000000001,0.53,0.61,25644,50,123,372
213321,King's College,1,0,2010,NA,NA,528,240,288,310,150,160,0.66,0.52,0.59,26644,52,128,431
213349,KUTZTOWN UNIVERSITY OF PENNSYLVANIA,1,0,1991,NA,NA,1427,813,614,295,59,236,0.29,0.1,0.21,3022,57,370,1272
213349,KUTZTOWN UNIVERSITY OF PENNSYLVANIA,1,0,1992,NA,NA,1131,632,499,188,40,148,0.23,0.08,0.17,3160,62,405,982
213349,KUTZTOWN UNIVERSITY OF PENNSYLVANIA,1,0,1993,NA,NA,1309,771,538,236,57,179,0.23,0.11,0.18,3558,65,383,1207
213349,KUTZTOWN UNIVERSITY OF PENNSYLVANIA,1,0,1995,NA,NA,1229,715,514,192,52,140,0.19,0.1,0.16,3940,78,395,1105
213349,KUTZTOWN UNIVERSITY OF PENNSYLVANIA,1,0,1996,NA,NA,1440,883,557,245,56,189,0.21,0.1,0.17,4098,79,406,1341
213349,KUTZTOWN UNIVERSITY OF PENNSYLVANIA,1,0,1997,NA,NA,1497,837,660,252,72,180,0.21,0.11,0.17,4219,81,407,1380
213349,KUTZTOWN UNIVERSITY OF PENNSYLVANIA,1,0,1998,NA,NA,1417,840,577,282,70,212,0.25,0.12,0.2,4251,85,370,1320
213349,KUTZTOWN UNIVERSITY OF PENNSYLVANIA,1,0,1999,NA,NA,1550,922,628,374,89,285,0.3,0.14,0.24,3618,89,401,1464
213349,KUTZTOWN UNIVERSITY OF PENNSYLVANIA,1,0,2000,NA,NA,1528,925,603,422,100,322,0.34,0.17,0.28,3792,94,381,1448
213349,KUTZTOWN UNIVERSITY OF PENNSYLVANIA,1,0,2001,NA,NA,1630,957,673,474,111,363,0.37,0.16,0.29,4016,102,361,1454
213349,KUTZTOWN UNIVERSITY OF PENNSYLVANIA,1,0,2002,NA,NA,1726,1027,699,498,141,357,0.34,0.2,0.29,4378,96,362,1437
213349,KUTZTOWN UNIVERSITY OF PENNSYLVANIA,1,0,2003,NA,NA,1825,1035,790,549,158,391,0.37,0.2,0.3,4598,100,381,1503
213349,KUTZTOWN UNIVERSITY OF PENNSYLVANIA,1,0,2004,NA,NA,2049,1217,832,680,191,489,0.4,0.23,0.33,4810,110,396,1698
213349,Kutztown University of Pennsylvania,1,0,2005,NA,NA,1905,1105,800,621,190,431,0.39,0.24,0.33,4906,118,410,1596
213349,Kutztown University of Pennsylvania,1,0,2006,NA,NA,1930,1177,753,612,163,449,0.38,0.22,0.32,5038,126,412,1644
213349,Kutztown University of Pennsylvania,1,0,2007,NA,NA,1888,1111,777,645,182,463,0.41000000000000003,0.23,0.34,5177,138,417,1577
213349,Kutztown University of Pennsylvania,1,0,2008,NA,NA,1812,1034,778,680,206,474,0.45,0.26,0.38,5358,150,432,1562
213349,Kutztown University of Pennsylvania,1,0,2009,NA,NA,1985,1132,853,689,221,468,0.41000000000000003,0.26,0.35,5554,161,448,1688
213349,Kutztown University of Pennsylvania,1,0,2010,NA,NA,2009,1175,834,677,217,460,0.39,0.26,0.34,5804,164,427,1663
213358,LA ROCHE COLLEGE,1,0,1991,NA,NA,120,76,44,34,10,24,0.31,0.23,0.28,7138,10,43,106
213358,LA ROCHE COLLEGE,1,0,1992,NA,NA,118,84,34,33,6,27,0.32,0.18,0.28,7780,11,43,113
213358,LA ROCHE COLLEGE,1,0,1993,NA,NA,181,85,96,61,31,30,0.35000000000000003,0.32,0.34,8468,12,44,124
213358,LA ROCHE COLLEGE,1,0,1995,NA,NA,147,85,62,37,9,28,0.32,0.15,0.25,9426,14,46,132
213358,LA ROCHE COLLEGE,1,0,1996,NA,NA,152,106,46,57,19,38,0.35000000000000003,0.41,0.38,9912,15,43,137
213358,LA ROCHE COLLEGE,1,0,1997,NA,NA,184,101,83,91,44,47,0.46,0.53,0.49,10360,13,45,148
213358,LA ROCHE COLLEGE,1,0,1998,NA,NA,204,127,77,82,30,52,0.4,0.39,0.4,10780,13,45,178
213358,LA ROCHE COLLEGE,1,0,1999,NA,NA,306,170,136,133,58,75,0.44,0.43,0.43,11100,15,45,202
213358,LA ROCHE COLLEGE,1,0,2000,NA,NA,351,199,152,200,98,102,0.51,0.64,0.57,11600,18,49,211
213358,LA ROCHE COLLEGE,1,0,2001,NA,NA,214,133,81,91,34,57,0.42,0.42,0.43,12180,21,54,178
213358,LA ROCHE COLLEGE,1,0,2002,NA,NA,295,175,120,117,43,74,0.42,0.36,0.4,12790,23,63,217
213358,LA ROCHE COLLEGE,1,0,2003,NA,NA,174,124,50,58,13,45,0.36,0.26,0.33,15220,24,68,159
213358,LA ROCHE COLLEGE,1,0,2004,NA,NA,214,141,73,46,10,36,0.25,0.14,0.21,15982,23,65,182
213358,La Roche College,1,0,2005,NA,NA,302,203,99,103,32,71,0.34,0.32,0.34,16780,22,64,212
213358,La Roche College,1,0,2006,NA,NA,259,164,95,92,32,60,0.36,0.34,0.36,17620,22,64,158
213358,La Roche College,1,0,2007,NA,NA,294,192,102,93,29,64,0.33,0.28,0.32,18600,22,64,177
213358,La Roche College,1,0,2008,NA,NA,227,148,79,60,15,45,0.3,0.19,0.26,19660,23,63,130
213358,La Roche College,1,0,2009,NA,NA,190,121,69,46,15,31,0.25,0.22,0.24,20740,24,63,112
213358,La Roche College,1,0,2010,NA,NA,269,151,118,93,48,45,0.29,0.41,0.35,21570,22,62,183
213367,LA SALLE UNIVERSITY,1,0,1991,NA,NA,594,293,301,331,152,179,0.61,0.5,0.56,10300,56,211,512
213367,LA SALLE UNIVERSITY,1,0,1992,NA,NA,564,293,271,358,159,199,0.67,0.59,0.63,10970,60,212,485
213367,LA SALLE UNIVERSITY,1,0,1993,NA,NA,597,327,270,321,125,196,0.59,0.46,0.54,11560,61,209,509
213367,LA SALLE UNIVERSITY,1,0,1995,NA,NA,741,438,303,404,140,264,0.6,0.46,0.55,13070,62,187,649
213367,LA SALLE UNIVERSITY,1,0,1996,NA,NA,648,355,293,362,146,216,0.6,0.5,0.56,14090,67,182,550
213367,LA SALLE UNIVERSITY,1,0,1997,NA,NA,834,479,355,476,184,292,0.6,0.52,0.57,14850,58,179,714
213367,LA SALLE UNIVERSITY,1,0,1998,NA,NA,663,321,342,361,161,200,0.62,0.47,0.54,15860,61,171,552
213367,LA SALLE UNIVERSITY,1,0,1999,NA,NA,801,426,375,446,188,258,0.6,0.5,0.56,16880,59,182,681
213367,LA SALLE UNIVERSITY,1,0,2000,NA,NA,774,404,370,455,203,252,0.62,0.55,0.59,18020,63,187,641
213367,LA SALLE UNIVERSITY,1,0,2001,NA,NA,849,476,373,514,190,324,0.68,0.51,0.61,19740,72,193,696
213367,LA SALLE UNIVERSITY,1,0,2002,NA,NA,837,456,381,445,173,272,0.59,0.45,0.53,21270,82,200,692
213367,LA SALLE UNIVERSITY,1,0,2003,NA,NA,809,423,386,461,204,257,0.6,0.53,0.57,22760,83,207,584
213367,LA SALLE UNIVERSITY,1,0,2004,NA,NA,829,419,410,441,195,246,0.58,0.48,0.53,24410,88,213,627
213367,La Salle University,1,0,2005,NA,NA,803,440,363,400,160,240,0.54,0.44,0.5,25880,96,210,543
213367,La Salle University,1,0,2006,NA,NA,884,512,372,467,180,287,0.56,0.48,0.53,27500,104,225,609
213367,La Salle University,1,0,2007,NA,NA,804,472,332,424,136,288,0.61,0.41,0.53,29200,112,228,538
213367,La Salle University,1,0,2008,NA,NA,902,519,383,471,190,281,0.54,0.5,0.52,31000,126,230,548
213367,La Salle University,1,0,2009,NA,NA,1005,580,425,522,209,313,0.53,0.49,0.52,32500,120,231,618
213367,La Salle University,1,0,2010,NA,NA,982,605,377,524,182,342,0.56,0.48,0.53,33500,126,226,602
213385,LAFAYETTE COLLEGE,1,0,1991,NA,NA,519,243,276,426,212,214,0.88,0.77,0.82,15475,55,169,434
213385,LAFAYETTE COLLEGE,1,0,1992,NA,NA,575,263,312,455,231,224,0.85,0.74,0.79,16795,55,179,506
213385,LAFAYETTE COLLEGE,1,0,1993,NA,NA,570,252,318,443,226,217,0.86,0.71,0.78,17880,57,179,481
213385,LAFAYETTE COLLEGE,1,0,1995,NA,NA,525,241,284,415,208,207,0.85,0.73,0.79,19621,63,182,457
213385,LAFAYETTE COLLEGE,1,0,1996,NA,NA,572,281,291,460,215,245,0.87,0.74,0.8,20390,69,180,522
213385,LAFAYETTE COLLEGE,1,0,1997,NA,NA,568,263,305,456,230,226,0.85,0.75,0.8,21202,61,182,498
213385,LAFAYETTE COLLEGE,1,0,1998,NA,NA,597,281,316,480,241,239,0.85,0.76,0.8,22049,63,180,517
213385,LAFAYETTE COLLEGE,1,0,1999,NA,NA,583,316,267,505,218,287,0.9,0.82,0.87,22844,66,178,506
213385,LAFAYETTE COLLEGE,1,0,2000,NA,NA,558,280,278,490,238,252,0.9,0.86,0.88,23758,73,178,482
213385,LAFAYETTE COLLEGE,1,0,2001,NA,NA,575,287,288,487,238,249,0.86,0.83,0.85,24828,78,179,508
213385,LAFAYETTE COLLEGE,1,0,2002,NA,NA,580,267,313,498,263,235,0.88,0.84,0.86,25946,85,184,486
213385,LAFAYETTE COLLEGE,1,0,2003,NA,NA,584,268,316,502,267,235,0.87,0.84,0.86,27178,92,198,475
213385,LAFAYETTE COLLEGE,1,0,2004,NA,NA,609,315,294,529,249,280,0.88,0.85,0.87,28470,95,200,516
213385,Lafayette College,1,0,2005,NA,NA,596,275,321,508,268,240,0.87,0.83,0.85,29822,101,196,438
213385,Lafayette College,1,0,2006,NA,NA,629,290,339,561,299,262,0.9,0.88,0.89,31501,108,198,445
213385,Lafayette College,1,0,2007,NA,NA,591,277,314,500,253,247,0.89,0.81,0.85,33634,118,210,434
213385,Lafayette College,1,0,2008,NA,NA,600,270,330,530,280,250,0.92,0.85,0.88,35904,123,208,396
213385,Lafayette College,1,0,2009,NA,NA,616,298,318,533,263,270,0.9,0.83,0.87,37520,125,211,348
213385,Lafayette College,1,0,2010,NA,NA,648,294,354,553,279,274,0.93,0.79,0.85,38810,125,217,443
213507,LEBANON VALLEY COLLEGE,1,0,1991,NA,NA,180,77,103,98,50,48,0.62,0.49,0.54,11750,16,67,166
213507,LEBANON VALLEY COLLEGE,1,0,1992,NA,NA,280,123,157,161,84,77,0.62,0.54,0.58,12875,18,67,263
213507,LEBANON VALLEY COLLEGE,1,0,1993,NA,NA,314,170,144,191,77,114,0.67,0.53,0.61,13700,19,68,297
213507,LEBANON VALLEY COLLEGE,1,0,1995,NA,NA,297,155,142,183,79,104,0.67,0.56,0.62,14785,26,70,284
213507,LEBANON VALLEY COLLEGE,1,0,1996,NA,NA,287,172,115,165,53,112,0.65,0.46,0.57,15360,28,70,269
213507,LEBANON VALLEY COLLEGE,1,0,1997,NA,NA,303,174,129,185,71,114,0.65,0.55,0.61,15980,23,73,276
213507,LEBANON VALLEY COLLEGE,1,0,1998,NA,NA,422,208,214,247,110,137,0.65,0.51,0.59,16610,24,76,389
213507,LEBANON VALLEY COLLEGE,1,0,1999,NA,NA,407,238,169,279,102,177,0.74,0.6,0.69,16730,26,81,383
213507,LEBANON VALLEY COLLEGE,1,0,2000,NA,NA,388,225,163,242,85,157,0.6900000000000001,0.52,0.62,17870,27,84,358
213507,LEBANON VALLEY COLLEGE,1,0,2001,NA,NA,416,229,187,266,105,161,0.7000000000000001,0.56,0.64,19210,28,88,389
213507,LEBANON VALLEY COLLEGE,1,0,2002,NA,NA,422,234,188,266,99,167,0.71,0.53,0.63,20600,31,95,390
213507,LEBANON VALLEY COLLEGE,1,0,2003,NA,NA,429,231,198,292,119,173,0.74,0.6,0.68,21860,34,99,387
213507,LEBANON VALLEY COLLEGE,1,0,2004,NA,NA,416,221,195,287,121,166,0.75,0.62,0.69,22950,35,96,367
213507,Lebanon Valley College,1,0,2005,NA,NA,454,223,231,304,138,166,0.74,0.6,0.67,24210,35,100,391
213507,Lebanon Valley College,1,0,2006,NA,NA,447,241,206,300,114,186,0.77,0.55,0.67,25710,37,98,403
213507,Lebanon Valley College,1,0,2007,NA,NA,450,261,189,308,109,199,0.76,0.58,0.68,27125,39,100,392
213507,Lebanon Valley College,1,0,2008,NA,NA,395,217,178,276,110,166,0.76,0.62,0.7,28650,42,99,353
213507,Lebanon Valley College,1,0,2009,NA,NA,378,205,173,258,92,166,0.8,0.53,0.68,29780,44,100,339
213507,Lebanon Valley College,1,0,2010,NA,NA,460,245,215,331,152,179,0.73,0.71,0.72,30910,47,101,405
213543,LEHIGH UNIVERSITY,1,0,1991,NA,NA,1117,411,706,749,435,314,0.76,0.62,0.67,15650,170,411,980
213543,LEHIGH UNIVERSITY,1,0,1992,NA,NA,1089,385,704,720,430,290,0.75,0.61,0.66,16700,185,418,958
213543,LEHIGH UNIVERSITY,1,0,1993,NA,NA,1095,394,701,706,404,302,0.76,0.58,0.64,17750,182,416,941
213543,LEHIGH UNIVERSITY,1,0,1995,NA,NA,1045,412,633,734,404,330,0.8,0.64,0.7,19650,199,385,828
213543,LEHIGH UNIVERSITY,1,0,1996,NA,NA,1101,409,692,768,433,335,0.81,0.63,0.7,20500,202,399,847
213543,LEHIGH UNIVERSITY,1,0,1997,NA,NA,1097,442,655,803,444,359,0.81,0.68,0.73,21350,183,397,878
213543,LEHIGH UNIVERSITY,1,0,1998,NA,NA,1112,478,634,789,397,392,0.8200000000000001,0.63,0.71,22300,190,393,857
213543,LEHIGH UNIVERSITY,1,0,1999,NA,NA,1077,455,622,799,437,362,0.79,0.7,0.74,23150,198,391,790
213543,LEHIGH UNIVERSITY,1,0,2000,NA,NA,1127,464,663,845,473,372,0.8,0.71,0.75,24000,199,392,843
213543,LEHIGH UNIVERSITY,1,0,2001,NA,NA,1109,435,674,798,436,362,0.8300000000000001,0.65,0.72,24940,207,393,838
213543,LEHIGH UNIVERSITY,1,0,2002,NA,NA,1143,442,701,822,461,361,0.81,0.66,0.72,25980,221,406,938
213543,LEHIGH UNIVERSITY,1,0,2003,NA,NA,1124,448,676,854,487,367,0.81,0.72,0.76,27230,237,423,873
213543,LEHIGH UNIVERSITY,1,0,2004,NA,NA,1054,463,591,814,417,397,0.85,0.71,0.77,29140,248,432,847
213543,Lehigh University,1,0,2005,NA,NA,1223,512,711,956,521,435,0.84,0.73,0.78,31180,266,434,1036
213543,Lehigh University,1,0,2006,NA,NA,1217,511,706,950,523,427,0.8300000000000001,0.74,0.78,33470,269,443,874
213543,Lehigh University,1,0,2007,NA,NA,1165,450,715,851,485,366,0.81,0.68,0.73,35310,297,440,850
213543,Lehigh University,1,0,2008,NA,NA,1205,516,689,910,484,426,0.8200000000000001,0.7,0.76,37250,318,443,803
213543,Lehigh University,1,0,2009,NA,NA,1189,489,700,878,469,409,0.8300000000000001,0.67,0.74,38330,318,464,839
213543,Lehigh University,1,0,2010,NA,NA,1208,516,692,932,495,437,0.84,0.72,0.77,39480,317,473,885
213613,LOCK HAVEN UNIVERSITY,1,0,1991,NA,NA,737,447,290,187,52,135,0.3,0.18,0.25,3020,32,211,700
213613,LOCK HAVEN UNIVERSITY,1,0,1992,NA,NA,906,514,392,210,61,149,0.28,0.16,0.23,3261,37,201,872
213613,LOCK HAVEN UNIVERSITY,1,0,1993,NA,NA,758,402,356,157,43,114,0.28,0.12,0.21,3509,39,197,720
213613,LOCK HAVEN UNIVERISTY OF PENNSYLVANIA,1,0,1995,NA,NA,693,359,334,133,43,90,0.25,0.13,0.19,3822,41,188,635
213613,LOCK HAVEN UNIVERISTY OF PENNSYLVANIA,1,0,1996,NA,NA,780,419,361,179,62,117,0.27,0.17,0.23,3988,42,183,723
213613,LOCK HAVEN UNIVERSITY OF PENNSYLVANIA,1,0,1997,NA,NA,822,430,392,188,67,121,0.28,0.17,0.23,4062,45,197,768
213613,LOCK HAVEN UNIVERSITY OF PENNSYLVANIA,1,0,1998,NA,NA,813,463,350,159,50,109,0.23,0.14,0.2,4071,46,207,754
213613,LOCK HAVEN UNIVERSITY OF PENNSYLVANIA,1,0,1999,NA,NA,887,502,385,212,65,147,0.29,0.17,0.24,3618,49,202,839
213613,LOCK HAVEN UNIVERSITY OF PENNSYLVANIA,1,0,2000,NA,NA,890,522,368,250,68,182,0.34,0.18,0.28,3792,52,203,824
213613,LOCK HAVEN UNIVERSITY OF PENNSYLVANIA,1,0,2001,NA,NA,978,581,397,286,96,190,0.32,0.24,0.29,4016,57,205,917
213613,LOCK HAVEN UNIVERSITY OF PENNSYLVANIA,1,0,2002,NA,NA,1038,646,392,305,89,216,0.33,0.23,0.29,4378,57,213,941
213613,LOCK HAVEN UNIVERSITY OF PENNSYLVANIA,1,0,2003,NA,NA,1145,657,488,316,104,212,0.32,0.21,0.28,4598,61,220,1033
213613,LOCK HAVEN UNIVERSITY OF PENNSYLVANIA,1,0,2004,NA,NA,1191,702,489,348,129,219,0.31,0.26,0.29,4810,66,235,1051
213613,Lock Haven University of Pennsylvania,1,0,2005,NA,NA,1215,695,520,314,110,204,0.29,0.21,0.26,4906,70,236,990
213613,Lock Haven University of Pennsylvania,1,0,2006,NA,NA,1079,608,471,266,106,160,0.26,0.23,0.25,5038,74,233,900
213613,Lock Haven University of Pennsylvania,1,0,2007,NA,NA,1217,656,561,321,144,177,0.26,0.26,0.26,5178,76,235,1035
213613,Lock Haven University,1,0,2008,NA,NA,1269,731,538,340,119,221,0.3,0.22,0.27,5358,80,235,1093
213613,Lock Haven University,1,0,2009,NA,NA,1185,702,483,336,117,219,0.31,0.24,0.28,5554,81,231,1020
213613,Lock Haven University,1,0,2010,NA,NA,1185,630,555,361,158,203,0.32,0.28,0.3,5804,86,229,1030
213668,LYCOMING COLLEGE,1,0,1991,NA,NA,374,190,184,153,67,86,0.45,0.36,0.41,11100,20,85,357
213668,LYCOMING COLLEGE,1,0,1992,NA,NA,359,179,180,174,72,102,0.56,0.4,0.48,12000,23,83,346
213668,LYCOMING COLLEGE,1,0,1993,NA,NA,361,203,158,191,72,119,0.58,0.46,0.53,13000,25,86,345
213668,LYCOMING COLLEGE,1,0,1995,NA,NA,366,210,156,237,82,155,0.73,0.53,0.65,14700,30,87,347
213668,LYCOMING COLLEGE,1,0,1996,NA,NA,386,186,200,226,102,124,0.66,0.51,0.59,15460,31,86,372
213668,LYCOMING COLLEGE,1,0,1997,NA,NA,379,227,152,214,65,149,0.65,0.43,0.56,16130,21,91,372
213668,LYCOMING COLLEGE,1,0,1998,NA,NA,380,195,185,222,85,137,0.7000000000000001,0.46,0.58,16810,21,87,367
213668,LYCOMING COLLEGE,1,0,1999,NA,NA,392,209,183,242,99,143,0.68,0.54,0.62,17440,22,86,379
213668,LYCOMING COLLEGE,1,0,2000,NA,NA,337,177,160,199,90,109,0.61,0.56,0.59,18240,23,84,332
213668,LYCOMING COLLEGE,1,0,2001,NA,NA,407,218,189,249,100,149,0.68,0.53,0.61,19104,24,82,385
213668,LYCOMING COLLEGE,1,0,2002,NA,NA,373,195,178,234,100,134,0.68,0.56,0.63,20032,25,82,357
213668,LYCOMING COLLEGE,1,0,2003,NA,NA,381,226,155,254,97,157,0.6900000000000001,0.63,0.67,21088,26,84,360
213668,LYCOMING COLLEGE,1,0,2004,NA,NA,399,217,182,249,109,140,0.64,0.6,0.62,22336,27,81,376
213668,Lycoming College,1,0,2005,NA,NA,357,219,138,216,74,142,0.64,0.54,0.61,23680,29,84,328
213668,Lycoming College,1,0,2006,NA,NA,375,193,182,213,87,126,0.65,0.48,0.57,25120,30,80,349
213668,Lycoming College,1,0,2007,NA,NA,399,211,188,215,84,131,0.62,0.45,0.54,26624,31,84,372
213668,Lycoming College,1,0,2008,NA,NA,340,161,179,178,77,101,0.62,0.43,0.52,28224,32,82,319
213668,Lycoming College,1,0,2009,NA,NA,383,194,189,220,89,131,0.67,0.47,0.57,29344,31,81,286
213668,Lycoming College,1,0,2010,NA,NA,346,211,135,205,67,138,0.65,0.5,0.59,30240,32,85,265
213783,MANSFIELD UNIVERSITY OF PENNSYLVANIA,1,0,1991,NA,NA,461,283,178,168,50,118,0.41000000000000003,0.28,0.36,2947,31,178,428
213783,MANSFIELD UNIVERSITY OF PENNSYLVANIA,1,0,1992,NA,NA,485,294,191,148,44,104,0.35000000000000003,0.23,0.31,3168,34,179,440
213783,MANSFIELD UNIVERSITY OF PENNSYLVANIA,1,0,1993,NA,NA,590,350,240,189,59,130,0.37,0.25,0.32,3440,36,179,539
213783,MANSFIELD UNIVERSITY OF PENNSYLVANIA,1,0,1995,NA,NA,577,340,237,135,41,94,0.27,0.17,0.23,3804,38,179,536
213783,MANSFIELD UNIVERSITY OF PENNSYLVANIA,1,0,1996,NA,NA,590,316,274,154,57,97,0.3,0.21,0.26,4034,41,171,533
213783,MANSFIELD UNIVERSITY OF PENNSYLVANIA,1,0,1997,NA,NA,597,329,268,141,53,88,0.26,0.2,0.24,4354,41,168,550
213783,MANSFIELD UNIVERSITY OF PENNSYLVANIA,1,0,1998,NA,NA,619,346,273,143,64,79,0.22,0.23,0.23,4410,42,156,548
213783,MANSFIELD UNIVERSITY OF PENNSYLVANIA,1,0,1999,NA,NA,611,364,247,178,53,125,0.34,0.21,0.29,3618,45,169,569
213783,MANSFIELD UNIVERSITY OF PENNSYLVANIA,1,0,2000,NA,NA,639,363,276,183,79,104,0.28,0.29,0.29,3792,47,168,589
213783,MANSFIELD UNIVERSITY OF PENNSYLVANIA,1,0,2001,NA,NA,640,362,278,200,77,123,0.33,0.28,0.31,4016,49,168,592
213783,MANSFIELD UNIVERSITY OF PENNSYLVANIA,1,0,2002,NA,NA,654,381,273,171,48,123,0.32,0.18,0.26,4378,49,155,589
213783,MANSFIELD UNIVERSITY OF PENNSYLVANIA,1,0,2003,NA,NA,690,403,287,179,74,105,0.26,0.26,0.26,4598,50,153,595
213783,MANSFIELD UNIVERSITY OF PENNSYLVANIA,1,0,2004,NA,NA,689,402,287,168,54,114,0.28,0.19,0.24,4810,52,155,571
213783,Mansfield University of Pennsylvania,1,0,2005,NA,NA,662,406,256,216,62,154,0.37,0.24,0.33,4906,53,147,534
213783,Mansfield University of Pennsylvania,1,0,2006,NA,NA,603,356,247,172,53,119,0.33,0.21,0.29,5038,54,148,503
213783,Mansfield University of Pennsylvania,1,0,2007,NA,NA,661,397,264,198,63,135,0.34,0.24,0.3,5177,57,147,526
213783,Mansfield University of Pennsylvania,1,0,2008,NA,NA,665,410,255,203,67,136,0.33,0.26,0.31,5358,59,158,516
213783,Mansfield University of Pennsylvania,1,0,2009,NA,NA,704,397,307,189,71,118,0.29,0.23,0.27,5554,61,156,532
213783,Mansfield University of Pennsylvania,1,0,2010,NA,NA,631,346,285,162,70,92,0.26,0.25,0.26,5804,63,152,503
213826,MARYWOOD COLLEGE,1,0,1991,NA,NA,281,237,44,95,12,83,0.35000000000000003,0.27,0.34,8500,25,122,265
213826,MARYWOOD COLLEGE,1,0,1992,NA,NA,239,193,46,81,5,76,0.39,0.11,0.34,9350,29,121,233
213826,MARYWOOD COLLEGE,1,0,1993,NA,NA,292,228,64,101,17,84,0.36,0.27,0.35,9950,30,121,274
213826,MARYWOOD COLLEGE,1,0,1995,NA,NA,245,193,52,99,13,86,0.44,0.25,0.4,11500,36,120,227
213826,MARYWOOD COLLEGE,1,0,1996,NA,NA,251,191,60,103,18,85,0.44,0.3,0.41,12395,37,114,230
213826,MARYWOOD UNIVERSITY,1,0,1997,NA,NA,276,209,67,103,18,85,0.4,0.27,0.37,13165,30,116,248
213826,MARYWOOD UNIVERSITY,1,0,1998,NA,NA,241,186,55,102,16,86,0.46,0.29,0.42,14020,32,118,220
213826,MARYWOOD UNIVERSITY,1,0,1999,NA,NA,282,207,75,118,25,93,0.44,0.33,0.42,14070,33,117,257
213826,MARYWOOD UNIVERSITY,1,0,2000,NA,NA,257,188,69,100,29,71,0.37,0.42,0.39,14850,34,119,242
213826,MARYWOOD UNIVERSITY,1,0,2001,NA,NA,287,215,72,114,23,91,0.42,0.32,0.4,15600,37,121,271
213826,MARYWOOD UNIVERSITY,1,0,2002,NA,NA,310,238,72,164,29,135,0.56,0.4,0.53,17600,39,123,276
213826,MARYWOOD UNIVERSITY,1,0,2003,NA,NA,277,199,78,152,34,118,0.59,0.44,0.55,18560,41,122,252
213826,MARYWOOD UNIVERSITY,1,0,2004,NA,NA,332,262,70,149,24,125,0.47000000000000003,0.34,0.45,19600,43,121,292
213826,Marywood University,1,0,2005,NA,NA,301,230,71,153,30,123,0.53,0.42,0.51,20700,45,121,254
213826,Marywood University,1,0,2006,NA,NA,383,278,105,197,42,155,0.55,0.4,0.51,21840,49,121,321
213826,Marywood University,1,0,2007,NA,NA,407,297,110,218,46,172,0.5700000000000001,0.42,0.54,23040,52,123,360
213826,Marywood University,1,0,2008,NA,NA,422,291,131,238,62,176,0.6,0.47,0.56,24300,56,130,380
213826,Marywood University,1,0,2009,NA,NA,411,287,124,231,54,177,0.61,0.44,0.56,25150,61,136,365
213826,Marywood University,1,0,2010,NA,NA,452,338,114,241,44,197,0.58,0.39,0.53,26000,62,143,386
213996,MESSIAH COLLEGE,1,0,1991,NA,NA,560,343,217,361,136,225,0.65,0.63,0.64,8700,35,126,501
213996,MESSIAH COLLEGE,1,0,1992,NA,NA,568,357,211,376,142,234,0.65,0.67,0.66,9110,38,126,525
213996,MESSIAH COLLEGE,1,0,1993,NA,NA,606,376,230,400,155,245,0.65,0.67,0.66,9804,37,131,569
213996,MESSIAH COLLEGE,1,0,1995,NA,NA,671,416,255,428,163,265,0.63,0.64,0.64,10954,42,128,629
213996,MESSIAH COLLEGE,1,0,1996,NA,NA,672,407,265,448,168,280,0.68,0.63,0.67,11888,37,135,620
213996,MESSIAH COLLEGE,1,0,1997,NA,NA,689,445,244,445,165,280,0.62,0.68,0.65,12990,43,139,639
213996,MESSIAH COLLEGE,1,0,1998,NA,NA,763,480,283,536,205,331,0.68,0.72,0.7,13880,44,142,712
213996,MESSIAH COLLEGE,1,0,1999,NA,NA,678,413,265,468,168,300,0.72,0.63,0.69,15000,47,141,642
213996,MESSIAH COLLEGE,1,0,2000,NA,NA,741,451,290,500,184,316,0.7000000000000001,0.63,0.67,15830,51,149,675
213996,MESSIAH COLLEGE,1,0,2001,NA,NA,702,425,277,472,166,306,0.72,0.6,0.67,16860,72,158,635
213996,MESSIAH COLLEGE,1,0,2002,NA,NA,763,475,288,526,168,358,0.75,0.58,0.69,17730,61,166,690
213996,MESSIAH COLLEGE,1,0,2003,NA,NA,735,463,272,529,189,340,0.73,0.69,0.72,18880,65,166,662
213996,MESSIAH COLLEGE,1,0,2004,NA,NA,690,453,237,484,159,325,0.71,0.67,0.7,20120,69,170,620
213996,Messiah College,1,0,2005,NA,NA,707,439,268,500,177,323,0.73,0.66,0.71,21420,73,170,629
213996,Messiah College,1,0,2006,NA,NA,735,471,264,529,179,350,0.74,0.68,0.72,22600,74,173,605
213996,Messiah College,1,0,2007,NA,NA,723,459,264,514,185,329,0.71,0.7,0.71,23710,76,172,624
213996,Messiah College,1,0,2008,NA,NA,709,448,261,529,186,343,0.76,0.71,0.75,24900,78,173,585
213996,Messiah College,1,0,2009,NA,NA,697,440,257,497,173,324,0.73,0.67,0.71,25900,81,170,610
213996,Messiah College,1,0,2010,NA,NA,721,433,288,523,210,313,0.72,0.73,0.73,26680,81,175,604
214041,MILLERSVILLE UNIVERSITY OF PENNSYLVANIA,1,0,1991,NA,NA,1089,672,417,429,127,302,0.44,0.3,0.39,3100,64,332,946
214041,MILLERSVILLE UNIVERSITY OF PENNSYLVANIA,1,0,1992,NA,NA,1002,635,367,375,93,282,0.44,0.25,0.37,3488,70,322,846
214041,MILLERSVILLE UNIVERSITY OF PENNSYLVANIA,1,0,1993,NA,NA,946,593,353,339,86,253,0.42,0.24,0.36,3750,73,320,770
214041,MILLERSVILLE UNIVERSITY OF PENNSYLVANIA,1,0,1995,NA,NA,1157,700,457,389,132,257,0.36,0.29,0.34,4100,85,312,1018
214041,MILLERSVILLE UNIVERSITY OF PENNSYLVANIA,1,0,1996,NA,NA,979,587,392,327,121,206,0.35000000000000003,0.31,0.33,4268,88,309,848
214041,MILLERSVILLE UNIVERSITY OF PENNSYLVANIA,1,0,1997,NA,NA,1068,627,441,409,132,277,0.44,0.3,0.38,4400,88,300,899
214041,MILLERSVILLE UNIVERSITY OF PENNSYLVANIA,1,0,1998,NA,NA,1110,651,459,383,132,251,0.38,0.29,0.35,4429,92,288,976
214041,MILLERSVILLE UNIVERSITY OF PENNSYLVANIA,1,0,1999,NA,NA,1239,746,493,424,134,290,0.38,0.27,0.34,3618,96,286,1093
214041,MILLERSVILLE UNIVERSITY OF PENNSYLVANIA,1,0,2000,NA,NA,1265,768,497,463,163,300,0.39,0.33,0.37,3792,97,291,1133
214041,MILLERSVILLE UNIVERSITY OF PENNSYLVANIA,1,0,2001,NA,NA,1245,758,487,518,162,356,0.46,0.33,0.42,4016,104,296,1118
214041,MILLERSVILLE UNIVERSITY OF PENNSYLVANIA,1,0,2002,NA,NA,1270,748,522,463,158,305,0.4,0.3,0.36,4378,100,292,1071
214041,MILLERSVILLE UNIVERSITY OF PENNSYLVANIA,1,0,2003,NA,NA,1334,754,580,478,159,319,0.42,0.27,0.36,4598,105,303,1062
214041,MILLERSVILLE UNIVERSITY OF PENNSYLVANIA,1,0,2004,NA,NA,1396,791,605,512,177,335,0.42,0.29,0.37,4810,110,298,1019
214041,Millersville University of Pennsylvania,1,0,2005,NA,NA,1306,774,532,501,172,329,0.42,0.32,0.38,4906,111,302,953
214041,Millersville University of Pennsylvania,1,0,2006,NA,NA,1342,792,550,482,154,328,0.41000000000000003,0.28,0.36,5038,116,308,1069
214041,Millersville University of Pennsylvania,1,0,2007,NA,NA,1326,766,560,491,161,330,0.43,0.29,0.37,5177,126,310,1051
214041,Millersville University of Pennsylvania,1,0,2008,NA,NA,1311,729,582,503,190,313,0.42,0.33,0.38,5358,132,300,1044
214041,Millersville University of Pennsylvania,1,0,2009,NA,NA,1317,726,591,472,179,293,0.4,0.3,0.36,5554,136,303,1065
214041,Millersville University of Pennsylvania,1,0,2010,NA,NA,1315,728,587,494,193,301,0.41000000000000003,0.33,0.38,5804,136,298,1068
214069,COLLEGE MISERICORDIA,1,0,1991,NA,NA,246,187,59,86,23,63,0.33,0.39,0.35,7885,13,66,240
214069,COLLEGE MISERICORDIA,1,0,1992,NA,NA,292,228,64,88,20,68,0.29,0.31,0.3,9500,16,79,283
214069,COLLEGE MISERICORDIA,1,0,1993,NA,NA,316,231,85,88,24,64,0.27,0.28,0.28,10460,19,84,308
214069,COLLEGE MISERICORDIA,1,0,1995,NA,NA,280,204,76,88,28,60,0.29,0.37,0.31,12190,25,92,270
214069,COLLEGE MISERICORDIA,1,0,1996,NA,NA,251,186,65,59,16,43,0.23,0.25,0.24,12880,26,91,246
214069,COLLEGE MISERICORDIA,1,0,1997,NA,NA,240,174,66,162,32,130,0.74,0.48,0.68,13830,20,95,237
214069,COLLEGE MISERICORDIA,1,0,1998,NA,NA,187,142,45,126,31,95,0.66,0.69,0.67,14520,21,90,182
214069,COLLEGE MISERICORDIA,1,0,1999,NA,NA,249,173,76,165,42,123,0.71,0.55,0.66,14470,21,86,241
214069,COLLEGE MISERICORDIA,1,0,2000,NA,NA,261,185,76,160,39,121,0.65,0.51,0.61,15190,21,87,256
214069,COLLEGE MISERICORDIA,1,0,2001,NA,NA,260,188,72,157,39,118,0.62,0.54,0.6,15800,24,88,249
214069,COLLEGE MISERICORDIA,1,0,2002,NA,NA,347,239,108,201,59,142,0.59,0.55,0.58,16420,25,88,329
214069,COLLEGE MISERICORDIA,1,0,2003,NA,NA,313,233,80,206,49,157,0.67,0.61,0.66,17970,28,90,297
214069,COLLEGE MISERICORDIA,1,0,2004,NA,NA,317,225,92,171,41,130,0.5700000000000001,0.45,0.54,17850,30,93,301
214069,College Misericordia,1,0,2005,NA,NA,324,222,102,181,52,129,0.58,0.51,0.56,18700,32,90,299
214069,College Misericordia,1,0,2006,NA,NA,308,192,116,165,57,108,0.56,0.49,0.54,19800,34,94,287
214069,Misericordia University,1,0,2007,NA,NA,364,273,91,234,51,183,0.67,0.56,0.64,20830,35,94,343
214069,Misericordia University,1,0,2008,NA,NA,378,248,130,238,72,166,0.66,0.55,0.63,21990,39,95,364
214069,Misericordia University,1,0,2009,NA,NA,371,236,135,237,78,159,0.67,0.58,0.64,22850,41,96,346
214069,Misericordia University,1,0,2010,NA,NA,375,265,110,255,62,193,0.72,0.56,0.68,23750,44,104,356
214157,MORAVIAN COLLEGE,1,0,1991,NA,NA,288,143,145,192,92,100,0.6900000000000001,0.63,0.67,12698,23,85,270
214157,MORAVIAN COLLEGE,1,0,1992,NA,NA,296,142,154,187,86,101,0.71,0.56,0.63,13696,25,86,281
214157,MORAVIAN COLLEGE,1,0,1993,NA,NA,304,157,147,216,102,114,0.72,0.69,0.71,14490,26,86,289
214157,MORAVIAN COLLEGE,1,0,1995,NA,NA,319,169,150,217,97,120,0.71,0.65,0.68,15880,30,86,304
214157,MORAVIAN COLLEGE,1,0,1996,NA,NA,284,138,146,194,90,104,0.75,0.62,0.68,16500,33,89,275
214157,MORAVIAN COLLEGE,1,0,1997,NA,NA,325,190,135,219,86,133,0.7000000000000001,0.64,0.67,17276,27,93,305
214157,MORAVIAN COLLEGE AND THEOLOGICAL SEMINARY,1,0,1998,NA,NA,292,172,120,183,69,114,0.66,0.58,0.63,17841,28,95,268
214157,MORAVIAN COLLEGE AND THEOLOGICAL SEMINARY,1,0,1999,NA,NA,318,162,156,213,102,111,0.68,0.65,0.67,18245,29,98,289
214157,MORAVIAN COLLEGE AND THEOLOGICAL SEMINARY,1,0,2000,NA,NA,378,236,142,246,80,166,0.7000000000000001,0.56,0.65,19070,32,100,357
214157,MORAVIAN COLLEGE AND THEOLOGICAL SEMINARY,1,0,2001,NA,NA,315,200,115,219,68,151,0.75,0.59,0.7,20115,35,103,295
214157,MORAVIAN COLLEGE AND THEOLOGICAL SEMINARY,1,0,2002,NA,NA,372,214,158,264,102,162,0.75,0.65,0.71,20925,36,104,338
214157,MORAVIAN COLLEGE AND THEOLOGICAL SEMINARY,1,0,2003,NA,NA,379,239,140,270,90,180,0.75,0.64,0.71,21663,39,108,339
214157,MORAVIAN COLLEGE AND THEOLOGICAL SEMINARY,1,0,2004,NA,NA,382,215,167,261,103,158,0.73,0.62,0.68,23184,42,110,348
214157,Moravian College and Moravian Theological Seminary,1,0,2005,NA,NA,382,204,178,280,123,157,0.76,0.69,0.73,24813,44,113,350
214157,Moravian College and Moravian Theological Seminary,1,0,2006,NA,NA,375,223,152,268,108,160,0.71,0.71,0.71,26300,46,115,345
214157,Moravian College and Moravian Theological Seminary,1,0,2007,NA,NA,401,214,187,282,130,152,0.71,0.7,0.7,27873,47,112,346
214157,Moravian College and Moravian Theological Seminary,1,0,2008,NA,NA,387,226,161,253,94,159,0.7000000000000001,0.58,0.65,29547,48,116,345
214157,Moravian College and Moravian Theological Seminary,1,0,2009,NA,NA,379,223,156,248,97,151,0.67,0.62,0.65,30735,51,115,300
214157,Moravian College and Moravian Theological Seminary,1,0,2010,NA,NA,373,216,157,245,96,149,0.68,0.61,0.66,31662,50,106,318
214175,MUHLENBERG COLLEGE,1,0,1991,NA,NA,463,258,205,336,140,196,0.75,0.68,0.73,15115,34,113,427
214175,MUHLENBERG COLLEGE,1,0,1992,NA,NA,466,244,222,334,141,193,0.79,0.64,0.72,15740,37,109,427
214175,MUHLENBERG COLLEGE,1,0,1993,NA,NA,464,270,194,332,131,201,0.74,0.68,0.72,16385,39,115,421
214175,MUHLENBERG COLLEGE,1,0,1995,NA,NA,486,277,209,392,161,231,0.8300000000000001,0.77,0.81,17550,43,119,440
214175,MUHLENBERG COLLEGE,1,0,1996,NA,NA,532,307,225,414,161,253,0.8200000000000001,0.72,0.78,18100,46,129,489
214175,MUHLENBERG COLLEGE,1,0,1997,NA,NA,493,293,200,352,135,217,0.74,0.68,0.71,18660,37,123,459
214175,MUHLENBERG COLLEGE,1,0,1998,NA,NA,577,344,233,438,162,276,0.8,0.7,0.76,19300,39,127,532
214175,MUHLENBERG COLLEGE,1,0,1999,NA,NA,551,321,230,446,179,267,0.8300000000000001,0.78,0.81,19910,40,114,419
214175,MUHLENBERG COLLEGE,1,0,2000,NA,NA,579,340,239,480,196,284,0.8300000000000001,0.82,0.83,20865,43,128,546
214175,MUHLENBERG COLLEGE,1,0,2001,NA,NA,574,330,244,456,184,272,0.8200000000000001,0.75,0.79,22015,46,142,526
214175,MUHLENBERG COLLEGE,1,0,2002,NA,NA,547,300,247,445,191,254,0.84,0.77,0.81,23250,51,150,510
214175,MUHLENBERG COLLEGE,1,0,2003,NA,NA,589,354,235,485,179,306,0.86,0.76,0.82,24730,58,147,540
214175,MUHLENBERG COLLEGE,1,0,2004,NA,NA,559,337,222,456,178,278,0.8200000000000001,0.8,0.82,26570,58,150,510
214175,Muhlenberg College,1,0,2005,NA,NA,576,322,254,454,180,274,0.85,0.71,0.79,28550,63,154,538
214175,Muhlenberg College,1,0,2006,NA,NA,615,376,239,503,185,318,0.84,0.77,0.82,30490,67,164,558
214175,Muhlenberg College,1,0,2007,NA,NA,551,304,247,445,189,256,0.84,0.77,0.81,32850,70,165,504
214175,Muhlenberg College,1,0,2008,NA,NA,597,344,253,484,197,287,0.8300000000000001,0.78,0.81,35125,75,172,542
214175,Muhlenberg College,1,0,2009,NA,NA,576,337,239,475,187,288,0.85,0.78,0.82,36730,76,167,522
214175,Muhlenberg College,1,0,2010,NA,NA,603,341,262,485,199,286,0.8300000000000001,0.76,0.8,38110,79,171,504
214272,NEUMANN COLLEGE,1,0,1991,NA,NA,84,58,26,30,5,25,0.43,0.19,0.36,8390,7,41,79
214272,NEUMANN COLLEGE,1,0,1992,NA,NA,63,47,16,29,8,21,0.44,0.5,0.46,9166,8,47,59
214272,NEUMANN COLLEGE,1,0,1993,NA,NA,84,64,20,33,7,26,0.4,0.35,0.39,10150,8,44,82
214272,NEUMANN COLLEGE,1,0,1995,NA,NA,159,114,45,15,5,10,0.08,0.11,0.09,11090,10,47,147
214272,NEUMANN COLLEGE,1,0,1996,NA,NA,114,82,32,41,11,30,0.36,0.34,0.36,12140,12,49,104
214272,NEUMANN COLLEGE,1,0,1997,NA,NA,187,126,61,59,15,44,0.34,0.25,0.32,12400,11,50,121
214272,NEUMANN COLLEGE,1,0,1998,NA,NA,314,206,108,131,42,89,0.43,0.39,0.42,13520,13,50,244
214272,NEUMANN COLLEGE,1,0,1999,NA,NA,324,179,145,108,38,70,0.39,0.26,0.33,13350,16,52,267
214272,NEUMANN COLLEGE,1,0,2000,NA,NA,299,164,135,87,34,53,0.32,0.25,0.29,13750,17,53,241
214272,NEUMANN COLLEGE,1,0,2001,NA,NA,345,217,128,115,25,90,0.41000000000000003,0.2,0.33,14460,19,55,265
214272,NEUMANN COLLEGE,1,0,2002,NA,NA,363,228,135,114,25,89,0.39,0.19,0.31,15060,21,67,286
214272,NEUMANN COLLEGE,1,0,2003,NA,NA,510,327,183,209,72,137,0.41000000000000003,0.39,0.41,15820,25,72,402
214272,NEUMANN COLLEGE,1,0,2004,NA,NA,462,304,158,135,41,94,0.3,0.26,0.29,16590,28,78,322
214272,Neumann College,1,0,2005,NA,NA,522,334,188,163,46,117,0.35000000000000003,0.24,0.31,17300,31,84,306
214272,Neumann College,1,0,2006,NA,NA,544,325,219,160,46,114,0.35000000000000003,0.21,0.29,17992,33,85,345
214272,Neumann College,1,0,2007,NA,NA,540,336,204,157,44,113,0.33,0.22,0.29,18846,36,90,344
214272,Neumann College,1,0,2008,NA,NA,539,348,191,185,51,134,0.38,0.27,0.34,19742,37,89,340
214272,Neumann University,1,0,2009,NA,NA,519,323,196,189,57,132,0.4,0.29,0.36,20290,40,91,280
214272,Neumann University,1,0,2010,NA,NA,547,350,197,166,48,118,0.33,0.24,0.3,21456,45,93,261
214777,PENNSYLVANIA STATE UNIVERSITY MAIN CAMPUS,1,0,1991,NA,NA,3615,1712,1903,2808,1417,1391,0.81,0.74,0.78,4402,722,1778,3203
214777,PENNSYLVANIA STATE UNIVERSITY MAIN CAMPUS,1,0,1992,NA,NA,4227,1995,2232,2529,1163,1366,0.68,0.52,0.6,4618,739,1796,3636
214777,PENNSYLVANIA STATE UNIVERSITY-MAIN CAMPUS,1,0,1993,NA,NA,4265,2107,2158,1846,741,1105,0.52,0.34,0.43,4822,755,1799,3769
214777,PENNSYLVANIA STATE UNIVERSITY-MAIN CAMPUS,1,0,1995,NA,NA,5400,2712,2688,2410,947,1463,0.53,0.35,0.45,5258,878,1844,4656
214777,PENNSYLVANIA STATE UNIVERSITY-MAIN CAMPUS,1,0,1996,NA,NA,4701,2344,2357,2052,837,1215,0.51,0.36,0.44,5624,923,1836,3900
214777,PENNSYLVANIA STATE UNIVERSITY-MAIN CAMPUS,1,0,1997,NA,NA,5185,2686,2499,2497,980,1517,0.56,0.39,0.48,5832,949,1889,4384
214777,PENNSYLVANIA STATE UNIVERSITY-MAIN CAMPUS,1,0,1998,NA,NA,5117,2590,2527,2448,959,1489,0.5700000000000001,0.38,0.48,6092,950,1934,4273
214777,PENNSYLVANIA STATE UNIVERSITY-MAIN CAMPUS,1,0,1999,NA,NA,5058,2535,2523,2738,1142,1596,0.62,0.45,0.54,6162,1055,1983,4247
214777,PENNSYLVANIA STATE UNIVERSITY-MAIN CAMPUS,1,0,2000,NA,NA,5621,2866,2755,3127,1277,1850,0.64,0.46,0.56,6546,1158,2034,4666
214777,PENNSYLVANIA STATE UNIVERSITY-MAIN CAMPUS,1,0,2001,NA,NA,6146,2983,3163,3576,1586,1990,0.66,0.5,0.58,7054,1253,2085,5088
214777,PENNSYLVANIA STATE UNIVERSITY-MAIN CAMPUS,1,0,2002,NA,NA,5935,2911,3024,3558,1554,2004,0.68,0.51,0.6,8008,2286,2125,4883
214777,PENNSYLVANIA STATE UNIVERSITY-MAIN CAMPUS,1,0,2003,NA,NA,6035,3058,2977,3747,1598,2149,0.7000000000000001,0.54,0.62,8796,2423,2181,4990
214777,PENNSYLVANIA STATE UNIVERSITY-MAIN CAMPUS,1,0,2004,NA,NA,5905,2884,3021,3681,1674,2007,0.6900000000000001,0.55,0.62,10408,2611,2201,4962
214777,Pennsylvania State University-Main Campus,1,0,2005,NA,NA,6499,2976,3523,4096,1969,2127,0.71,0.56,0.63,11024,2802,2260,5455
214777,Pennsylvania State University-Penn State Main Campus,1,0,2006,NA,NA,8016,3790,4226,5243,2460,2783,0.73,0.58,0.65,11646,2969,2283,6792
214777,Pennsylvania State University-Main Campus,1,0,2007,NA,NA,6492,3121,3371,4191,1943,2248,0.72,0.58,0.65,12284,3103,2329,5328
214777,Pennsylvania State University-Main Campus,1,0,2008,NA,NA,7241,3428,3813,4746,2226,2520,0.73,0.58,0.66,13014,3373,2377,5833
214777,Pennsylvania State University-Main Campus,1,0,2009,NA,NA,6574,3217,3357,4226,1910,2316,0.71,0.57,0.64,13604,3627,2419,4878
214777,Pennsylvania State University-Main Campus,1,0,2010,NA,NA,7321,3542,3779,4942,2239,2703,0.76,0.59,0.68,14412,3881,2435,5484
215062,UNIVERSITY OF PENNSYLVANIA,1,0,1991,NA,NA,2286,986,1300,1791,981,810,0.8200000000000001,0.75,0.78,15644,1230,1003,1414
215062,UNIVERSITY OF PENNSYLVANIA,1,0,1992,NA,NA,2259,977,1282,1789,972,817,0.8300000000000001,0.76,0.79,16838,1381,997,1374
215062,UNIVERSITY OF PENNSYLVANIA,1,0,1993,NA,NA,2434,1086,1348,1923,1008,915,0.84,0.75,0.79,17838,1501,993,1453
215062,UNIVERSITY OF PENNSYLVANIA,1,0,1995,NA,NA,2349,1158,1191,1954,952,1002,0.86,0.8,0.83,19898,1803,989,1388
215062,UNIVERSITY OF PENNSYLVANIA,1,0,1996,NA,NA,2307,1169,1138,1976,924,1052,0.89,0.81,0.86,21130,2247,949,1387
215062,UNIVERSITY OF PENNSYLVANIA,1,0,1997,NA,NA,2324,1132,1192,1928,941,987,0.87,0.79,0.83,22250,2165,971,1369
215062,UNIVERSITY OF PENNSYLVANIA,1,0,1998,NA,NA,2301,1128,1173,1975,969,1006,0.89,0.83,0.86,23254,2629,970,1198
215062,UNIVERSITY OF PENNSYLVANIA,1,0,1999,NA,NA,2402,1155,1247,2079,1056,1023,0.88,0.85,0.87,21746,2959,979,1218
215062,UNIVERSITY OF PENNSYLVANIA,1,0,2000,NA,NA,2270,1125,1145,1986,967,1019,0.9,0.84,0.87,22682,3009,994,1224
215062,UNIVERSITY OF PENNSYLVANIA,1,0,2001,NA,NA,2316,1148,1168,2018,997,1021,0.88,0.85,0.87,23998,3113,1010,1163
215062,UNIVERSITY OF PENNSYLVANIA,1,0,2002,NA,NA,2373,1183,1190,2096,1030,1066,0.9,0.87,0.88,25078,3310,1019,1201
215062,UNIVERSITY OF PENNSYLVANIA,1,0,2003,NA,NA,2378,1221,1157,2082,992,1090,0.89,0.86,0.88,26282,3562,1031,1211
215062,UNIVERSITY OF PENNSYLVANIA,1,0,2004,NA,NA,2359,1191,1168,2090,999,1091,0.91,0.86,0.89,27544,3716,1055,1090
215062,University of Pennsylvania,1,0,2005,NA,NA,2479,1260,1219,2162,1033,1129,0.89,0.85,0.87,29030,3969,1051,1169
215062,University of Pennsylvania,1,0,2006,NA,NA,2334,1193,1141,2036,952,1084,0.9,0.83,0.87,30598,4197,1065,1017
215062,University of Pennsylvania,1,0,2007,NA,NA,2342,1107,1235,2058,1052,1006,0.9,0.85,0.88,32160,4423,1081,1050
215062,University of Pennsylvania,1,0,2008,NA,NA,2392,1278,1114,2078,943,1135,0.88,0.85,0.87,33608,4730,1293,916
215062,University of Pennsylvania,1,0,2009,NA,NA,2402,1232,1170,2091,976,1115,0.9,0.83,0.87,34868,5015,1297,870
215062,University of Pennsylvania,1,0,2010,NA,NA,2363,1213,1150,1999,917,1082,0.89,0.8,0.85,36208,5263,1257,1158
215743,SAINT FRANCIS COLLEGE,1,0,1991,NA,NA,279,144,135,97,38,59,0.4,0.28,0.35,9596,18,57,265
215743,SAINT FRANCIS COLLEGE,1,0,1992,NA,NA,297,145,152,121,58,63,0.43,0.38,0.41,10384,21,62,287
215743,SAINT FRANCIS COLLEGE,1,0,1993,NA,NA,285,136,149,115,49,66,0.48,0.33,0.4,10480,24,66,266
215743,SAINT FRANCIS COLLEGE,1,0,1995,NA,NA,334,145,189,135,61,74,0.51,0.32,0.4,11850,26,74,320
215743,SAINT FRANCIS COLLEGE,1,0,1996,NA,NA,346,205,141,95,24,71,0.34,0.17,0.27,12475,27,74,311
215743,SAINT FRANCIS COLLEGE,1,0,1997,NA,NA,354,200,154,79,22,57,0.28,0.14,0.22,13120,24,76,314
215743,SAINT FRANCIS COLLEGE,1,0,1998,NA,NA,335,182,153,90,47,43,0.23,0.31,0.27,13510,25,78,298
215743,SAINT FRANCIS COLLEGE,1,0,1999,NA,NA,333,215,118,147,34,113,0.52,0.29,0.44,14100,29,81,285
215743,SAINT FRANCIS COLLEGE,1,0,2000,NA,NA,355,210,145,159,58,101,0.48,0.4,0.45,15808,31,83,263
215743,SAINT FRANCIS UNIVERSITY,1,0,2001,NA,NA,342,187,155,163,60,103,0.55,0.39,0.48,16512,33,86,272
215743,SAINT FRANCIS UNIVERSITY,1,0,2002,NA,NA,281,154,127,122,47,75,0.48,0.37,0.43,17024,35,90,224
215743,SAINT FRANCIS UNIVERSITY,1,0,2003,NA,NA,332,200,132,174,63,111,0.55,0.48,0.52,18292,39,90,279
215743,SAINT FRANCIS UNIVERSITY,1,0,2004,NA,NA,321,198,123,175,48,127,0.64,0.39,0.55,19390,40,87,271
215743,Saint Francis University,1,0,2005,NA,NA,364,220,144,190,59,131,0.59,0.41,0.52,20360,40,84,294
215743,Saint Francis University,1,0,2006,NA,NA,384,234,150,194,66,128,0.54,0.44,0.51,21174,40,97,304
215743,Saint Francis University,1,0,2007,NA,NA,403,258,145,230,71,159,0.61,0.49,0.57,22444,44,99,356
215743,Saint Francis University,1,0,2008,NA,NA,412,224,188,254,99,155,0.6900000000000001,0.53,0.62,23790,48,102,363
215743,Saint Francis University,1,0,2009,NA,NA,349,207,142,15,3,12,0.05,0.02,0.04,24504,52,108,308
215743,Saint Francis University,1,0,2010,NA,NA,429,258,171,243,82,161,0.62,0.48,0.57,25484,54,113,353
215798,SAINT VINCENT COLLEGE,1,0,1991,NA,NA,228,118,110,129,51,78,0.66,0.46,0.57,8760,16,61,214
215798,SAINT VINCENT COLLEGE,1,0,1992,NA,NA,267,152,115,148,50,98,0.64,0.43,0.55,9360,19,59,260
215798,SAINT VINCENT COLLEGE,1,0,1993,NA,NA,277,122,155,144,74,70,0.5700000000000001,0.48,0.52,9900,20,64,266
215798,SAINT VINCENT COLLEGE,1,0,1995,NA,NA,260,129,131,161,72,89,0.68,0.55,0.62,11310,23,60,247
215798,SAINT VINCENT COLLEGE,1,0,1996,NA,NA,271,136,135,168,76,92,0.67,0.56,0.62,12100,26,60,259
215798,SAINT VINCENT COLLEGE,1,0,1997,NA,NA,272,129,143,159,77,82,0.63,0.54,0.58,13030,21,59,264
215798,SAINT VINCENT COLLEGE,1,0,1998,NA,NA,262,135,127,153,73,80,0.59,0.57,0.58,13780,22,62,251
215798,SAINT VINCENT COLLEGE,1,0,1999,NA,NA,272,138,134,162,74,88,0.63,0.55,0.6,14250,23,65,251
215798,SAINT VINCENT COLLEGE,1,0,2000,NA,NA,302,141,161,192,99,93,0.65,0.61,0.64,15531,25,63,281
215798,SAINT VINCENT COLLEGE,1,0,2001,NA,NA,262,128,134,161,69,92,0.71,0.51,0.61,16585,26,61,241
215798,SAINT VINCENT COLLEGE,1,0,2002,NA,NA,322,159,163,209,102,107,0.67,0.63,0.65,18080,27,67,296
215798,SAINT VINCENT COLLEGE,1,0,2003,NA,NA,362,196,166,221,91,130,0.66,0.55,0.61,19000,30,72,345
215798,SAINT VINCENT COLLEGE,1,0,2004,NA,NA,331,186,145,226,93,133,0.71,0.64,0.68,20312,37,76,282
215798,Saint Vincent College,1,0,2005,NA,NA,481,254,227,308,141,167,0.65,0.62,0.64,21104,35,84,430
215798,Saint Vincent College,1,0,2006,NA,NA,437,217,220,272,133,139,0.64,0.6,0.62,22350,38,86,401
215798,Saint Vincent College,1,0,2007,NA,NA,423,200,223,269,130,139,0.6900000000000001,0.58,0.64,23459,42,92,389
215798,Saint Vincent College,1,0,2008,NA,NA,442,195,247,302,167,135,0.6900000000000001,0.68,0.68,24620,45,99,386
215798,Saint Vincent College,1,0,2009,NA,NA,446,197,249,267,125,142,0.72,0.5,0.6,25350,48,104,388
215798,Saint Vincent College,1,0,2010,NA,NA,422,202,220,261,113,148,0.73,0.51,0.62,26350,48,101,372
215929,UNIVERSITY OF SCRANTON,1,0,1991,NA,NA,897,457,440,646,294,352,0.77,0.67,0.72,9530,60,241,840
215929,UNIVERSITY OF SCRANTON,1,0,1992,NA,NA,898,495,403,605,262,343,0.6900000000000001,0.65,0.67,9920,72,241,814
215929,UNIVERSITY OF SCRANTON,1,0,1993,NA,NA,899,496,403,582,239,343,0.6900000000000001,0.59,0.65,10820,70,242,812
215929,UNIVERSITY OF SCRANTON,1,0,1995,NA,NA,907,515,392,590,261,329,0.63,0.67,0.65,12570,81,244,830
215929,UNIVERSITY OF SCRANTON,1,0,1996,NA,NA,948,550,398,623,254,369,0.67,0.64,0.66,15000,85,244,869
215929,UNIVERSITY OF SCRANTON,1,0,1997,NA,NA,905,538,367,644,247,397,0.73,0.67,0.71,15880,73,244,820
215929,UNIVERSITY OF SCRANTON,1,0,1998,NA,NA,873,527,346,607,217,390,0.74,0.63,0.7,16820,76,246,804
215929,UNIVERSITY OF SCRANTON,1,0,1999,NA,NA,958,550,408,675,268,407,0.74,0.66,0.7,17540,79,243,876
215929,UNIVERSITY OF SCRANTON,1,0,2000,NA,NA,833,472,361,625,259,366,0.77,0.72,0.75,18460,84,243,717
215929,UNIVERSITY OF SCRANTON,1,0,2001,NA,NA,1013,578,435,674,258,416,0.71,0.59,0.67,19330,87,244,853
215929,UNIVERSITY OF SCRANTON,1,0,2002,NA,NA,958,569,389,702,258,444,0.78,0.66,0.73,20248,90,243,795
215929,UNIVERSITY OF SCRANTON,1,0,2003,NA,NA,974,538,436,716,307,409,0.76,0.7,0.74,21208,92,247,832
215929,UNIVERSITY OF SCRANTON,1,0,2004,NA,NA,965,559,406,658,248,410,0.73,0.61,0.68,22214,95,242,769
215929,University of Scranton,1,0,2005,NA,NA,943,551,392,629,248,381,0.6900000000000001,0.63,0.67,23750,99,245,768
215929,University of Scranton,1,0,2006,NA,NA,980,585,395,740,289,451,0.77,0.73,0.76,25638,101,244,802
215929,University of Scranton,1,0,2007,NA,NA,1025,574,451,771,307,464,0.8,0.68,0.75,28458,113,253,822
215929,University of Scranton,1,0,2008,NA,NA,961,555,406,710,274,436,0.78,0.67,0.74,31276,115,253,828
215929,University of Scranton,1,0,2009,NA,NA,1027,578,449,747,296,451,0.78,0.66,0.73,32824,124,263,852
215929,University of Scranton,1,0,2010,NA,NA,950,508,442,688,291,397,0.78,0.66,0.72,34236,128,271,745
216010,SHIPPENSBURG UNIVERSITY OF PENNSYLVANIA,1,0,1991,NA,NA,1163,631,532,474,153,321,0.5,0.29,0.41,3108,53,298,1070
216010,SHIPPENSBURG UNIVERSITY OF PENNSYLVANIA,1,0,1992,NA,NA,1238,675,563,441,156,285,0.42,0.28,0.36,3388,60,288,1173
216010,SHIPPENSBURG UNIVERSITY OF PENNSYLVANIA,1,0,1993,NA,NA,1114,603,511,443,162,281,0.46,0.32,0.4,3710,64,292,1039
216010,SHIPPENSBURG UNIVERSITY OF PENNSYLVANIA,1,0,1995,NA,NA,1278,665,613,497,188,309,0.46,0.31,0.39,4010,74,299,1182
216010,SHIPPENSBURG UNIVERSITY OF PENNSYLVANIA,1,0,1996,NA,NA,1272,674,598,455,168,287,0.42,0.28,0.36,4230,76,294,1168
216010,SHIPPENSBURG UNIVERSITY OF PENNSYLVANIA,1,0,1997,NA,NA,1292,741,551,476,178,298,0.4,0.32,0.37,4344,77,296,1193
216010,SHIPPENSBURG UNIVERSITY OF PENNSYLVANIA,1,0,1998,NA,NA,1211,654,557,480,181,299,0.45,0.32,0.4,4346,79,288,1095
216010,SHIPPENSBURG UNIVERSITY OF PENNSYLVANIA,1,0,1999,NA,NA,1377,734,643,574,231,343,0.46,0.36,0.42,3618,84,295,1291
216010,SHIPPENSBURG UNIVERSITY OF PENNSYLVANIA,1,0,2000,NA,NA,1520,831,689,679,233,446,0.53,0.34,0.45,3792,89,296,1421
216010,SHIPPENSBURG UNIVERSITY OF PENNSYLVANIA,1,0,2001,NA,NA,1478,805,673,683,239,444,0.55,0.36,0.46,4016,96,297,1353
216010,SHIPPENSBURG UNIVERSITY OF PENNSYLVANIA,1,0,2002,NA,NA,1507,831,676,721,270,451,0.54,0.4,0.48,4378,91,307,1336
216010,SHIPPENSBURG UNIVERSITY OF PENNSYLVANIA,1,0,2003,NA,NA,1485,742,743,666,271,395,0.53,0.36,0.45,4598,96,307,1292
216010,SHIPPENSBURG UNIVERSITY OF PENNSYLVANIA,1,0,2004,NA,NA,1458,748,710,629,251,378,0.5,0.35,0.43,4810,99,333,1241
216010,Shippensburg University of Pennsylvania,1,0,2005,NA,NA,1495,775,720,622,233,389,0.5,0.32,0.42,4906,102,305,1261
216010,Shippensburg University of Pennsylvania,1,0,2006,NA,NA,1496,778,718,601,215,386,0.49,0.3,0.4,5038,106,321,1252
216010,Shippensburg University of Pennsylvania,1,0,2007,NA,NA,1720,927,793,639,251,388,0.41000000000000003,0.32,0.37,5178,112,316,1412
216010,Shippensburg University of Pennsylvania,1,0,2008,NA,NA,1716,871,845,638,247,391,0.44,0.29,0.37,5358,117,319,1388
216010,Shippensburg University of Pennsylvania,1,0,2009,NA,NA,1673,873,800,669,273,396,0.45,0.34,0.4,5554,121,320,1370
216010,Shippensburg University of Pennsylvania,1,0,2010,NA,NA,1706,888,818,693,275,418,0.47000000000000003,0.34,0.41,5804,126,328,1466
216038,SLIPPERY ROCK UNIVERSITY OF PENNSYLVANIA,1,0,1991,NA,NA,1191,690,501,232,76,156,0.22,0.15,0.19,3045,66,367,1100
216038,SLIPPERY ROCK UNIVERSITY OF PENNSYLVANIA,1,0,1992,NA,NA,1164,658,506,242,95,147,0.22,0.19,0.21,3287,73,380,1060
216038,SLIPPERY ROCK UNIVERSITY OF PENNSYLVANIA,1,0,1993,NA,NA,1239,739,500,247,77,170,0.23,0.15,0.2,3547,75,380,1110
216038,SLIPPERY ROCK UNIVERSITY OF PENNSYLVANIA,1,0,1995,NA,NA,1279,715,564,254,82,172,0.24,0.15,0.2,4013,82,379,1174
216038,SLIPPERY ROCK UNIVERSITY OF PENNSYLVANIA,1,0,1996,NA,NA,1197,677,520,247,85,162,0.23,0.16,0.21,4179,85,371,1079
216038,SLIPPERY ROCK UNIVERSITY OF PENNSYLVANIA,1,0,1997,NA,NA,1193,684,509,248,76,172,0.25,0.15,0.21,4302,82,371,1118
216038,SLIPPERY ROCK UNIVERSITY OF PENNSYLVANIA,1,0,1998,NA,NA,1260,713,547,297,95,202,0.28,0.17,0.24,4311,84,362,1189
216038,SLIPPERY ROCK UNIVERSITY OF PENNSYLVANIA,1,0,1999,NA,NA,1302,742,560,334,103,231,0.31,0.18,0.26,3618,88,349,1206
216038,SLIPPERY ROCK UNIVERSITY OF PENNSYLVANIA,1,0,2000,NA,NA,1346,794,552,372,105,267,0.33,0.19,0.28,3792,90,353,1229
216038,SLIPPERY ROCK UNIVERSITY OF PENNSYLVANIA,1,0,2001,NA,NA,1314,751,563,378,117,261,0.34,0.21,0.29,4016,97,358,1200
216038,SLIPPERY ROCK UNIVERSITY OF PENNSYLVANIA,1,0,2002,NA,NA,1421,796,625,416,139,277,0.34,0.22,0.29,4378,92,335,1273
216038,SLIPPERY ROCK UNIVERSITY OF PENNSYLVANIA,1,0,2003,NA,NA,1465,803,662,455,158,297,0.36,0.24,0.31,4598,102,342,1311
216038,SLIPPERY ROCK UNIVERSITY OF PENNSYLVANIA,1,0,2004,NA,NA,1530,890,640,551,196,355,0.39,0.31,0.36,4810,107,340,1383
216038,Slippery Rock University of Pennsylvania,1,0,2005,NA,NA,1457,800,657,556,216,340,0.42,0.33,0.38,4906,106,340,1315
216038,Slippery Rock University of Pennsylvania,1,0,2006,NA,NA,1416,832,584,545,185,360,0.43,0.32,0.38,5038,108,333,1228
216038,Slippery Rock University of Pennsylvania,1,0,2007,NA,NA,1498,876,622,596,185,411,0.46,0.3,0.4,5178,119,340,1272
216038,Slippery Rock University of Pennsylvania,1,0,2008,NA,NA,1527,887,640,749,272,477,0.53,0.42,0.49,5358,124,343,1262
216038,Slippery Rock University of Pennsylvania,1,0,2009,NA,NA,1534,915,619,795,258,537,0.58,0.42,0.52,5554,133,352,1312
216038,Slippery Rock University of Pennsylvania,1,0,2010,NA,NA,1562,969,593,808,265,543,0.56,0.45,0.52,5804,134,354,1378
216287,SWARTHMORE COLLEGE,1,0,1991,NA,NA,319,148,171,266,138,128,0.86,0.81,0.83,16640,53,155,247
216287,SWARTHMORE COLLEGE,1,0,1992,NA,NA,353,172,181,285,143,142,0.8200000000000001,0.79,0.81,17646,62,154,255
216287,SWARTHMORE COLLEGE,1,0,1993,NA,NA,413,226,187,348,149,199,0.88,0.8,0.84,18482,57,162,289
216287,SWARTHMORE COLLEGE,1,0,1995,NA,NA,354,190,164,308,134,174,0.91,0.82,0.87,20186,66,161,266
216287,SWARTHMORE COLLEGE,1,0,1996,NA,NA,412,217,195,354,167,187,0.86,0.86,0.86,21054,70,157,243
216287,SWARTHMORE COLLEGE,1,0,1997,NA,NA,373,193,180,309,136,173,0.89,0.76,0.83,22000,64,167,232
216287,SWARTHMORE COLLEGE,1,0,1998,NA,NA,361,193,168,297,132,165,0.85,0.79,0.82,23240,69,173,210
216287,SWARTHMORE COLLEGE,1,0,1999,NA,NA,368,192,176,315,142,173,0.9,0.81,0.86,23964,73,174,222
216287,SWARTHMORE COLLEGE,1,0,2000,NA,NA,366,195,171,316,141,175,0.89,0.82,0.86,24950,80,170,227
216287,SWARTHMORE COLLEGE,1,0,2001,NA,NA,380,193,187,346,165,181,0.93,0.88,0.91,26098,87,167,218
216287,SWARTHMORE COLLEGE,1,0,2002,NA,NA,371,189,182,326,155,171,0.9,0.85,0.88,27272,91,173,197
216287,SWARTHMORE COLLEGE,1,0,2003,NA,NA,368,198,170,316,141,175,0.88,0.83,0.86,28500,97,195,173
216287,SWARTHMORE COLLEGE,1,0,2004,NA,NA,365,189,176,324,153,171,0.9,0.87,0.89,29782,99,192,151
216287,Swarthmore College,1,0,2005,NA,NA,389,198,191,355,171,184,0.92,0.9,0.91,31196,100,194,170
216287,Swarthmore College,1,0,2006,NA,NA,370,193,177,318,143,175,0.9,0.81,0.86,32912,106,192,166
216287,Swarthmore College,1,0,2007,NA,NA,365,190,175,324,152,172,0.9,0.87,0.89,34564,114,202,162
216287,Swarthmore College,1,0,2008,NA,NA,372,184,188,330,159,171,0.92,0.85,0.89,36154,118,193,163
216287,Swarthmore College,1,0,2009,NA,NA,394,204,190,343,159,184,0.9,0.84,0.87,37510,121,197,165
216287,Swarthmore College,1,0,2010,NA,NA,387,195,192,339,169,170,0.87,0.88,0.88,39260,118,189,183
216339,TEMPLE UNIVERSITY,1,0,1991,NA,NA,2084,1071,1013,287,115,172,0.16,0.11,0.14,4756,634,1130,1252
216339,TEMPLE UNIVERSITY,1,0,1992,NA,NA,2029,1068,961,337,124,213,0.19,0.13,0.17,5008,702,1156,1130
216339,TEMPLE UNIVERSITY,1,0,1993,NA,NA,2186,1209,977,355,141,214,0.17,0.14,0.16,5226,755,1147,1263
216339,TEMPLE UNIVERSITY,1,0,1995,NA,NA,2302,1366,936,440,143,297,0.21,0.15,0.19,5514,889,1119,1090
216339,TEMPLE UNIVERSITY,1,0,1996,NA,NA,2155,1284,871,442,138,304,0.23,0.16,0.21,5828,1002,1119,1001
216339,TEMPLE UNIVERSITY,1,0,1997,NA,NA,2149,1233,916,503,176,327,0.26,0.19,0.23,6150,1023,1090,1016
216339,TEMPLE UNIVERSITY,1,0,1998,NA,NA,2150,1279,871,521,171,350,0.27,0.2,0.24,6378,1152,1071,1077
216339,TEMPLE UNIVERSITY,1,0,1999,NA,NA,2747,1628,1119,721,228,493,0.3,0.2,0.26,6332,1284,1066,1396
216339,TEMPLE UNIVERSITY,1,0,2000,NA,NA,3031,1767,1264,857,318,539,0.3,0.25,0.28,6648,1430,1114,1536
216339,TEMPLE UNIVERSITY,1,0,2001,NA,NA,3157,1826,1331,919,319,600,0.32,0.24,0.29,6974,1429,1162,1694
216339,TEMPLE UNIVERSITY,1,0,2002,NA,NA,3467,2034,1433,1170,394,776,0.38,0.27,0.34,7602,1569,1196,2075
216339,TEMPLE UNIVERSITY,1,0,2003,NA,NA,3590,2106,1484,1232,459,773,0.36,0.31,0.34,8134,1517,1220,2203
216339,TEMPLE UNIVERSITY,1,0,2004,NA,NA,3788,2184,1604,1216,468,748,0.34,0.29,0.32,8622,1645,1207,2290
216339,Temple University,1,0,2005,NA,NA,3841,2175,1666,1247,483,764,0.35000000000000003,0.29,0.32,9140,1735,1225,2295
216339,Temple University,1,0,2006,NA,NA,3848,2105,1743,1377,578,799,0.37,0.33,0.36,9680,1805,1245,2224
216339,Temple University,1,0,2007,NA,NA,4385,2478,1907,1705,684,1021,0.41000000000000003,0.36,0.39,10252,1804,1303,2607
216339,Temple University,1,0,2008,NA,NA,4157,2260,1897,1718,663,1055,0.46,0.35,0.41,10858,1984,1383,2511
216339,Temple University,1,0,2009,NA,NA,4183,2320,1863,1808,687,1121,0.48,0.37,0.43,11174,2072,1427,2575
216339,Temple University,1,0,2010,NA,NA,4305,2273,2032,1920,783,1137,0.5,0.39,0.45,11834,2069,1462,2770
216524,URSINUS COLLEGE,1,0,1991,NA,NA,234,124,110,155,69,86,0.6900000000000001,0.63,0.66,12555,24,89,205
216524,URSINUS COLLEGE,1,0,1992,NA,NA,403,199,204,285,131,154,0.77,0.64,0.71,13330,24,87,363
216524,URSINUS COLLEGE,1,0,1993,NA,NA,308,159,149,226,108,118,0.74,0.72,0.73,14265,28,92,281
216524,URSINUS COLLEGE,1,0,1995,NA,NA,315,170,145,230,106,124,0.72,0.73,0.73,15840,31,85,270
216524,URSINUS COLLEGE,1,0,1996,NA,NA,327,180,147,244,105,139,0.77,0.71,0.75,16600,34,84,281
216524,URSINUS COLLEGE,1,0,1997,NA,NA,314,162,152,236,117,119,0.73,0.77,0.75,17380,26,87,260
216524,URSINUS COLLEGE,1,0,1998,NA,NA,336,189,147,249,93,156,0.8200000000000001,0.63,0.74,18520,27,86,280
216524,URSINUS COLLEGE,1,0,1999,NA,NA,337,173,164,241,106,135,0.78,0.65,0.72,19950,29,92,271
216524,URSINUS COLLEGE,1,0,2000,NA,NA,376,214,162,287,112,175,0.81,0.69,0.76,21050,31,94,313
216524,URSINUS COLLEGE,1,0,2001,NA,NA,387,230,157,278,114,164,0.71,0.73,0.72,24850,34,96,314
216524,URSINUS COLLEGE,1,0,2002,NA,NA,427,212,215,301,134,167,0.78,0.62,0.7,26200,36,102,348
216524,URSINUS COLLEGE,1,0,2003,NA,NA,453,233,220,356,163,193,0.8200000000000001,0.74,0.79,27500,38,110,338
216524,URSINUS COLLEGE,1,0,2004,NA,NA,393,200,193,303,142,161,0.8,0.74,0.77,29650,41,114,305
216524,Ursinus College,1,0,2005,NA,NA,411,222,189,309,136,173,0.77,0.72,0.75,31450,45,115,294
216524,Ursinus College,1,0,2006,NA,NA,405,217,188,287,126,161,0.74,0.67,0.71,33200,49,120,300
216524,Ursinus College,1,0,2007,NA,NA,468,242,226,353,159,194,0.8,0.7,0.75,35000,49,120,354
216524,Ursinus College,1,0,2008,NA,NA,543,304,239,428,181,247,0.81,0.76,0.79,36750,52,122,376
216524,Ursinus College,1,0,2009,NA,NA,509,260,249,379,178,201,0.77,0.71,0.74,38500,56,125,406
216524,Ursinus College,1,0,2010,NA,NA,441,236,205,323,144,179,0.75,0.7,0.73,39950,59,127,332
216694,WAYNESBURG COLLEGE,1,0,1991,NA,NA,317,185,132,112,33,79,0.42,0.25,0.35,7690,13,64,294
216694,WAYNESBURG COLLEGE,1,0,1992,NA,NA,346,178,168,158,65,93,0.52,0.39,0.46,8120,15,67,333
216694,WAYNESBURG COLLEGE,1,0,1993,NA,NA,325,180,145,132,51,81,0.45,0.35,0.41,8580,16,67,293
216694,WAYNESBURG COLLEGE,1,0,1995,NA,NA,295,141,154,109,46,63,0.44,0.3,0.37,9600,19,65,275
216694,WAYNESBURG COLLEGE,1,0,1996,NA,NA,305,134,171,138,59,79,0.58,0.35,0.45,10040,19,58,287
216694,WAYNESBURG COLLEGE,1,0,1997,NA,NA,309,123,186,132,72,60,0.48,0.39,0.43,10550,18,53,281
216694,WAYNESBURG COLLEGE,1,0,1998,NA,NA,290,113,177,116,60,56,0.49,0.34,0.4,10970,15,55,258
216694,WAYNESBURG COLLEGE,1,0,1999,NA,NA,277,126,151,121,64,57,0.45,0.42,0.44,11160,16,55,251
216694,WAYNESBURG COLLEGE,1,0,2000,NA,NA,328,160,168,146,57,89,0.55,0.34,0.45,11670,22,57,314
216694,WAYNESBURG COLLEGE,1,0,2001,NA,NA,315,159,156,141,56,85,0.53,0.36,0.45,12250,26,59,292
216694,WAYNESBURG COLLEGE,1,0,2002,NA,NA,297,141,156,142,50,92,0.65,0.32,0.48,12870,26,62,274
216694,WAYNESBURG COLLEGE,1,0,2003,NA,NA,327,157,170,157,70,87,0.55,0.41,0.48,13520,25,61,308
216694,WAYNESBURG COLLEGE,1,0,2004,NA,NA,367,189,178,175,70,105,0.55,0.39,0.48,14200,25,63,330
216694,Waynesburg College,1,0,2005,NA,NA,340,208,132,171,58,113,0.54,0.44,0.5,14810,28,62,294
216694,Waynesburg College,1,0,2006,NA,NA,322,172,150,174,69,105,0.61,0.46,0.54,15440,31,63,287
216694,Waynesburg University,1,0,2007,NA,NA,402,232,170,182,67,115,0.49,0.39,0.45,16080,29,65,374
216694,Waynesburg University,1,0,2008,NA,NA,376,218,158,195,76,119,0.54,0.48,0.52,16730,34,67,351
216694,Waynesburg University,1,0,2009,NA,NA,380,221,159,211,77,134,0.6,0.48,0.56,17400,35,72,353
216694,Waynesburg University,1,0,2010,NA,NA,401,229,172,213,77,136,0.59,0.45,0.53,18050,37,76,371
216764,WEST CHESTER UNIVERSITY OF PENNSYLVANIA,1,0,1991,NA,NA,1467,960,507,337,79,258,0.26,0.16,0.23,2918,88,491,1275
216764,WEST CHESTER UNIVERSITY OF PENNSYLVANIA,1,0,1992,NA,NA,1378,883,495,357,90,267,0.3,0.18,0.26,3158,93,495,1209
216764,WEST CHESTER UNIVERSITY OF PENNSYLVANIA,1,0,1993,NA,NA,1386,876,510,346,74,272,0.31,0.15,0.25,3504,93,483,1170
216764,WEST CHESTER UNIVERSITY OF PENNSYLVANIA,1,0,1995,NA,NA,1384,873,511,363,85,278,0.31,0.17,0.26,3874,104,478,1180
216764,WEST CHESTER UNIVERSITY OF PENNSYLVANIA,1,0,1996,NA,NA,1454,943,511,376,88,288,0.3,0.17,0.26,4032,110,464,1223
216764,WEST CHESTER UNIVERSITY OF PENNSYLVANIA,1,0,1997,NA,NA,1581,1025,556,409,93,316,0.3,0.17,0.26,4162,114,463,1374
216764,WEST CHESTER UNIVERSITY OF PENNSYLVANIA,1,0,1998,NA,NA,1629,1031,598,474,124,350,0.33,0.21,0.29,4248,121,468,1418
216764,WEST CHESTER UNIVERSITY OF PENNSYLVANIA,1,0,1999,NA,NA,1710,1069,641,444,122,322,0.3,0.19,0.26,3618,126,453,1513
216764,WEST CHESTER UNIVERSITY OF PENNSYLVANIA,1,0,2000,NA,NA,1715,1085,630,536,127,409,0.37,0.2,0.31,3792,136,467,1506
216764,WEST CHESTER UNIVERSITY OF PENNSYLVANIA,1,0,2001,NA,NA,1626,1020,606,561,144,417,0.4,0.24,0.35,4016,147,482,1390
216764,WEST CHESTER UNIVERSITY OF PENNSYLVANIA,1,0,2002,NA,NA,1766,1104,662,642,168,474,0.42,0.25,0.36,4378,141,537,1535
216764,WEST CHESTER UNIVERSITY OF PENNSYLVANIA,1,0,2003,NA,NA,1723,1119,604,685,152,533,0.47000000000000003,0.25,0.4,4598,149,504,1441
216764,WEST CHESTER UNIVERSITY OF PENNSYLVANIA,1,0,2004,NA,NA,1870,1214,656,734,177,557,0.45,0.27,0.39,4810,150,512,1607
216764,West Chester University of Pennsylvania,1,0,2005,NA,NA,1898,1219,679,812,216,596,0.48,0.32,0.43,4906,160,527,1616
216764,West Chester University of Pennsylvania,1,0,2006,NA,NA,1883,1200,683,803,196,607,0.5,0.29,0.43,5038,165,520,1597
216764,West Chester University of Pennsylvania,1,0,2007,NA,NA,1955,1215,740,857,235,622,0.51,0.32,0.44,5177,176,545,1655
216764,West Chester University of Pennsylvania,1,0,2008,NA,NA,1992,1231,761,872,232,640,0.51,0.3,0.44,5358,190,568,1644
216764,West Chester University of Pennsylvania,1,0,2009,NA,NA,2241,1353,888,954,277,677,0.5,0.31,0.43,5554,196,516,1908
216764,West Chester University of Pennsylvania,1,0,2010,NA,NA,2060,1295,765,946,263,683,0.52,0.34,0.46,5804,204,540,1643
216807,WESTMINSTER COLLEGE,1,0,1991,NA,NA,319,175,144,223,99,124,0.7000000000000001,0.69,0.7,10580,23,92,312
216807,WESTMINSTER COLLEGE,1,0,1992,NA,NA,362,213,149,227,89,138,0.64,0.6,0.63,11210,25,91,350
216807,WESTMINSTER COLLEGE,1,0,1993,NA,NA,375,216,159,250,93,157,0.72,0.58,0.67,11770,25,93,362
216807,WESTMINSTER COLLEGE,1,0,1995,NA,NA,376,230,146,250,86,164,0.71,0.59,0.66,13950,29,100,364
216807,WESTMINSTER COLLEGE,1,0,1996,NA,NA,304,176,128,208,78,130,0.73,0.61,0.68,14535,30,98,293
216807,WESTMINSTER COLLEGE,1,0,1997,NA,NA,394,239,155,259,93,166,0.6900000000000001,0.6,0.66,14650,23,97,383
216807,WESTMINSTER COLLEGE,1,0,1998,NA,NA,372,236,136,252,79,173,0.73,0.58,0.68,15510,24,96,365
216807,WESTMINSTER COLLEGE,1,0,1999,NA,NA,351,224,127,228,69,159,0.7000000000000001,0.54,0.65,15485,23,95,347
216807,WESTMINSTER COLLEGE,1,0,2000,NA,NA,340,199,141,230,87,143,0.71,0.62,0.68,16180,24,99,285
216807,WESTMINSTER COLLEGE,1,0,2001,NA,NA,375,219,156,224,76,148,0.67,0.49,0.6,16920,26,103,286
216807,WESTMINSTER COLLEGE,1,0,2002,NA,NA,350,235,115,208,56,152,0.64,0.49,0.59,18100,28,101,272
216807,WESTMINSTER COLLEGE,1,0,2003,NA,NA,337,206,131,200,61,139,0.67,0.47,0.59,19370,29,100,242
216807,WESTMINSTER COLLEGE,1,0,2004,NA,NA,378,235,143,225,72,153,0.65,0.5,0.6,20530,31,100,269
216807,Westminster College,1,0,2005,NA,NA,360,231,129,223,75,148,0.64,0.58,0.62,21700,33,103,301
216807,Westminster College,1,0,2006,NA,NA,311,180,131,225,87,138,0.76,0.66,0.72,23220,33,105,265
216807,Westminster College,1,0,2007,NA,NA,311,179,132,195,76,119,0.66,0.58,0.63,24430,34,104,258
216807,Westminster College,1,0,2008,NA,NA,441,246,195,313,128,185,0.75,0.66,0.71,25900,35,101,381
216807,Westminster College,1,0,2009,NA,NA,451,277,174,313,117,196,0.7000000000000001,0.67,0.69,26940,36,110,377
216807,Westminster College,1,0,2010,NA,NA,402,248,154,274,99,175,0.7000000000000001,0.64,0.68,28020,37,109,341
216852,WIDENER UNIVERSITY PENNSYLVANIA CAMPUS,1,0,1991,NA,NA,464,206,258,172,81,91,0.44,0.31,0.37,10500,76,250,390
216852,WIDENER UNIVERSITY PENNSYLVANIA CAMPUS,1,0,1992,NA,NA,436,169,267,140,66,74,0.43,0.25,0.32,11120,79,211,369
216852,WIDENER UNIVERSITY-MAIN CAMPUS,1,0,1993,NA,NA,473,215,258,182,79,103,0.47000000000000003,0.31,0.38,11740,84,216,375
216852,WIDENER UNIVERSITY-MAIN CAMPUS,1,0,1995,NA,NA,421,175,246,141,64,77,0.44,0.26,0.33,12950,95,215,361
216852,WIDENER UNIVERSITY-MAIN CAMPUS,1,0,1996,NA,NA,462,217,245,172,73,99,0.45,0.3,0.37,13560,101,218,365
216852,WIDENER UNIVERSITY-MAIN CAMPUS,1,0,1997,NA,NA,391,174,217,145,65,80,0.45,0.3,0.37,14380,83,218,318
216852,WIDENER UNIVERSITY-MAIN CAMPUS,1,0,1998,NA,NA,490,207,283,204,111,93,0.44,0.39,0.42,15750,83,219,427
216852,WIDENER UNIVERSITY-MAIN CAMPUS,1,0,1999,NA,NA,548,250,298,213,100,113,0.45,0.34,0.39,16750,85,220,460
216852,WIDENER UNIVERSITY-MAIN CAMPUS,1,0,2000,NA,NA,534,231,303,218,96,122,0.52,0.32,0.41,17950,89,219,466
216852,WIDENER UNIVERSITY-MAIN CAMPUS,1,0,2001,NA,NA,550,227,323,188,78,110,0.48,0.24,0.34,19300,90,218,410
216852,WIDENER UNIVERSITY-MAIN CAMPUS,1,0,2002,NA,NA,716,327,389,284,119,165,0.5,0.31,0.4,20450,95,219,538
216852,WIDENER UNIVERSITY-MAIN CAMPUS,1,0,2003,NA,NA,578,286,292,237,90,147,0.51,0.31,0.41,21400,101,219,445
216852,WIDENER UNIVERSITY-MAIN CAMPUS,1,0,2004,NA,NA,736,342,394,247,97,150,0.43,0.25,0.34,22800,108,244,527
216852,Widener University-Main Campus,1,0,2005,NA,NA,646,332,314,258,98,160,0.48,0.31,0.4,24620,117,248,449
216852,Widener University-Main Campus,1,0,2006,NA,NA,740,354,386,317,135,182,0.51,0.35,0.43,26350,124,253,466
216852,Widener University-Main Campus,1,0,2007,NA,NA,782,382,400,312,133,179,0.46,0.33,0.4,28180,129,219,575
216852,Widener University-Main Campus,1,0,2008,NA,NA,718,337,381,266,121,145,0.43,0.32,0.37,29990,136,220,547
216852,Widener University-Main Campus,1,0,2009,NA,NA,710,372,338,304,127,177,0.47000000000000003,0.38,0.43,31340,140,226,505
216852,Widener University-Main Campus,1,0,2010,NA,NA,718,371,347,298,116,182,0.49,0.33,0.42,32750,145,228,512
216931,WILKES UNIVERSITY,1,0,1991,NA,NA,395,170,225,154,71,83,0.48,0.32,0.39,9275,33,149,378
216931,WILKES UNIVERSITY,1,0,1992,NA,NA,404,164,240,153,73,80,0.48,0.3,0.38,9868,35,140,383
216931,WILKES UNIVERSITY,1,0,1993,NA,NA,434,198,236,177,85,92,0.46,0.36,0.41,10898,35,138,412
216931,WILKES UNIVERSITY,1,0,1995,NA,NA,369,167,202,118,60,58,0.34,0.3,0.32,12473,41,134,352
216931,WILKES UNIVERSITY,1,0,1996,NA,NA,448,181,267,154,83,71,0.39,0.31,0.34,13147,42,134,415
216931,WILKES UNIVERSITY,1,0,1997,NA,NA,355,168,187,161,72,89,0.52,0.39,0.45,15091,34,125,331
216931,WILKES UNIVERSITY,1,0,1998,NA,NA,376,160,216,148,70,78,0.48,0.32,0.39,15702,32,116,353
216931,WILKES UNIVERSITY,1,0,1999,NA,NA,377,161,216,166,88,78,0.48,0.41,0.44,15652,34,114,364
216931,WILKES UNIVERSITY,1,0,2000,NA,NA,460,196,264,194,93,101,0.51,0.35,0.42,16388,33,110,439
216931,WILKES UNIVERSITY,1,0,2001,NA,NA,407,198,209,198,99,99,0.5,0.47,0.49,17142,36,106,381
216931,WILKES UNIVERSITY,1,0,2002,NA,NA,471,239,232,224,101,123,0.51,0.44,0.48,17956,41,106,444
216931,WILKES UNIVERSITY,1,0,2003,NA,NA,509,235,274,254,107,147,0.62,0.39,0.5,18680,43,112,481
216931,WILKES UNIVERSITY,1,0,2004,NA,NA,550,296,254,287,128,159,0.53,0.5,0.52,19428,47,120,507
216931,Wilkes University,1,0,2005,NA,NA,562,297,265,270,114,156,0.52,0.43,0.48,20592,51,131,501
216931,Wilkes University,1,0,2006,NA,NA,570,285,285,279,133,146,0.51,0.47,0.49,21830,59,133,510
216931,Wilkes University,1,0,2007,NA,NA,620,299,321,291,146,145,0.48,0.45,0.47,22820,66,136,530
216931,Wilkes University,1,0,2008,NA,NA,559,290,269,249,114,135,0.46,0.42,0.45,23850,68,146,443
216931,Wilkes University,1,0,2009,NA,NA,527,243,284,250,121,129,0.53,0.43,0.47,24690,73,148,437
216931,Wilkes University,1,0,2010,NA,NA,499,249,250,240,106,134,0.53,0.42,0.48,25802,76,157,337
217059,YORK COLLEGE PENNSYLVANIA,1,0,1991,NA,NA,697,396,301,265,88,177,0.44,0.29,0.38,4380,19,108,676
217059,YORK COLLEGE PENNSYLVANIA,1,0,1992,NA,NA,691,414,277,263,87,176,0.42,0.31,0.38,4645,21,114,662
217059,YORK COLLEGE PENNSYLVANIA,1,0,1993,NA,NA,691,397,294,274,102,172,0.43,0.35,0.4,4995,23,113,656
217059,YORK COLLEGE PENNSYLVANIA,1,0,1995,NA,NA,851,483,368,350,121,229,0.47000000000000003,0.33,0.41,5730,27,115,819
217059,YORK COLLEGE PENNSYLVANIA,1,0,1996,NA,NA,805,443,362,319,122,197,0.44,0.34,0.4,5790,28,119,774
217059,YORK COLLEGE PENNSYLVANIA,1,0,1997,NA,NA,842,496,346,348,128,220,0.44,0.37,0.41,6100,28,124,812
217059,YORK COLLEGE PENNSYLVANIA,1,0,1998,NA,NA,853,462,391,370,145,225,0.48,0.37,0.43,6310,31,128,809
217059,YORK COLLEGE PENNSYLVANIA,1,0,1999,NA,NA,909,511,398,372,122,250,0.48,0.31,0.41,6280,33,130,880
217059,YORK COLLEGE PENNSYLVANIA,1,0,2000,NA,NA,900,510,390,366,129,237,0.46,0.33,0.41,6600,36,134,864
217059,YORK COLLEGE PENNSYLVANIA,1,0,2001,NA,NA,968,540,428,383,137,246,0.45,0.32,0.4,7000,38,138,925
217059,YORK COLLEGE PENNSYLVANIA,1,0,2002,NA,NA,921,521,400,373,138,235,0.45,0.34,0.4,7500,42,134,878
217059,YORK COLLEGE PENNSYLVANIA,1,0,2003,NA,NA,1013,541,472,425,171,254,0.46,0.36,0.42,8000,45,133,926
217059,YORK COLLEGE PENNSYLVANIA,1,0,2004,NA,NA,1037,612,425,423,151,272,0.44,0.36,0.41,8600,49,130,949
217059,York College Pennsylvania,1,0,2005,NA,NA,1078,591,487,442,175,267,0.45,0.36,0.41,9350,53,134,970
217059,York College Pennsylvania,1,0,2006,NA,NA,1092,536,556,452,207,245,0.45,0.37,0.41,10160,60,145,945
217059,York College Pennsylvania,1,0,2007,NA,NA,1177,597,580,437,189,248,0.41000000000000003,0.33,0.37,11500,64,147,1014
217059,York College Pennsylvania,1,0,2008,NA,NA,1097,580,517,427,185,242,0.41000000000000003,0.36,0.39,12320,74,155,974
217059,York College Pennsylvania,1,0,2009,NA,NA,1092,595,497,431,144,287,0.48,0.29,0.39,13000,78,183,911
217059,York College Pennsylvania,1,0,2010,NA,NA,1231,657,574,481,182,299,0.45,0.32,0.39,13640,86,185,1053
217156,BROWN UNIVERSITY,1,0,1991,NA,NA,1358,658,700,1048,543,505,0.76,0.78,0.77,17224,244,515,879
217156,BROWN UNIVERSITY,1,0,1992,NA,NA,1406,711,695,1121,553,568,0.79,0.8,0.8,18392,254,517,889
217156,BROWN UNIVERSITY,1,0,1993,NA,NA,1424,770,654,1109,494,615,0.79,0.76,0.78,19556,270,514,961
217156,BROWN UNIVERSITY,1,0,1995,NA,NA,1370,739,631,1106,492,614,0.8300000000000001,0.78,0.81,21727,303,516,885
217156,BROWN UNIVERSITY,1,0,1996,NA,NA,1469,810,659,1220,536,684,0.84,0.81,0.83,22719,322,531,960
217156,BROWN UNIVERSITY,1,0,1997,NA,NA,1368,722,646,1136,527,609,0.84,0.82,0.83,23287,297,532,866
217156,BROWN UNIVERSITY,1,0,1998,NA,NA,1417,772,645,1180,520,660,0.85,0.81,0.83,23616,310,525,897
217156,BROWN UNIVERSITY,1,0,1999,NA,NA,1376,729,647,1146,539,607,0.8300000000000001,0.83,0.83,24624,327,539,685
217156,BROWN UNIVERSITY,1,0,2000,NA,NA,1415,767,648,1177,530,647,0.84,0.82,0.83,25600,353,567,667
217156,BROWN UNIVERSITY,1,0,2001,NA,NA,1375,760,615,1154,506,648,0.85,0.82,0.84,26568,368,596,655
217156,BROWN UNIVERSITY,1,0,2002,NA,NA,1451,817,634,1213,505,708,0.86,0.8,0.84,27856,401,621,777
217156,BROWN UNIVERSITY,1,0,2003,NA,NA,1392,736,656,1192,539,653,0.88,0.82,0.86,29200,443,657,719
217156,BROWN UNIVERSITY,1,0,2004,NA,NA,1429,744,685,1224,580,644,0.86,0.85,0.86,30672,473,651,785
217156,Brown University,1,0,2005,NA,NA,1439,735,704,1197,577,620,0.84,0.82,0.83,32264,523,643,742
217156,Brown University,1,0,2006,NA,NA,1464,740,724,1215,590,625,0.84,0.81,0.83,33888,554,687,717
217156,Brown University,1,0,2007,NA,NA,1477,814,663,1246,548,698,0.85,0.83,0.84,35584,570,714,687
217156,Brown University,1,0,2008,NA,NA,1546,813,733,1307,612,695,0.85,0.83,0.85,36928,606,738,694
217156,Brown University,1,0,2009,NA,NA,1490,770,720,1238,598,640,0.8300000000000001,0.83,0.83,38048,636,728,728
217156,Brown University,1,0,2010,NA,NA,1495,784,711,1251,599,652,0.8300000000000001,0.84,0.84,39928,658,728,683
217402,PROVIDENCE COLLEGE,1,0,1991,NA,NA,963,529,434,764,330,434,0.8200000000000001,0.76,0.79,11840,69,215,884
217402,PROVIDENCE COLLEGE,1,0,1992,NA,NA,931,523,408,734,322,412,0.78,0.79,0.79,12700,72,221,837
217402,PROVIDENCE COLLEGE,1,0,1993,NA,NA,968,503,465,775,368,407,0.8,0.79,0.8,13625,74,219,867
217402,PROVIDENCE COLLEGE,1,0,1995,NA,NA,954,589,365,795,297,498,0.84,0.81,0.83,15380,84,216,851
217402,PROVIDENCE COLLEGE,1,0,1996,NA,NA,938,556,382,786,310,476,0.85,0.81,0.84,15930,91,216,826
217402,PROVIDENCE COLLEGE,1,0,1997,NA,NA,974,563,411,801,326,475,0.84,0.79,0.82,16480,72,218,869
217402,PROVIDENCE COLLEGE,1,0,1998,NA,NA,994,599,395,813,323,490,0.81,0.82,0.82,17285,75,227,895
217402,PROVIDENCE COLLEGE,1,0,1999,NA,NA,973,556,417,838,351,487,0.87,0.84,0.86,17640,76,234,860
217402,PROVIDENCE COLLEGE,1,0,2000,NA,NA,930,527,403,775,328,447,0.84,0.81,0.83,18440,77,240,816
217402,PROVIDENCE COLLEGE,1,0,2001,NA,NA,933,531,402,795,334,461,0.86,0.83,0.85,19375,82,246,809
217402,PROVIDENCE COLLEGE,1,0,2002,NA,NA,877,540,337,734,274,460,0.85,0.81,0.84,20440,86,264,711
217402,PROVIDENCE COLLEGE,1,0,2003,NA,NA,975,561,414,823,339,484,0.86,0.82,0.84,21665,94,251,821
217402,PROVIDENCE COLLEGE,1,0,2004,NA,NA,1036,549,487,859,406,453,0.8200000000000001,0.83,0.83,23180,98,256,865
217402,Providence College,1,0,2005,NA,NA,1064,593,471,857,367,490,0.8200000000000001,0.78,0.81,24800,101,256,895
217402,Providence College,1,0,2006,NA,NA,1023,585,438,860,351,509,0.87,0.8,0.84,26780,108,260,848
217402,Providence College,1,0,2007,NA,NA,989,559,430,820,361,459,0.8200000000000001,0.84,0.83,28920,114,261,788
217402,Providence College,1,0,2008,NA,NA,987,575,412,821,336,485,0.84,0.82,0.83,30800,127,264,709
217402,Providence College,1,0,2009,NA,NA,952,549,403,772,324,448,0.81,0.8,0.81,32320,130,269,649
217402,Providence College,1,0,2010,NA,NA,1102,633,469,888,383,505,0.79,0.82,0.81,38610,136,266,839
217536,SALVE REGINA UNIVERSITY,1,0,1991,NA,NA,400,281,119,196,49,147,0.52,0.41,0.49,11930,26,109,379
217536,SALVE REGINA UNIVERSITY,1,0,1992,NA,NA,381,264,117,208,58,150,0.56,0.5,0.55,13000,26,115,360
217536,SALVE REGINA UNIVERSITY,1,0,1993,NA,NA,345,235,110,181,57,124,0.52,0.52,0.52,14200,27,124,328
217536,SALVE REGINA UNIVERSITY,1,0,1995,NA,NA,354,258,96,190,49,141,0.54,0.51,0.54,14650,29,111,286
217536,SALVE REGINA UNIVERSITY,1,0,1996,NA,NA,393,271,122,209,61,148,0.54,0.5,0.53,15190,28,107,372
217536,SALVE REGINA UNIVERSITY,1,0,1997,NA,NA,479,318,161,219,55,164,0.51,0.34,0.46,15650,24,105,442
217536,SALVE REGINA UNIVERSITY,1,0,1998,NA,NA,443,296,147,241,69,172,0.58,0.47,0.54,16300,26,104,411
217536,SALVE REGINA UNIVERSITY,1,0,1999,NA,NA,528,352,176,277,69,208,0.59,0.39,0.52,16500,29,110,487
217536,SALVE REGINA UNIVERSITY,1,0,2000,NA,NA,510,383,127,273,63,210,0.54,0.5,0.54,17200,31,107,474
217536,SALVE REGINA UNIVERSITY,1,0,2001,NA,NA,551,396,155,321,78,243,0.61,0.5,0.58,17950,34,105,498
217536,SALVE REGINA UNIVERSITY,1,0,2002,NA,NA,523,378,145,334,93,241,0.63,0.64,0.64,19000,36,105,470
217536,SALVE REGINA UNIVERSITY,1,0,2003,NA,NA,571,401,170,361,91,270,0.67,0.54,0.63,20100,39,106,492
217536,SALVE REGINA UNIVERSITY,1,0,2004,NA,NA,558,397,161,358,99,259,0.65,0.61,0.64,21750,40,113,472
217536,Salve Regina University,1,0,2005,NA,NA,562,418,144,382,82,300,0.71,0.57,0.68,23500,44,122,468
217536,Salve Regina University,1,0,2006,NA,NA,568,394,174,390,113,277,0.7000000000000001,0.65,0.69,24975,49,121,475
217536,Salve Regina University,1,0,2007,NA,NA,556,353,203,338,117,221,0.62,0.58,0.61,26750,53,122,461
217536,Salve Regina University,1,0,2008,NA,NA,556,382,174,355,94,261,0.68,0.54,0.64,28950,57,119,423
217536,Salve Regina University,1,0,2009,NA,NA,501,346,155,343,98,245,0.7000000000000001,0.63,0.68,29800,59,117,375
217536,Salve Regina University,1,0,2010,NA,NA,592,423,169,380,96,284,0.67,0.57,0.64,31250,58,110,473
217776,CENTRAL WESLEYAN COLLEGE,1,0,1991,NA,NA,78,41,37,16,6,10,0.24,0.16,0.21,7090,6,34,70
217776,CENTRAL WESLEYAN COLLEGE,1,0,1992,NA,NA,88,54,34,26,6,20,0.37,0.18,0.3,7500,7,38,80
217776,CENTRAL WESLEYAN COLLEGE,1,0,1993,NA,NA,90,48,42,23,8,15,0.31,0.19,0.26,8100,7,36,79
217776,SOUTHERN WESLEYAN UNIVERSITY,1,0,1995,NA,NA,69,32,37,11,3,8,0.25,0.08,0.16,9081,8,35,58
217776,SOUTHERN WESLEYAN UNIVERSITY,1,0,1996,NA,NA,73,36,37,19,8,11,0.3,0.22,0.26,9616,8,38,64
217776,SOUTHERN WESLEYAN UNIVERSITY,1,0,1997,NA,NA,101,51,50,27,9,18,0.35000000000000003,0.18,0.27,10180,7,38,86
217776,SOUTHERN WESLEYAN UNIVERSITY,1,0,1998,NA,NA,91,51,40,25,11,14,0.27,0.28,0.27,10840,8,40,84
217776,SOUTHERN WESLEYAN UNIVERSITY,1,0,1999,NA,NA,99,47,52,35,12,23,0.48,0.23,0.35,11148,8,41,91
217776,SOUTHERN WESLEYAN UNIVERSITY,1,0,2000,NA,NA,92,51,41,33,12,21,0.41000000000000003,0.29,0.36,11704,10,42,81
217776,SOUTHERN WESLEYAN UNIVERSITY,1,0,2001,NA,NA,139,78,61,46,18,28,0.35000000000000003,0.3,0.33,12400,12,43,103
217776,SOUTHERN WESLEYAN UNIVERSITY,1,0,2002,NA,NA,141,76,65,36,11,25,0.32,0.17,0.26,13000,13,47,105
217776,SOUTHERN WESLEYAN UNIVERSITY,1,0,2003,NA,NA,160,100,60,41,17,24,0.24,0.28,0.26,13650,16,47,129
217776,SOUTHERN WESLEYAN UNIVERSITY,1,0,2004,NA,NA,161,98,63,40,15,25,0.25,0.24,0.25,14300,18,51,122
217776,Southern Wesleyan University,1,0,2005,NA,NA,176,110,66,46,18,28,0.25,0.27,0.26,15000,19,54,127
217776,Southern Wesleyan University,1,0,2006,NA,NA,150,86,64,61,28,33,0.38,0.44,0.41,15700,21,50,123
217776,Southern Wesleyan University,1,0,2007,NA,NA,183,114,69,49,20,29,0.25,0.29,0.27,16700,21,52,135
217776,Southern Wesleyan University,1,0,2008,NA,NA,142,84,58,52,13,39,0.46,0.22,0.37,17500,22,53,114
217776,Southern Wesleyan University,1,0,2009,NA,NA,168,100,68,67,26,41,0.41000000000000003,0.38,0.4,18200,23,52,133
217776,Southern Wesleyan University,1,0,2010,NA,NA,153,80,73,77,40,37,0.46,0.55,0.5,19000,24,57,119
217819,COLLEGE OF CHARLESTON,1,0,1991,NA,NA,1434,943,491,483,104,379,0.4,0.21,0.34,2400,55,267,1277
217819,COLLEGE OF CHARLESTON,1,0,1992,NA,NA,1296,853,443,426,100,326,0.38,0.23,0.33,2650,58,293,1171
217819,COLLEGE OF CHARLESTON,1,0,1993,NA,NA,1519,1004,515,485,123,362,0.36,0.24,0.32,2950,63,320,1353
217819,COLLEGE OF CHARLESTON,1,0,1995,NA,NA,1748,1190,558,596,136,460,0.38,0.24,0.34,3090,77,347,1542
217819,COLLEGE OF CHARLESTON,1,0,1996,NA,NA,1867,1236,631,624,149,475,0.38,0.24,0.33,3190,81,368,1641
217819,COLLEGE OF CHARLESTON,1,0,1997,NA,NA,1568,1031,537,565,130,435,0.42,0.24,0.36,3290,88,378,1385
217819,COLLEGE OF CHARLESTON,1,0,1998,NA,NA,1937,1248,689,712,179,533,0.42,0.26,0.37,3390,94,394,1699
217819,COLLEGE OF CHARLESTON,1,0,1999,NA,NA,2067,1399,668,850,206,644,0.46,0.31,0.41,206,108,414,1784
217819,COLLEGE OF CHARLESTON,1,0,2000,NA,NA,1985,1337,648,835,215,620,0.46,0.33,0.42,276,115,425,1704
217819,COLLEGE OF CHARLESTON,1,0,2001,NA,NA,1967,1295,672,868,248,620,0.47000000000000003,0.37,0.44,276,122,437,1631
217819,COLLEGE OF CHARLESTON,1,0,2002,NA,NA,1991,1333,658,941,253,688,0.51,0.38,0.47,386,121,445,1693
217819,COLLEGE OF CHARLESTON,1,0,2003,NA,NA,1868,1229,639,896,251,645,0.52,0.39,0.48,386,136,469,1602
217819,COLLEGE OF CHARLESTON,1,0,2004,NA,NA,1940,1323,617,1039,268,771,0.58,0.43,0.54,456,139,481,1664
217819,College of Charleston,1,0,2005,NA,NA,1984,1342,642,1031,291,740,0.55,0.45,0.52,70,151,495,1650
217819,College of Charleston,1,0,2006,NA,NA,1959,1332,627,1132,315,817,0.61,0.5,0.58,70,159,502,1671
217819,College of Charleston,1,0,2007,NA,NA,2061,1352,709,1071,302,769,0.56,0.43,0.52,70,167,499,1722
217819,College of Charleston,1,0,2008,NA,NA,1949,1296,653,1070,318,752,0.58,0.49,0.55,70,188,503,1663
217819,College of Charleston,1,0,2009,NA,NA,2136,1497,639,1203,320,883,0.58,0.5,0.56,70,190,504,1769
217819,College of Charleston,1,0,2010,NA,NA,2001,1329,672,1162,325,837,0.62,0.48,0.58,70,199,510,1699
217882,CLEMSON UNIVERSITY,1,0,1991,NA,NA,2474,1120,1354,871,321,550,0.49,0.24,0.35,2630,291,829,2151
217882,CLEMSON UNIVERSITY,1,0,1992,NA,NA,2484,1179,1305,910,330,580,0.49,0.25,0.37,2762,308,846,2186
217882,CLEMSON UNIVERSITY,1,0,1993,NA,NA,2300,1053,1247,872,323,549,0.52,0.26,0.38,2954,312,801,2015
217882,CLEMSON UNIVERSITY,1,0,1995,NA,NA,2556,1255,1301,905,319,586,0.46,0.25,0.35,3112,331,879,2259
217882,CLEMSON UNIVERSITY,1,0,1996,NA,NA,2538,1234,1304,945,327,618,0.5,0.25,0.37,3112,323,867,2288
217882,CLEMSON UNIVERSITY,1,0,1997,NA,NA,2579,1265,1314,997,341,656,0.51,0.26,0.39,3252,345,865,2285
217882,CLEMSON UNIVERSITY,1,0,1998,NA,NA,2699,1273,1426,1091,396,695,0.54,0.28,0.4,3344,371,923,2408
217882,CLEMSON UNIVERSITY,1,0,1999,NA,NA,2886,1354,1532,1267,490,777,0.5700000000000001,0.32,0.44,2835,411,935,2566
217882,CLEMSON UNIVERSITY,1,0,2000,NA,NA,3028,1451,1577,1333,496,837,0.5700000000000001,0.31,0.44,3590,424,907,2690
217882,CLEMSON UNIVERSITY,1,0,2001,NA,NA,2530,1184,1346,1166,443,723,0.61,0.33,0.46,5090,454,880,2069
217882,CLEMSON UNIVERSITY,1,0,2002,NA,NA,2463,1214,1249,1231,462,769,0.63,0.37,0.5,5834,445,964,2072
217882,CLEMSON UNIVERSITY,1,0,2003,NA,NA,2748,1293,1455,1379,535,844,0.65,0.37,0.5,6934,479,952,2205
217882,CLEMSON UNIVERSITY,1,0,2004,NA,NA,2994,1369,1625,1488,597,891,0.65,0.37,0.5,7840,483,942,2461
217882,Clemson University,1,0,2005,NA,NA,2893,1426,1467,1565,611,954,0.66,0.42,0.54,8816,501,1014,2420
217882,Clemson University,1,0,2006,NA,NA,2755,1363,1392,1575,604,971,0.71,0.43,0.57,9056,536,1061,2269
217882,Clemson University,1,0,2007,NA,NA,2702,1304,1398,1598,677,921,0.7000000000000001,0.48,0.59,9344,576,1086,2232
217882,Clemson University,1,0,2008,NA,NA,2866,1412,1454,1747,737,1010,0.71,0.51,0.61,9886,647,1094,2356
217882,Clemson University,1,0,2009,NA,NA,3336,1564,1772,1926,853,1073,0.68,0.48,0.58,10298,626,1052,2847
217882,Clemson University,1,0,2010,NA,NA,2977,1498,1479,1755,707,1048,0.6900000000000001,0.48,0.59,11128,629,1043,2570
217998,ERSKINE COLLEGE AND SEMINARY,1,0,1991,NA,NA,101,64,37,66,21,45,0.7000000000000001,0.57,0.65,9565,8,39,97
217998,ERSKINE COLLEGE AND SEMINARY,1,0,1992,NA,NA,185,98,87,110,52,58,0.59,0.6,0.59,10125,10,39,173
217998,ERSKINE COLLEGE AND SEMINARY,1,0,1993,NA,NA,177,108,69,113,36,77,0.71,0.52,0.64,10630,10,50,170
217998,ERSKINE COLLEGE AND SEMINARY,1,0,1995,NA,NA,143,77,66,93,42,51,0.66,0.64,0.65,11823,12,51,140
217998,ERSKINE COLLEGE AND SEMINARY,1,0,1996,NA,NA,134,82,52,89,34,55,0.67,0.65,0.66,13087,12,51,128
217998,ERSKINE COLLEGE AND SEMINARY,1,0,1997,NA,NA,132,78,54,85,31,54,0.6900000000000001,0.57,0.64,13902,13,52,118
217998,ERSKINE COLLEGE AND SEMINARY,1,0,1998,NA,NA,136,84,52,89,28,61,0.72,0.54,0.65,14893,13,47,122
217998,ERSKINE COLLEGE AND SEMINARY,1,0,1999,NA,NA,156,91,65,100,33,67,0.73,0.51,0.64,14269,12,50,144
217998,ERSKINE COLLEGE AND SEMINARY,1,0,2000,NA,NA,138,79,59,89,31,58,0.73,0.53,0.64,14697,11,55,122
217998,ERSKINE COLLEGE AND SEMINARY,1,0,2001,NA,NA,217,127,90,125,44,81,0.63,0.49,0.58,15138,12,60,197
217998,ERSKINE COLLEGE AND SEMINARY,1,0,2002,NA,NA,165,100,65,87,25,62,0.62,0.38,0.53,15700,16,55,152
217998,ERSKINE COLLEGE AND SEMINARY,1,0,2003,NA,NA,176,102,74,111,43,68,0.66,0.58,0.63,16312,16,53,154
217998,ERSKINE COLLEGE AND SEMINARY,1,0,2004,NA,NA,179,106,73,97,39,58,0.54,0.53,0.54,16948,16,54,160
217998,Erskine College and Seminary,1,0,2005,NA,NA,181,90,91,82,33,49,0.54,0.36,0.45,17700,16,53,160
217998,Erskine College and Seminary,1,0,2006,NA,NA,178,100,78,101,34,67,0.67,0.44,0.57,18840,17,58,150
217998,Erskine College and Seminary,1,0,2007,NA,NA,163,94,69,84,30,54,0.5700000000000001,0.43,0.52,20185,18,59,145
217998,Erskine College and Seminary,1,0,2008,NA,NA,163,83,80,72,32,40,0.48,0.4,0.44,21590,20,62,106
217998,Erskine College and Seminary,1,0,2009,NA,NA,182,99,83,102,45,57,0.5700000000000001,0.54,0.56,23000,19,61,152
217998,Erskine College and Seminary,1,0,2010,NA,NA,144,81,63,85,34,51,0.62,0.54,0.59,24750,20,58,117
218061,FRANCIS MARION COLLEGE,1,0,1991,NA,NA,735,388,347,79,23,56,0.14,0.07,0.11,2140,24,157,587
218061,FRANCIS MARION UNIVERSITY,1,0,1992,NA,NA,875,487,388,110,42,68,0.13,0.11,0.13,2440,27,160,666
218061,FRANCIS MARION UNIVERSITY,1,0,1993,NA,NA,807,435,372,130,40,90,0.2,0.11,0.16,2800,29,166,583
218061,FRANCIS MARION UNIVERSITY,1,0,1995,NA,NA,757,405,352,140,43,97,0.23,0.12,0.18,3010,31,167,550
218061,FRANCIS MARION UNIVERSITY,1,0,1996,NA,NA,636,365,271,119,39,80,0.21,0.14,0.19,3100,32,154,442
218061,FRANCIS MARION UNIVERSITY,1,0,1997,NA,NA,582,336,246,99,34,65,0.19,0.14,0.17,3390,33,161,425
218061,FRANCIS MARION UNIVERSITY,1,0,1998,NA,NA,649,372,277,188,57,131,0.35000000000000003,0.21,0.29,3350,34,161,413
218061,FRANCIS MARION UNIVERSITY,1,0,1999,NA,NA,570,332,238,104,27,77,0.23,0.11,0.18,3260,40,159,371
218061,FRANCIS MARION UNIVERSITY,1,0,2000,NA,NA,602,356,246,95,33,62,0.17,0.13,0.16,3410,38,158,412
218061,FRANCIS MARION UNIVERSITY,1,0,2001,NA,NA,634,377,257,127,41,86,0.22,0.16,0.2,3620,39,158,403
218061,FRANCIS MARION UNIVERSITY,1,0,2002,NA,NA,734,431,303,142,48,94,0.21,0.16,0.19,4190,34,158,463
218061,FRANCIS MARION UNIVERSITY,1,0,2003,NA,NA,765,447,318,153,48,105,0.23,0.15,0.2,4947,37,164,445
218061,FRANCIS MARION UNIVERSITY,1,0,2004,NA,NA,745,463,282,139,34,105,0.22,0.12,0.19,5405,38,170,395
218061,Francis Marion University,1,0,2005,NA,NA,797,517,280,158,40,118,0.22,0.14,0.2,5849,39,175,416
218061,Francis Marion University,1,0,2006,NA,NA,795,519,276,142,34,108,0.2,0.12,0.18,6327,44,190,422
218061,Francis Marion University,1,0,2007,NA,NA,776,493,283,127,47,80,0.16,0.17,0.16,6803,47,200,419
218061,Francis Marion University,1,0,2008,NA,NA,676,452,224,104,34,70,0.15,0.15,0.15,7347,53,199,289
218061,Francis Marion University,1,0,2009,NA,NA,791,533,258,142,44,98,0.18,0.17,0.18,7625,52,199,355
218061,Francis Marion University,1,0,2010,NA,NA,737,479,258,130,40,90,0.18,0.16,0.18,8145,53,202,352
218229,LANDER COLLEGE,1,0,1991,NA,NA,421,286,135,83,18,65,0.22,0.13,0.2,2620,18,120,343
218229,LANDER COLLEGE,1,0,1992,NA,NA,402,273,129,65,16,49,0.17,0.12,0.16,2920,18,115,332
218229,LANDER UNIVERSITY,1,0,1993,NA,NA,491,327,164,80,21,59,0.18,0.13,0.16,3220,20,110,398
218229,LANDER UNIVERSITY,1,0,1995,NA,NA,477,301,176,155,46,109,0.36,0.26,0.32,3400,23,116,389
218229,LANDER UNIVERSITY,1,0,1996,NA,NA,437,273,164,134,40,94,0.34,0.24,0.31,3550,24,120,342
218229,LANDER UNIVERSITY,1,0,1997,NA,NA,434,288,146,94,23,71,0.24,0.16,0.22,5328,28,120,353
218229,LANDER UNIVERSITY,1,0,1998,NA,NA,488,322,166,92,19,73,0.22,0.11,0.19,5476,30,121,396
218229,LANDER UNIVERSITY,1,0,1999,NA,NA,494,313,181,107,22,85,0.27,0.12,0.22,5548,30,122,417
218229,LANDER UNIVERSITY,1,0,2000,NA,NA,509,321,188,88,23,65,0.2,0.12,0.17,5832,28,116,414
218229,LANDER UNIVERSITY,1,0,2001,NA,NA,488,291,197,118,25,93,0.31,0.13,0.24,4152,30,111,401
218229,LANDER UNIVERSITY,1,0,2002,NA,NA,526,335,191,117,25,92,0.27,0.13,0.22,4704,28,114,439
218229,LANDER UNIVERSITY,1,0,2003,NA,NA,541,356,185,139,30,109,0.3,0.16,0.26,5400,31,124,439
218229,LANDER UNIVERSITY,1,0,2004,NA,NA,647,440,207,140,32,108,0.24,0.15,0.22,5856,33,118,471
218229,Lander University,1,0,2005,NA,NA,555,369,186,110,34,76,0.2,0.18,0.2,6588,34,123,377
218229,Lander University,1,0,2006,NA,NA,578,379,199,127,29,98,0.25,0.15,0.22,6602,37,136,395
218229,Lander University,1,0,2007,NA,NA,433,296,137,139,35,104,0.35000000000000003,0.26,0.32,7098,37,128,315
218229,Lander University,1,0,2008,NA,NA,554,398,156,162,39,123,0.3,0.25,0.29,8380,39,130,344
218229,Lander University,1,0,2009,NA,NA,581,405,176,160,46,114,0.28,0.26,0.28,7980,40,117,383
218229,Lander University,1,0,2010,NA,NA,685,476,209,195,44,151,0.31,0.21,0.28,8374,42,126,447
218238,LIMESTONE COLLEGE,1,0,1991,NA,NA,232,126,106,17,5,12,0.09,0.05,0.07,6464,6,27,118
218238,LIMESTONE COLLEGE,1,0,1992,NA,NA,115,48,67,9,4,5,0.1,0.06,0.08,6878,8,28,80
218238,LIMESTONE COLLEGE,1,0,1993,NA,NA,214,88,126,43,22,21,0.23,0.17,0.2,7200,7,28,143
218238,LIMESTONE COLLEGE,1,0,1995,NA,NA,164,82,82,40,18,22,0.26,0.22,0.24,8000,9,31,127
218238,LIMESTONE COLLEGE,1,0,1996,NA,NA,87,38,49,16,5,11,0.28,0.1,0.18,8200,9,32,73
218238,LIMESTONE COLLEGE,1,0,1997,NA,NA,193,92,101,4,3,1,0.01,0.03,0.02,8600,12,33,141
218238,LIMESTONE COLLEGE,1,0,1998,NA,NA,112,58,54,26,8,18,0.31,0.15,0.23,9100,13,41,80
218238,LIMESTONE COLLEGE,1,0,1999,NA,NA,136,58,78,27,13,14,0.24,0.17,0.2,9500,14,50,105
218238,LIMESTONE COLLEGE,1,0,2000,NA,NA,103,49,54,23,6,17,0.34,0.11,0.22,10100,16,52,80
218238,LIMESTONE COLLEGE,1,0,2001,NA,NA,136,69,67,31,11,20,0.28,0.16,0.23,10800,18,54,107
218238,LIMESTONE COLLEGE,1,0,2002,NA,NA,180,83,97,26,12,14,0.16,0.12,0.14,11500,23,56,136
218238,LIMESTONE COLLEGE,1,0,2003,NA,NA,176,98,78,35,15,20,0.2,0.19,0.2,12300,28,65,112
218238,LIMESTONE COLLEGE,1,0,2004,NA,NA,203,95,108,41,15,26,0.27,0.14,0.2,13200,33,66,146
218238,Limestone College,1,0,2005,NA,NA,201,99,102,40,10,30,0.3,0.1,0.2,14040,41,71,137
218238,Limestone College,1,0,2006,NA,NA,206,87,119,39,17,22,0.25,0.14,0.19,15000,22,75,145
218238,Limestone College,1,0,2007,NA,NA,225,92,133,42,18,24,0.26,0.14,0.19,15900,24,76,163
218238,Limestone College,1,0,2008,NA,NA,229,98,131,29,8,21,0.21,0.06,0.13,17300,27,98,145
218238,Limestone College,1,0,2009,NA,NA,288,133,155,63,22,41,0.3,0.14,0.22,18300,26,91,179
218238,Limestone College,1,0,2010,NA,NA,275,129,146,52,19,33,0.25,0.13,0.19,19200,30,91,165
218399,MORRIS COLLEGE,1,0,1991,NA,NA,196,135,61,38,6,32,0.23,0.1,0.19,3939,9,48,0
218399,MORRIS COLLEGE,1,0,1992,NA,NA,293,177,116,40,16,24,0.13,0.14,0.14,4136,9,44,0
218399,MORRIS COLLEGE,1,0,1993,NA,NA,327,213,114,33,10,23,0.1,0.09,0.1,4290,10,46,1
218399,MORRIS COLLEGE,1,0,1995,NA,NA,241,167,74,35,8,27,0.16,0.11,0.15,4867,11,51,0
218399,MORRIS COLLEGE,1,0,1996,NA,NA,246,145,101,45,11,34,0.23,0.11,0.18,5105,12,48,0
218399,MORRIS COLLEGE,1,0,1997,NA,NA,262,180,82,68,15,53,0.29,0.18,0.26,5240,12,48,0
218399,MORRIS COLLEGE,1,0,1998,NA,NA,204,123,81,37,10,27,0.21,0.12,0.18,5515,13,48,0
218399,MORRIS COLLEGE,1,0,1999,NA,NA,263,173,90,53,10,43,0.24,0.11,0.2,5640,13,48,0
218399,MORRIS COLLEGE,1,0,2000,NA,NA,265,167,98,48,14,34,0.2,0.14,0.18,5894,15,47,0
218399,MORRIS COLLEGE,1,0,2001,NA,NA,268,167,101,56,13,43,0.25,0.13,0.21,6483,16,47,0
218399,MORRIS COLLEGE,1,0,2002,NA,NA,289,175,114,51,11,40,0.22,0.1,0.18,6783,17,48,0
218399,MORRIS COLLEGE,1,0,2003,NA,NA,276,168,108,46,9,37,0.22,0.08,0.17,7190,18,48,0
218399,MORRIS COLLEGE,1,0,2004,NA,NA,232,141,91,19,3,16,0.11,0.03,0.08,7550,18,48,0
218399,Morris College,1,0,2005,NA,NA,207,130,77,30,9,21,0.16,0.12,0.14,7828,19,47,0
218399,Morris College,1,0,2006,NA,NA,249,144,105,39,11,28,0.19,0.1,0.16,8562,16,46,0
218399,Morris College,1,0,2007,NA,NA,295,152,143,40,14,26,0.17,0.1,0.14,8990,16,46,0
218399,Morris College,1,0,2008,NA,NA,292,162,130,37,6,31,0.19,0.05,0.13,9621,19,44,1
218399,Morris College,1,0,2009,NA,NA,300,166,134,37,9,28,0.16,0.07,0.12,9630,18,48,0
218399,Morris College,1,0,2010,NA,NA,319,173,146,19,6,13,0.07,0.04,0.06,10015,19,48,0
218414,NEWBERRY COLLEGE,1,0,1991,NA,NA,189,77,112,45,21,24,0.31,0.19,0.24,7400,9,42,143
218414,NEWBERRY COLLEGE,1,0,1992,NA,NA,177,82,95,36,16,20,0.24,0.17,0.2,7900,9,46,136
218414,NEWBERRY COLLEGE,1,0,1993,NA,NA,155,62,93,44,24,20,0.32,0.26,0.28,8594,10,46,110
218414,NEWBERRY COLLEGE,1,0,1995,NA,NA,166,70,96,50,19,31,0.44,0.2,0.3,10950,12,50,125
218414,NEWBERRY COLLEGE,1,0,1996,NA,NA,234,103,131,91,36,55,0.53,0.27,0.39,11510,13,47,197
218414,NEWBERRY COLLEGE,1,0,1997,NA,NA,161,52,109,41,22,19,0.36,0.2,0.25,12322,10,46,130
218414,NEWBERRY COLLEGE,1,0,1998,NA,NA,206,92,114,74,27,47,0.51,0.24,0.36,13062,9,48,157
218414,NEWBERRY COLLEGE,1,0,1999,NA,NA,179,70,109,59,18,41,0.58,0.17,0.33,13602,9,48,139
218414,NEWBERRY COLLEGE,1,0,2000,NA,NA,181,80,101,58,25,33,0.41000000000000003,0.25,0.32,14282,10,47,131
218414,NEWBERRY COLLEGE,1,0,2001,NA,NA,178,70,108,55,26,29,0.41000000000000003,0.24,0.31,15000,10,46,129
218414,NEWBERRY COLLEGE,1,0,2002,NA,NA,250,94,156,70,33,37,0.39,0.21,0.28,15800,10,44,168
218414,NEWBERRY COLLEGE,1,0,2003,NA,NA,203,69,134,64,36,28,0.4,0.27,0.32,16640,11,43,145
218414,NEWBERRY COLLEGE,1,0,2004,NA,NA,231,90,141,73,28,45,0.5,0.2,0.32,17470,13,48,152
218414,Newberry College,1,0,2005,NA,NA,275,96,179,67,34,33,0.34,0.19,0.24,18170,13,51,178
218414,Newberry College,1,0,2006,NA,NA,264,116,148,65,24,41,0.35000000000000003,0.16,0.25,18900,15,50,173
218414,Newberry College,1,0,2007,NA,NA,323,122,201,88,41,47,0.38,0.2,0.27,19900,16,55,227
218414,Newberry College,1,0,2008,NA,NA,297,118,179,78,27,51,0.43,0.15,0.26,20500,18,54,211
218414,Newberry College,1,0,2009,NA,NA,342,133,209,84,32,52,0.39,0.15,0.25,20500,19,52,221
218414,Newberry College,1,0,2010,NA,NA,288,110,178,82,41,41,0.37,0.23,0.28,21500,21,56,203
218663,UNIVERSITY OF SOUTH CAROLINA AT COLUMBIA,1,0,1991,NA,NA,2591,1398,1193,643,242,401,0.28,0.2,0.25,2686,304,1077,1972
218663,UNIVERSITY OF SOUTH CAROLINA AT COLUMBIA,1,0,1992,NA,NA,2460,1312,1148,643,257,386,0.29,0.22,0.26,2818,306,1059,1768
218663,UNIVERSITY OF SOUTH CAROLINA AT COLUMBIA,1,0,1993,NA,NA,2298,1269,1029,681,246,435,0.34,0.24,0.3,3090,331,1034,1681
218663,UNIVERSITY OF SOUTH CAROLINA AT COLUMBIA,1,0,1995,NA,NA,2593,1477,1116,799,282,517,0.35000000000000003,0.25,0.31,3280,371,1018,1945
218663,UNIVERSITY OF SOUTH CAROLINA AT COLUMBIA,1,0,1996,NA,NA,2635,1518,1117,857,289,568,0.37,0.26,0.33,3432,391,1028,1921
218663,UNIVERSITY OF SOUTH CAROLINA AT COLUMBIA,1,0,1997,NA,NA,2919,1596,1323,1065,393,672,0.42,0.3,0.36,3534,415,1032,2220
218663,UNIVERSITY OF SOUTH CAROLINA AT COLUMBIA,1,0,1998,NA,NA,2756,1553,1203,1098,398,700,0.45,0.33,0.4,3630,441,1024,2038
218663,UNIVERSITY OF SOUTH CAROLINA AT COLUMBIA,1,0,1999,NA,NA,2596,1511,1085,1073,367,706,0.46,0.34,0.41,3640,429,1036,1915
218663,UNIVERSITY OF SOUTH CAROLINA AT COLUMBIA,1,0,2000,NA,NA,2475,1394,1081,988,351,637,0.45,0.32,0.4,3768,507,1021,1852
218663,UNIVERSITY OF SOUTH CAROLINA AT COLUMBIA,1,0,2001,NA,NA,3227,1770,1457,1304,461,843,0.47000000000000003,0.32,0.4,3964,531,1006,2415
218663,UNIVERSITY OF SOUTH CAROLINA AT COLUMBIA,1,0,2002,NA,NA,3500,1909,1591,1557,594,963,0.5,0.37,0.44,4784,512,1015,2632
218663,UNIVERSITY OF SOUTH CAROLINA-COLUMBIA,1,0,2003,NA,NA,3441,1949,1492,1578,586,992,0.5,0.39,0.46,5548,544,1011,2580
218663,UNIVERSITY OF SOUTH CAROLINA-COLUMBIA,1,0,2004,NA,NA,3330,1841,1489,1524,593,931,0.5,0.4,0.46,6156,563,1043,2319
218663,University of South Carolina-Columbia,1,0,2005,NA,NA,3677,2087,1590,1881,682,1199,0.5700000000000001,0.43,0.51,6914,620,1169,2769
218663,University of South Carolina-Columbia,1,0,2006,NA,NA,3646,2084,1562,1932,702,1230,0.59,0.45,0.53,7408,665,1163,2717
218663,University of South Carolina-Columbia,1,0,2007,NA,NA,3690,2117,1573,1999,734,1265,0.59,0.47,0.54,7946,707,1217,2995
218663,University of South Carolina-Columbia,1,0,2008,NA,NA,3826,2133,1693,2129,812,1317,0.61,0.48,0.56,8438,751,1201,2983
218663,University of South Carolina-Columbia,1,0,2009,NA,NA,3881,2089,1792,2132,825,1307,0.62,0.46,0.55,8756,722,1152,3232
218663,University of South Carolina-Columbia,1,0,2010,NA,NA,4421,2431,1990,2400,911,1489,0.61,0.46,0.54,9386,728,1178,3663
218724,UNIVERSITY OF SOUTH CAROLINA AT COASTAL CAROLINA,1,0,1991,NA,NA,584,328,256,84,26,58,0.17,0.1,0.14,2020,24,142,518
218724,UNIVERSITY OF SOUTH CAROLINA AT COASTAL CAROLINA,1,0,1992,NA,NA,591,305,286,71,17,54,0.17,0.06,0.12,2170,25,140,506
218724,COASTAL CAROLINA UNIVERSITY,1,0,1993,NA,NA,732,379,353,86,26,60,0.15,0.07,0.12,2470,27,143,635
218724,COASTAL CAROLINA UNIVERSITY,1,0,1995,NA,NA,734,411,323,117,27,90,0.21,0.08,0.16,2800,32,160,648
218724,COASTAL CAROLINA UNIVERSITY,1,0,1996,NA,NA,823,408,415,120,44,76,0.18,0.11,0.15,2910,35,164,713
218724,COASTAL CAROLINA UNIVERSITY,1,0,1997,NA,NA,826,443,383,121,43,78,0.17,0.11,0.15,3030,38,179,725
218724,COASTAL CAROLINA UNIVERSITY,1,0,1998,NA,NA,855,468,387,150,53,97,0.2,0.14,0.18,3150,42,180,757
218724,COASTAL CAROLINA UNIVERSITY,1,0,1999,NA,NA,757,405,352,161,60,101,0.24,0.17,0.21,3270,45,176,674
218724,COASTAL CAROLINA UNIVERSITY,1,0,2000,NA,NA,784,434,350,157,57,100,0.23,0.16,0.2,3420,49,178,687
218724,COASTAL CAROLINA UNIVERSITY,1,0,2001,NA,NA,931,494,437,212,60,152,0.3,0.14,0.23,3690,54,180,842
218724,COASTAL CAROLINA UNIVERSITY,1,0,2002,NA,NA,1072,523,549,236,104,132,0.25,0.19,0.22,4430,51,200,932
218724,COASTAL CAROLINA UNIVERSITY,1,0,2003,NA,NA,1266,618,648,283,109,174,0.28,0.17,0.22,5270,60,208,1076
218724,COASTAL CAROLINA UNIVERSITY,1,0,2004,NA,NA,1320,669,651,288,104,184,0.27,0.16,0.22,6100,68,220,1115
218724,Coastal Carolina University,1,0,2005,NA,NA,1493,775,718,375,130,245,0.31,0.18,0.25,6780,75,233,1284
218724,Coastal Carolina University,1,0,2006,NA,NA,1466,810,656,420,144,276,0.34,0.22,0.29,7420,86,248,1241
218724,Coastal Carolina University,1,0,2007,NA,NA,1647,886,761,443,143,300,0.33,0.19,0.27,7520,95,264,1363
218724,Coastal Carolina University,1,0,2008,NA,NA,1641,835,806,422,157,265,0.31,0.19,0.26,8570,103,299,1314
218724,Coastal Carolina University,1,0,2009,NA,NA,1766,950,816,465,142,323,0.34,0.17,0.26,8870,112,315,1353
218724,Coastal Carolina University,1,0,2010,NA,NA,1996,1087,909,530,181,349,0.32,0.2,0.27,9310,118,346,1437
218733,SOUTH CAROLINA STATE COLLEGE,1,0,1991,NA,NA,888,486,402,85,17,68,0.13,0.04,0.1,2050,48,224,9
218733,SOUTH CAROLINA STATE UNIVERSITY,1,0,1992,NA,NA,701,366,335,89,25,64,0.17,0.07,0.13,2200,51,291,3
218733,SOUTH CAROLINA STATE UNIVERSITY,1,0,1993,NA,NA,613,329,284,80,20,60,0.18,0.07,0.13,2500,53,255,3
218733,SOUTH CAROLINA STATE UNIVERSITY,1,0,1995,NA,NA,859,447,412,279,100,179,0.4,0.24,0.32,2550,56,257,10
218733,SOUTH CAROLINA STATE UNIVERSITY,1,0,1996,NA,NA,801,452,349,159,24,135,0.29,0.07,0.2,2730,59,249,3
218733,SOUTH CAROLINA STATE UNIVERSITY,1,0,1997,NA,NA,601,320,281,169,52,117,0.36,0.19,0.28,2974,65,236,3
218733,SOUTH CAROLINA STATE UNIVERSITY,1,0,1998,NA,NA,739,428,311,186,50,136,0.31,0.16,0.25,3184,66,217,4
218733,SOUTH CAROLINA STATE UNIVERSITY,1,0,1999,NA,NA,680,351,329,143,37,106,0.3,0.11,0.21,3410,67,217,7
218733,SOUTH CAROLINA STATE UNIVERSITY,1,0,2000,NA,NA,571,307,264,170,48,122,0.39,0.18,0.3,3654,85,218,2
218733,SOUTH CAROLINA STATE UNIVERSITY,1,0,2001,NA,NA,615,358,257,135,47,88,0.24,0.18,0.22,4096,79,219,2
218733,SOUTH CAROLINA STATE UNIVERSITY,1,0,2002,NA,NA,717,401,316,174,45,129,0.32,0.14,0.24,2278,79,218,4
218733,SOUTH CAROLINA STATE UNIVERSITY,1,0,2003,NA,NA,794,453,341,106,33,73,0.16,0.1,0.13,5570,79,190,8
218733,SOUTH CAROLINA STATE UNIVERSITY,1,0,2004,NA,NA,945,523,422,164,41,123,0.23,0.1,0.17,6170,81,211,5
218733,South Carolina State University,1,0,2005,NA,NA,1002,544,458,140,50,90,0.16,0.11,0.14,150,96,202,4
218733,South Carolina State University,1,0,2006,NA,NA,870,458,412,134,49,85,0.18,0.12,0.15,514,100,212,8
218733,South Carolina State University,1,0,2007,NA,NA,1292,652,640,177,59,118,0.18,0.09,0.14,550,111,225,10
218733,South Carolina State University,1,0,2008,NA,NA,923,484,439,138,38,100,0.2,0.09,0.15,572,126,228,9
218733,South Carolina State University,1,0,2009,NA,NA,713,358,355,106,37,69,0.19,0.1,0.15,624,124,229,14
218733,South Carolina State University,1,0,2010,NA,NA,816,414,402,156,58,98,0.23,0.14,0.19,8328,119,216,10
218742,UNIVERSITY OF SOUTH CAROLINA AT SPARTANBURG,1,0,1991,NA,NA,485,277,208,58,13,45,0.16,0.06,0.12,2020,19,133,416
218742,UNIVERSITY OF SOUTH CAROLINA AT SPARTANBURG,1,0,1992,NA,NA,399,240,159,56,16,40,0.16,0.1,0.14,2120,20,135,332
218742,UNIVERSITY OF SOUTH CAROLINA AT SPARTANBURG,1,0,1993,NA,NA,327,216,111,46,6,40,0.18,0.05,0.14,2320,21,132,258
218742,UNIVERSITY OF SOUTH CAROLINA AT SPARTANBURG,1,0,1995,NA,NA,427,264,163,66,15,51,0.19,0.09,0.15,2578,22,130,338
218742,UNIVERSITY OF SOUTH CAROLINA AT SPARTANBURG,1,0,1996,NA,NA,438,284,154,75,12,63,0.22,0.08,0.17,2808,25,133,327
218742,UNIVERSITY OF SOUTH CAROLINA AT SPARTANBURG,1,0,1997,NA,NA,539,327,212,81,18,63,0.19,0.08,0.15,2974,26,136,390
218742,UNIVERSITY OF SOUTH CAROLINA AT SPARTANBURG,1,0,1998,NA,NA,547,362,185,106,18,88,0.24,0.1,0.19,3118,30,137,369
218742,UNIVERSITY OF SOUTH CAROLINA AT SPARTANBURG,1,0,1999,NA,NA,540,334,206,87,24,63,0.18,0.12,0.16,3250,32,138,355
218742,UNIVERSITY OF SOUTH CAROLINA AT SPARTANBURG,1,0,2000,NA,NA,546,358,188,94,24,70,0.19,0.13,0.17,3494,35,142,348
218742,UNIVERSITY OF SOUTH CAROLINA AT SPARTANBURG,1,0,2001,NA,NA,573,350,223,107,36,71,0.2,0.16,0.19,3738,37,147,334
218742,UNIVERSITY OF SOUTH CAROLINA AT SPARTANBURG,1,0,2002,NA,NA,647,414,233,119,19,100,0.24,0.08,0.18,4598,38,165,410
218742,UNIVERSITY OF SOUTH CAROLINA-SPARTANBURG,1,0,2003,NA,NA,684,450,234,139,35,104,0.23,0.15,0.2,5310,45,179,409
218742,UNIVERSITY OF SOUTH CAROLINA UPSTATE,1,0,2004,NA,NA,643,398,245,145,51,94,0.23,0.21,0.23,5860,47,180,408
218742,University of South Carolina-Upstate,1,0,2005,NA,NA,718,469,249,153,41,112,0.23,0.16,0.21,6436,50,183,382
218742,University of South Carolina-Upstate,1,0,2006,NA,NA,781,497,284,166,42,124,0.24,0.15,0.21,6958,52,196,429
218742,University of South Carolina-Upstate,1,0,2007,NA,NA,805,488,317,191,54,137,0.28,0.17,0.24,7480,59,206,458
218742,University of South Carolina-Upstate,1,0,2008,NA,NA,708,455,253,164,47,117,0.25,0.19,0.23,8062,65,214,382
218742,University of South Carolina-Upstate,1,0,2009,NA,NA,837,540,297,219,63,156,0.28,0.21,0.26,8362,64,206,474
218742,University of South Carolina-Upstate,1,0,2010,NA,NA,838,559,279,200,54,146,0.26,0.19,0.24,8792,66,206,461
218973,WOFFORD COLLEGE,1,0,1991,NA,NA,295,117,178,217,124,93,0.79,0.7,0.74,9790,17,63,264
218973,WOFFORD COLLEGE,1,0,1992,NA,NA,287,132,155,206,113,93,0.7000000000000001,0.73,0.72,10490,20,63,250
218973,WOFFORD COLLEGE,1,0,1993,NA,NA,273,109,164,210,117,93,0.85,0.71,0.77,11480,20,64,248
218973,WOFFORD COLLEGE,1,0,1995,NA,NA,286,140,146,219,99,120,0.85,0.68,0.77,13795,23,65,263
218973,WOFFORD COLLEGE,1,0,1996,NA,NA,291,132,159,204,106,98,0.74,0.67,0.7,14675,25,67,266
218973,WOFFORD COLLEGE,1,0,1997,NA,NA,296,139,157,210,102,108,0.77,0.65,0.71,15390,22,67,262
218973,WOFFORD COLLEGE,1,0,1998,NA,NA,298,145,153,224,113,111,0.76,0.74,0.75,16170,25,68,263
218973,WOFFORD COLLEGE,1,0,1999,NA,NA,307,154,153,226,112,114,0.74,0.73,0.74,16410,26,72,269
218973,WOFFORD COLLEGE,1,0,2000,NA,NA,308,150,158,222,104,118,0.78,0.66,0.72,17030,30,73,280
218973,WOFFORD COLLEGE,1,0,2001,NA,NA,303,152,151,218,100,118,0.77,0.66,0.72,17760,28,75,269
218973,WOFFORD COLLEGE,1,0,2002,NA,NA,297,170,127,234,95,139,0.81,0.75,0.79,19415,38,79,267
218973,WOFFORD COLLEGE,1,0,2003,NA,NA,330,163,167,255,127,128,0.78,0.76,0.77,20610,37,82,284
218973,WOFFORD COLLEGE,1,0,2004,NA,NA,323,144,179,253,129,124,0.86,0.72,0.78,22300,38,81,293
218973,Wofford College,1,0,2005,NA,NA,320,144,176,241,123,118,0.81,0.7,0.75,24130,40,91,280
218973,Wofford College,1,0,2006,NA,NA,377,191,186,299,139,160,0.8300000000000001,0.75,0.79,26110,43,99,329
218973,Wofford College,1,0,2007,NA,NA,385,193,192,301,141,160,0.8200000000000001,0.73,0.78,27830,43,106,324
218973,Wofford College,1,0,2008,NA,NA,415,203,212,296,140,156,0.76,0.66,0.71,29465,44,111,364
218973,Wofford College,1,0,2009,NA,NA,391,203,188,302,138,164,0.8,0.73,0.77,29240,49,117,318
218973,Wofford College,1,0,2010,NA,NA,429,202,227,334,173,161,0.79,0.76,0.78,30630,51,116,357
219000,AUGUSTANA COLLEGE,1,0,1991,NA,NA,323,221,102,151,41,110,0.49,0.4,0.47,9330,24,106,306
219000,AUGUSTANA COLLEGE,1,0,1992,NA,NA,347,228,119,162,48,114,0.5,0.4,0.47,9800,24,109,334
219000,AUGUSTANA COLLEGE,1,0,1993,NA,NA,306,208,98,128,25,103,0.49,0.26,0.42,10180,26,108,299
219000,AUGUSTANA COLLEGE,1,0,1995,NA,NA,372,242,130,168,52,116,0.47000000000000003,0.4,0.45,11780,26,116,363
219000,AUGUSTANA COLLEGE,1,0,1996,NA,NA,383,244,139,190,55,135,0.55,0.4,0.5,12488,27,121,374
219000,AUGUSTANA COLLEGE,1,0,1997,NA,NA,326,209,117,171,53,118,0.56,0.45,0.52,12968,23,119,318
219000,AUGUSTANA COLLEGE,1,0,1998,NA,NA,403,257,146,213,61,152,0.59,0.42,0.53,13490,24,121,393
219000,AUGUSTANA COLLEGE,1,0,1999,NA,NA,469,314,155,231,65,166,0.52,0.42,0.49,13960,25,118,463
219000,AUGUSTANA COLLEGE,1,0,2000,NA,NA,460,286,174,222,76,146,0.51,0.44,0.48,14592,26,115,453
219000,AUGUSTANA COLLEGE,1,0,2001,NA,NA,416,276,140,214,58,156,0.56,0.41,0.51,15280,27,113,404
219000,AUGUSTANA COLLEGE,1,0,2002,NA,NA,416,259,157,208,74,134,0.51,0.47,0.5,15892,29,108,405
219000,AUGUSTANA COLLEGE,1,0,2003,NA,NA,424,281,143,217,61,156,0.55,0.43,0.51,16766,28,106,409
219000,AUGUSTANA COLLEGE,1,0,2004,NA,NA,392,231,161,197,70,127,0.54,0.43,0.5,17764,29,109,377
219000,Augustana College,1,0,2005,NA,NA,390,256,134,192,54,138,0.53,0.4,0.49,18634,30,109,371
219000,Augustana College,1,0,2006,NA,NA,442,282,160,228,64,164,0.58,0.4,0.52,19750,31,111,420
219000,Augustana College,1,0,2007,NA,NA,429,272,157,207,54,153,0.56,0.34,0.48,20932,34,117,397
219000,Augustana College,1,0,2008,NA,NA,426,292,134,211,50,161,0.55,0.37,0.5,22188,36,119,396
219000,Augustana College,1,0,2009,NA,NA,431,261,170,245,80,165,0.63,0.47,0.57,23276,38,125,404
219000,Augustana College,1,0,2010,NA,NA,418,276,142,226,55,171,0.61,0.39,0.54,24790,39,132,371
219046,BLACK HILLS STATE UNIVERSITY,1,0,1991,NA,NA,492,285,207,23,5,18,0.06,0.02,0.05,1770,17,101,454
219046,BLACK HILLS STATE UNIVERSITY,1,0,1992,NA,NA,1056,597,459,226,79,147,0.24,0.17,0.21,2126,18,106,986
219046,BLACK HILLS STATE UNIVERSITY,1,0,1993,NA,NA,1078,586,492,243,85,158,0.26,0.17,0.23,2220,20,107,980
219046,BLACK HILLS STATE UNIVERSITY,1,0,1995,NA,NA,435,234,201,33,8,25,0.1,0.04,0.08,2458,20,107,408
219046,BLACK HILLS STATE UNIVERSITY,1,0,1996,NA,NA,452,260,192,58,15,43,0.16,0.08,0.13,2502,19,110,423
219046,BLACK HILLS STATE UNIVERSITY,1,0,1997,NA,NA,451,227,224,38,8,30,0.13,0.04,0.08,2698,20,110,416
219046,BLACK HILLS STATE UNIVERSITY,1,0,1998,NA,NA,632,381,251,48,13,35,0.09,0.05,0.08,2920,22,115,594
219046,BLACK HILLS STATE UNIVERSITY,1,0,1999,NA,NA,630,360,270,71,17,54,0.15,0.06,0.11,3115,25,114,604
219046,BLACK HILLS STATE UNIVERSITY,1,0,2000,NA,NA,586,361,225,48,11,37,0.1,0.05,0.08,3630,26,116,525
219046,BLACK HILLS STATE UNIVERSITY,1,0,2001,NA,NA,565,354,211,65,27,38,0.1,0.13,0.12,1997,27,119,491
219046,BLACK HILLS STATE UNIVERSITY,1,0,2002,NA,NA,537,334,203,43,11,32,0.09,0.05,0.08,2080,28,111,491
219046,BLACK HILLS STATE UNIVERSITY,1,0,2003,NA,NA,653,409,244,62,17,45,0.11,0.07,0.09,2307,29,114,580
219046,BLACK HILLS STATE UNIVERSITY,1,0,2004,NA,NA,581,350,231,46,11,35,0.1,0.05,0.08,2371,31,123,517
219046,Black Hills State University,1,0,2005,NA,NA,584,353,231,74,22,52,0.14,0.1,0.13,2444,33,124,477
219046,Black Hills State University,1,0,2006,NA,NA,595,353,242,122,28,94,0.26,0.12,0.21,2540,34,121,494
219046,Black Hills State University,1,0,2007,NA,NA,472,268,204,51,14,37,0.13,0.07,0.11,2643,38,127,411
219046,Black Hills State University,1,0,2008,NA,NA,545,345,200,64,17,47,0.13,0.09,0.12,2822,40,133,455
219046,Black Hills State University,1,0,2009,NA,NA,540,308,232,85,23,62,0.2,0.1,0.16,2934,42,134,473
219046,Black Hills State University,1,0,2010,NA,NA,648,386,262,105,30,75,0.19,0.11,0.16,3194,42,143,559
219082,DAKOTA STATE UNIVERSITY,1,0,1991,NA,NA,209,110,99,9,2,7,0.06,0.02,0.04,1582,9,54,195
219082,DAKOTA STATE UNIVERSITY,1,0,1992,NA,NA,234,123,111,26,12,14,0.11,0.11,0.11,1653,10,55,224
219082,DAKOTA STATE UNIVERSITY,1,0,1993,NA,NA,208,116,92,14,2,12,0.1,0.02,0.07,1770,10,59,200
219082,DAKOTA STATE UNIVERSITY,1,0,1995,NA,NA,256,125,131,22,5,17,0.13,0.04,0.09,2585,11,64,244
219082,DAKOTA STATE UNIVERSITY,1,0,1996,NA,NA,189,100,89,25,5,20,0.2,0.06,0.13,2607,12,63,186
219082,DAKOTA STATE UNIVERSITY,1,0,1997,NA,NA,249,135,114,1,1,0,0,0.01,0,2838,12,65,239
219082,DAKOTA STATE UNIVERSITY,1,0,1998,NA,NA,231,110,121,45,17,28,0.25,0.14,0.19,3301,13,62,223
219082,DAKOTA STATE UNIVERSITY,1,0,1999,NA,NA,306,124,182,45,21,24,0.19,0.12,0.15,1867,14,72,288
219082,DAKOTA STATE UNIVERSITY,1,0,2000,NA,NA,351,149,202,51,25,26,0.17,0.12,0.15,1935,16,79,306
219082,DAKOTA STATE UNIVERSITY,1,0,2001,NA,NA,292,123,169,54,28,26,0.21,0.17,0.18,1997,18,86,267
219082,DAKOTA STATE UNIVERSITY,1,0,2002,NA,NA,273,111,162,45,22,23,0.2,0.14,0.16,2080,21,82,260
219082,DAKOTA STATE UNIVERSITY,1,0,2003,NA,NA,290,120,170,43,18,25,0.2,0.11,0.15,2163,21,79,254
219082,DAKOTA STATE UNIVERSITY,1,0,2004,NA,NA,249,114,135,44,18,26,0.22,0.13,0.18,2223,22,81,221
219082,Dakota State University,1,0,2005,NA,NA,280,135,145,29,14,15,0.11,0.1,0.1,2290,24,77,265
219082,Dakota State University,1,0,2006,NA,NA,295,137,158,41,23,18,0.13,0.15,0.14,2382,23,80,276
219082,Dakota State University,1,0,2007,NA,NA,243,110,133,44,23,21,0.19,0.17,0.18,2478,24,89,220
219082,Dakota State University,1,0,2008,NA,NA,258,121,137,45,18,27,0.22,0.13,0.17,2646,26,89,240
219082,Dakota State University,1,0,2009,NA,NA,284,116,168,54,28,26,0.22,0.17,0.19,2751,28,92,252
219082,Dakota State University,1,0,2010,NA,NA,314,113,201,62,43,19,0.16,0.21,0.2,2994,31,93,273
219198,MOUNT MARTY COLLEGE,1,0,1991,NA,NA,126,95,31,38,8,30,0.31,0.26,0.3,6690,5,40,114
219198,MOUNT MARTY COLLEGE,1,0,1992,NA,NA,107,72,35,31,9,22,0.3,0.26,0.29,7078,6,44,100
219198,MOUNT MARTY COLLEGE,1,0,1993,NA,NA,117,96,21,39,9,30,0.31,0.43,0.33,7470,7,39,112
219198,MOUNT MARTY COLLEGE,1,0,1995,NA,NA,95,62,33,27,11,16,0.25,0.33,0.28,8196,8,43,88
219198,MOUNT MARTY COLLEGE,1,0,1996,NA,NA,117,77,40,42,11,31,0.4,0.28,0.36,8649,8,39,108
219198,MOUNT MARTY COLLEGE,1,0,1997,NA,NA,129,96,33,47,12,35,0.36,0.36,0.36,9168,8,54,125
219198,MOUNT MARTY COLLEGE,1,0,1998,NA,NA,126,85,41,44,13,31,0.36,0.32,0.35,9628,8,33,123
219198,MOUNT MARTY COLLEGE,1,0,1999,NA,NA,121,84,37,34,8,26,0.3,0.22,0.28,9248,9,31,119
219198,MOUNT MARTY COLLEGE,1,0,2000,NA,NA,154,97,57,46,21,25,0.25,0.37,0.3,9710,9,34,146
219198,MOUNT MARTY COLLEGE,1,0,2001,NA,NA,148,109,39,49,10,39,0.35000000000000003,0.26,0.33,9942,11,38,136
219198,MOUNT MARTY COLLEGE,1,0,2002,NA,NA,137,104,33,44,7,37,0.35000000000000003,0.21,0.32,11580,11,45,134
219198,MOUNT MARTY COLLEGE,1,0,2003,NA,NA,158,113,45,33,11,22,0.19,0.24,0.21,12506,12,44,148
219198,MOUNT MARTY COLLEGE,1,0,2004,NA,NA,150,111,39,51,13,38,0.34,0.33,0.34,13256,10,50,138
219198,Mount Marty College,1,0,2005,NA,NA,139,91,48,54,15,39,0.42,0.31,0.39,14050,11,48,132
219198,Mount Marty College,1,0,2006,NA,NA,127,92,35,57,14,43,0.46,0.4,0.45,14752,12,49,119
219198,Mount Marty College,1,0,2007,NA,NA,108,73,35,49,14,35,0.47000000000000003,0.4,0.45,15638,12,50,94
219198,Mount Marty College,1,0,2008,NA,NA,136,88,48,66,20,46,0.52,0.42,0.49,16420,13,54,125
219198,Mount Marty College,1,0,2009,NA,NA,109,66,43,47,16,31,0.46,0.37,0.43,17078,12,43,96
219198,Mount Marty College,1,0,2010,NA,NA,120,64,56,48,17,31,0.48,0.3,0.4,18102,12,42,107
219259,NORTHERN STATE UNIVERSITY,1,0,1991,NA,NA,511,258,253,45,15,30,0.11,0.06,0.09,1835,18,126,487
219259,NORTHERN STATE UNIVERSITY,1,0,1992,NA,NA,587,313,274,60,20,40,0.12,0.07,0.1,1978,18,102,568
219259,NORTHERN STATE UNIVERSITY,1,0,1993,NA,NA,647,360,287,73,14,59,0.16,0.05,0.11,2120,19,105,598
219259,NORTHERN STATE UNIVERSITY,1,0,1995,NA,NA,574,343,231,75,19,56,0.16,0.08,0.13,2455,20,123,544
219259,NORTHERN STATE UNIVERSITY,1,0,1996,NA,NA,560,324,236,68,24,44,0.13,0.1,0.12,2526,20,104,510
219259,NORTHERN STATE UNIVERSITY,1,0,1997,NA,NA,539,321,218,83,22,61,0.19,0.1,0.15,2704,20,105,502
219259,NORTHERN STATE UNIVERSITY,1,0,1998,NA,NA,480,276,204,66,16,50,0.18,0.08,0.14,2842,21,96,404
219259,NORTHERN STATE UNIVERSITY,1,0,1999,NA,NA,523,303,220,69,15,54,0.17,0.07,0.13,1750,21,90,440
219259,NORTHERN STATE UNIVERSITY,1,0,2000,NA,NA,446,257,189,61,10,51,0.19,0.05,0.14,1812,23,92,399
219259,NORTHERN STATE UNIVERSITY,1,0,2001,NA,NA,409,244,165,61,14,47,0.19,0.08,0.15,1872,24,95,363
219259,NORTHERN STATE UNIVERSITY,1,0,2002,NA,NA,376,214,162,51,12,39,0.18,0.07,0.14,1950,26,98,343
219259,NORTHERN STATE UNIVERSITY,1,0,2003,NA,NA,380,210,170,59,16,43,0.2,0.09,0.16,2163,27,98,297
219259,NORTHERN STATE UNIVERSITY,1,0,2004,NA,NA,384,238,146,53,12,41,0.17,0.08,0.14,2223,27,100,321
219259,Northern State University,1,0,2005,NA,NA,368,197,171,47,13,34,0.17,0.08,0.13,2290,28,94,329
219259,Northern State University,1,0,2006,NA,NA,367,178,189,50,14,36,0.2,0.07,0.14,2382,28,93,315
219259,Northern State University,1,0,2007,NA,NA,340,203,137,70,15,55,0.27,0.11,0.21,2478,30,92,302
219259,Northern State University,1,0,2008,NA,NA,389,204,185,67,16,51,0.25,0.09,0.17,2646,31,91,347
219259,Northern State University,1,0,2009,NA,NA,317,197,120,65,16,49,0.24,0.13,0.21,2751,34,96,273
219259,Northern State University,1,0,2010,NA,NA,380,208,172,84,25,59,0.28,0.15,0.22,2994,35,96,324
219356,SOUTH DAKOTA STATE UNIVERSITY,1,0,1991,NA,NA,1306,657,649,189,77,112,0.17,0.12,0.14,2045,79,355,1278
219356,SOUTH DAKOTA STATE UNIVERSITY,1,0,1992,NA,NA,1495,701,794,293,112,181,0.25,0.14,0.2,2146,87,354,1458
219356,SOUTH DAKOTA STATE UNIVERSITY,1,0,1993,NA,NA,1670,831,839,320,128,192,0.23,0.15,0.19,2252,96,367,1631
219356,SOUTH DAKOTA STATE UNIVERSITY,1,0,1995,NA,NA,1659,813,846,359,135,224,0.27,0.16,0.22,2705,96,375,1615
219356,SOUTH DAKOTA STATE UNIVERSITY,1,0,1996,NA,NA,1481,733,748,303,129,174,0.23,0.17,0.2,2784,101,367,1437
219356,SOUTH DAKOTA STATE UNIVERSITY,1,0,1997,NA,NA,1531,741,790,346,130,216,0.29,0.16,0.23,2912,103,361,1444
219356,SOUTH DAKOTA STATE UNIVERSITY,1,0,1998,NA,NA,1510,766,744,384,147,237,0.3,0.2,0.25,3128,112,371,1444
219356,SOUTH DAKOTA STATE UNIVERSITY,1,0,1999,NA,NA,1457,714,743,342,127,215,0.3,0.17,0.23,1867,120,355,1313
219356,SOUTH DAKOTA STATE UNIVERSITY,1,0,2000,NA,NA,1446,740,706,327,129,198,0.26,0.18,0.23,1933,122,350,1363
219356,SOUTH DAKOTA STATE UNIVERSITY,1,0,2001,NA,NA,1495,751,744,316,105,211,0.28,0.14,0.21,1997,131,346,1396
219356,SOUTH DAKOTA STATE UNIVERSITY,1,0,2002,NA,NA,1767,864,903,348,140,208,0.24,0.16,0.2,2080,136,367,1671
219356,SOUTH DAKOTA STATE UNIVERSITY,1,0,2003,NA,NA,1993,957,1036,427,176,251,0.26,0.17,0.21,2307,145,397,1881
219356,SOUTH DAKOTA STATE UNIVERSITY,1,0,2004,NA,NA,1993,1011,982,485,194,291,0.28,0.2,0.24,2371,157,408,1824
219356,South Dakota State University,1,0,2005,NA,NA,1784,893,891,528,213,315,0.35000000000000003,0.24,0.3,2443,170,411,1646
219356,South Dakota State University,1,0,2006,NA,NA,1833,922,911,484,173,311,0.33,0.19,0.26,2382,173,423,1688
219356,South Dakota State University,1,0,2007,NA,NA,1933,950,983,495,183,312,0.32,0.19,0.26,2478,188,493,1764
219356,South Dakota State University,1,0,2008,NA,NA,2008,987,1021,563,237,326,0.33,0.23,0.28,2646,207,478,1886
219356,South Dakota State University,1,0,2009,NA,NA,2043,1032,1011,602,247,355,0.34,0.24,0.29,2751,224,476,1889
219356,South Dakota State University,1,0,2010,NA,NA,2157,1051,1106,613,270,343,0.32,0.24,0.28,2994,241,479,1985
219471,UNIVERSITY OF SOUTH DAKOTA,1,0,1991,NA,NA,1150,661,489,223,78,145,0.21,0.16,0.19,1977,63,329,1110
219471,UNIVERSITY OF SOUTH DAKOTA,1,0,1992,NA,NA,1228,686,542,239,79,160,0.23,0.15,0.19,2073,70,345,1153
219471,UNIVERSITY OF SOUTH DAKOTA,1,0,1993,NA,NA,1227,704,523,247,79,168,0.23,0.15,0.2,2294,76,361,1166
219471,UNIVERSITY OF SOUTH DAKOTA,1,0,1995,NA,NA,1160,660,500,224,60,164,0.24,0.12,0.19,2803,78,339,1095
219471,UNIVERSITY OF SOUTH DAKOTA,1,0,1996,NA,NA,875,489,386,175,62,113,0.23,0.16,0.2,2885,83,318,833
219471,UNIVERSITY OF SOUTH DAKOTA,1,0,1997,NA,NA,896,503,393,213,80,133,0.26,0.2,0.24,2918,80,328,842
219471,UNIVERSITY OF SOUTH DAKOTA,1,0,1998,NA,NA,894,500,394,180,58,122,0.24,0.15,0.2,3216,86,323,824
219471,UNIVERSITY OF SOUTH DAKOTA,1,0,1999,NA,NA,868,493,375,176,53,123,0.24,0.14,0.2,1867,89,322,781
219471,UNIVERSITY OF SOUTH DAKOTA,1,0,2000,NA,NA,918,504,414,199,62,137,0.27,0.15,0.22,1933,90,297,811
219471,UNIVERSITY OF SOUTH DAKOTA,1,0,2001,NA,NA,932,578,354,196,45,151,0.26,0.13,0.21,1997,96,272,843
219471,UNIVERSITY OF SOUTH DAKOTA,1,0,2002,NA,NA,976,544,432,186,74,112,0.2,0.17,0.19,2080,100,312,876
219471,UNIVERSITY OF SOUTH DAKOTA,1,0,2003,NA,NA,982,539,443,186,76,110,0.2,0.17,0.19,2307,109,327,855
219471,UNIVERSITY OF SOUTH DAKOTA,1,0,2004,NA,NA,945,538,407,220,80,140,0.26,0.2,0.23,2371,115,336,841
219471,University of South Dakota,1,0,2005,NA,NA,1030,621,409,236,74,162,0.26,0.18,0.23,2443,123,285,908
219471,University of South Dakota,1,0,2006,NA,NA,1109,674,435,237,88,149,0.22,0.2,0.21,2541,126,287,998
219471,University of South Dakota,1,0,2007,NA,NA,1030,612,418,282,105,177,0.28,0.25,0.27,2643,145,254,810
219471,University of South Dakota,1,0,2008,NA,NA,1023,597,426,295,111,184,0.3,0.26,0.29,2646,151,310,835
219471,University of South Dakota,1,0,2009,NA,NA,971,559,412,286,91,195,0.34,0.22,0.29,2751,153,309,791
219471,University of South Dakota,1,0,2010,NA,NA,1034,622,412,313,114,199,0.31,0.28,0.3,2994,162,299,840
219602,AUSTIN PEAY STATE UNIVERSITY,1,0,1991,NA,NA,771,492,279,70,14,56,0.11,0.05,0.09,1628,36,208,563
219602,AUSTIN PEAY STATE UNIVERSITY,1,0,1992,NA,NA,752,471,281,164,46,118,0.25,0.16,0.22,1726,37,229,577
219602,AUSTIN PEAY STATE UNIVERSITY,1,0,1993,NA,NA,788,474,314,152,50,102,0.21,0.16,0.19,1800,43,253,587
219602,AUSTIN PEAY STATE UNIVERSITY,1,0,1995,NA,NA,776,457,319,105,26,79,0.17,0.08,0.14,1946,49,268,591
219602,AUSTIN PEAY STATE UNIVERSITY,1,0,1996,NA,NA,777,498,279,156,38,118,0.23,0.14,0.2,2108,50,276,609
219602,AUSTIN PEAY STATE UNIVERSITY,1,0,1997,NA,NA,788,503,285,144,40,104,0.2,0.14,0.18,2280,51,272,595
219602,AUSTIN PEAY STATE UNIVERSITY,1,0,1998,NA,NA,846,518,328,76,20,56,0.1,0.06,0.09,2470,53,267,612
219602,AUSTIN PEAY STATE UNIVERSITY,1,0,1999,NA,NA,715,432,283,66,22,44,0.1,0.08,0.09,2584,58,269,506
219602,AUSTIN PEAY STATE UNIVERSITY,1,0,2000,NA,NA,870,554,316,101,29,72,0.13,0.09,0.12,2222,61,275,630
219602,AUSTIN PEAY STATE UNIVERSITY,1,0,2001,NA,NA,900,569,331,77,20,57,0.1,0.06,0.09,2556,63,281,642
219602,AUSTIN PEAY STATE UNIVERSITY,1,0,2002,NA,NA,986,636,350,126,37,89,0.13,0.11,0.13,2748,67,269,662
219602,AUSTIN PEAY STATE UNIVERSITY,1,0,2003,NA,NA,967,609,358,118,33,85,0.13,0.09,0.12,3132,67,261,677
219602,AUSTIN PEAY STATE UNIVERSITY,1,0,2004,NA,NA,1196,714,482,173,64,109,0.15,0.13,0.14,3352,70,262,837
219602,Austin Peay State University,1,0,2005,NA,NA,1226,708,518,175,70,105,0.14,0.14,0.14,3678,79,290,869
219602,Austin Peay State University,1,0,2006,NA,NA,1210,731,479,188,56,132,0.18,0.12,0.16,3828,85,294,809
219602,Austin Peay State University,1,0,2007,NA,NA,1188,683,505,178,55,123,0.18,0.11,0.15,4058,95,286,739
219602,Austin Peay State University,1,0,2008,NA,NA,1326,806,520,208,70,138,0.17,0.13,0.16,4302,106,302,858
219602,Austin Peay State University,1,0,2009,NA,NA,1465,897,568,214,74,140,0.15,0.13,0.15,4584,109,310,1038
219602,Austin Peay State University,1,0,2010,NA,NA,1478,903,575,252,88,164,0.18,0.15,0.17,4824,112,327,981
219709,BELMONT UNIVERSITY,1,0,1991,NA,NA,238,146,92,68,21,47,0.32,0.23,0.29,6100,20,132,223
219709,BELMONT UNIVERSITY,1,0,1992,NA,NA,285,158,127,93,41,52,0.32,0.32,0.33,6480,24,132,264
219709,BELMONT UNIVERSITY,1,0,1993,NA,NA,328,182,146,137,58,79,0.43,0.4,0.42,7300,27,150,307
219709,BELMONT UNIVERSITY,1,0,1995,NA,NA,347,221,126,14,3,11,0.04,0.02,0.04,8750,32,154,313
219709,BELMONT UNIVERSITY,1,0,1996,NA,NA,418,262,156,185,66,119,0.45,0.42,0.44,9500,35,158,389
219709,BELMONT UNIVERSITY,1,0,1997,NA,NA,399,248,151,197,67,130,0.52,0.44,0.49,10300,40,164,365
219709,BELMONT UNIVERSITY,1,0,1998,NA,NA,413,254,159,201,73,128,0.5,0.46,0.49,11050,44,187,377
219709,BELMONT UNIVERSITY,1,0,1999,NA,NA,487,300,187,266,91,175,0.58,0.49,0.55,11300,43,184,447
219709,BELMONT UNIVERSITY,1,0,2000,NA,NA,516,309,207,278,108,170,0.55,0.52,0.54,11990,43,175,479
219709,BELMONT UNIVERSITY,1,0,2001,NA,NA,502,309,193,284,121,163,0.52,0.63,0.57,13040,47,166,455
219709,BELMONT UNIVERSITY,1,0,2002,NA,NA,524,320,204,264,91,173,0.54,0.45,0.5,13690,53,195,476
219709,BELMONT UNIVERSITY,1,0,2003,NA,NA,599,360,239,312,110,202,0.56,0.46,0.52,15164,55,208,555
219709,BELMONT UNIVERSITY,1,0,2004,NA,NA,727,442,285,429,168,261,0.59,0.59,0.59,15360,63,203,661
219709,Belmont University,1,0,2005,NA,NA,791,488,303,483,180,303,0.62,0.59,0.61,16360,69,214,715
219709,Belmont University,1,0,2006,NA,NA,763,439,324,422,160,262,0.59,0.49,0.55,17470,75,227,679
219709,Belmont University,1,0,2007,NA,NA,799,453,346,449,187,262,0.5700000000000001,0.54,0.56,18780,79,243,706
219709,Belmont University,1,0,2008,NA,NA,928,519,409,520,217,303,0.58,0.53,0.56,20070,93,273,800
219709,Belmont University,1,0,2009,NA,NA,986,558,428,561,222,339,0.6,0.52,0.57,21770,102,276,870
219709,Belmont University,1,0,2010,NA,NA,1013,581,432,597,247,350,0.6,0.57,0.59,22530,103,290,877
219718,BETHEL COLLEGE,1,0,1991,NA,NA,107,68,39,12,6,6,0.08,0.15,0.11,4350,5,25,98
219718,BETHEL COLLEGE,1,0,1992,NA,NA,104,65,39,12,6,6,0.09,0.15,0.12,5250,5,26,86
219718,BETHEL COLLEGE,1,0,1993,NA,NA,125,43,82,15,4,11,0.25,0.05,0.12,6200,6,27,97
219718,BETHEL COLLEGE,1,0,1995,NA,NA,149,52,97,17,5,12,0.23,0.05,0.11,7000,6,28,125
219718,BETHEL COLLEGE,1,0,1996,NA,NA,180,82,98,24,6,18,0.21,0.06,0.13,6990,7,29,156
219718,BETHEL COLLEGE,1,0,1997,NA,NA,65,26,39,8,2,6,0.23,0.05,0.12,6990,7,30,60
219718,BETHEL COLLEGE,1,0,1998,NA,NA,82,29,53,16,6,10,0.34,0.11,0.2,6990,7,35,70
219718,BETHEL COLLEGE,1,0,1999,NA,NA,142,42,100,17,10,7,0.16,0.1,0.12,7800,8,34,110
219718,BETHEL COLLEGE,1,0,2000,NA,NA,137,44,93,17,7,10,0.22,0.08,0.12,7860,9,35,104
219718,BETHEL COLLEGE,1,0,2001,NA,NA,141,63,78,21,3,18,0.28,0.04,0.15,8180,11,37,103
219718,BETHEL COLLEGE,1,0,2002,NA,NA,139,53,86,16,5,11,0.2,0.06,0.12,8180,13,38,85
219718,BETHEL COLLEGE,1,0,2003,NA,NA,129,59,70,27,10,17,0.28,0.14,0.21,9360,16,36,90
219718,BETHEL COLLEGE,1,0,2004,NA,NA,252,97,155,40,15,25,0.25,0.1,0.16,9360,18,58,149
219718,Bethel College,1,0,2005,NA,NA,234,108,126,29,9,20,0.18,0.07,0.12,10016,22,66,139
219718,Bethel College,1,0,2006,NA,NA,243,94,149,26,13,13,0.13,0.09,0.11,10516,26,61,144
219718,Bethel College,1,0,2007,NA,NA,255,115,140,27,13,14,0.12,0.09,0.11,11040,23,84,145
219718,Bethel College,1,0,2008,NA,NA,268,122,146,57,19,38,0.31,0.13,0.21,11592,26,87,168
219718,Bethel University,1,0,2009,NA,NA,351,151,200,90,36,54,0.35000000000000003,0.18,0.26,11592,29,97,195
219718,Bethel University,1,0,2010,NA,NA,377,133,244,51,27,24,0.18,0.11,0.14,12288,34,110,265
219949,CUMBERLAND UNIVERSITY,1,0,1991,NA,NA,165,88,77,26,13,13,0.14,0.17,0.16,4700,4,31,153
219949,CUMBERLAND UNIVERSITY,1,0,1992,NA,NA,173,80,93,40,18,22,0.27,0.19,0.23,5000,5,32,147
219949,CUMBERLAND UNIVERSITY,1,0,1993,NA,NA,169,106,63,37,6,31,0.29,0.1,0.22,5500,6,33,134
219949,CUMBERLAND UNIVERSITY,1,0,1995,NA,NA,171,64,107,38,17,21,0.32,0.16,0.22,6950,7,63,137
219949,CUMBERLAND UNIVERSITY,1,0,1996,NA,NA,154,78,76,37,10,27,0.34,0.13,0.24,7440,9,66,128
219949,CUMBERLAND UNIVERSITY,1,0,1997,NA,NA,186,91,95,42,10,32,0.35000000000000003,0.11,0.23,8590,10,66,149
219949,CUMBERLAND UNIVERSITY,1,0,1998,NA,NA,236,111,125,44,8,36,0.32,0.06,0.19,9000,12,55,197
219949,CUMBERLAND UNIVERSITY,1,0,1999,NA,NA,174,67,107,36,19,17,0.25,0.18,0.21,9850,14,52,141
219949,CUMBERLAND UNIVERSITY,1,0,2000,NA,NA,189,78,111,28,9,19,0.24,0.08,0.15,10530,11,58,145
219949,CUMBERLAND UNIVERSITY,1,0,2001,NA,NA,200,92,108,39,15,24,0.26,0.14,0.2,10950,12,64,164
219949,CUMBERLAND UNIVERSITY,1,0,2002,NA,NA,164,74,90,35,6,29,0.39,0.07,0.21,11660,13,70,128
219949,CUMBERLAND UNIVERSITY,1,0,2003,NA,NA,149,76,73,24,9,15,0.19,0.12,0.16,12130,13,63,113
219949,CUMBERLAND UNIVERSITY,1,0,2004,NA,NA,203,104,99,37,15,22,0.21,0.15,0.18,12130,13,54,159
219949,Cumberland University,1,0,2005,NA,NA,217,107,110,44,17,27,0.25,0.15,0.2,13344,14,50,178
219949,Cumberland University,1,0,2006,NA,NA,189,75,114,34,8,26,0.34,0.07,0.18,14010,15,48,138
219949,Cumberland University,1,0,2007,NA,NA,210,75,135,43,22,21,0.28,0.16,0.2,14710,15,40,158
219949,Cumberland University,1,0,2008,NA,NA,194,82,112,43,20,23,0.28,0.18,0.22,15820,16,36,154
219949,Cumberland University,1,0,2009,NA,NA,200,101,99,62,25,37,0.36,0.25,0.31,16530,17,39,160
219949,Cumberland University,1,0,2010,NA,NA,163,67,96,56,29,27,0.4,0.3,0.34,17356,17,48,130
220075,EAST TENNESSEE STATE UNIVERSITY,1,0,1991,NA,NA,1599,950,649,149,47,102,0.1,0.07,0.09,1456,100,450,1481
220075,EAST TENNESSEE STATE UNIVERSITY,1,0,1992,NA,NA,1610,971,639,150,37,113,0.11,0.06,0.09,1554,106,474,1450
220075,EAST TENNESSEE STATE UNIVERSITY,1,0,1993,NA,NA,1289,757,532,128,51,77,0.1,0.1,0.1,1680,116,486,1159
220075,EAST TENNESSEE STATE UNIVERSITY,1,0,1995,NA,NA,1505,867,638,178,59,119,0.13,0.09,0.12,1878,135,496,1371
220075,EAST TENNESSEE STATE UNIVERSITY,1,0,1996,NA,NA,1532,894,638,186,62,124,0.13,0.1,0.12,1928,146,442,1392
220075,EAST TENNESSEE STATE UNIVERSITY,1,0,1997,NA,NA,1487,853,634,192,70,122,0.14,0.11,0.13,2100,154,481,1339
220075,EAST TENNESSEE STATE UNIVERSITY,1,0,1998,NA,NA,1507,880,627,204,64,140,0.15,0.1,0.14,2384,164,482,1357
220075,EAST TENNESSEE STATE UNIVERSITY,1,0,1999,NA,NA,1466,821,645,217,62,155,0.18,0.1,0.15,2020,177,476,1313
220075,EAST TENNESSEE STATE UNIVERSITY,1,0,2000,NA,NA,1483,824,659,244,73,171,0.2,0.11,0.16,2222,174,474,1321
220075,EAST TENNESSEE STATE UNIVERSITY,1,0,2001,NA,NA,1472,838,634,255,79,176,0.21,0.12,0.17,2556,206,473,1322
220075,EAST TENNESSEE STATE UNIVERSITY,1,0,2002,NA,NA,1473,831,642,262,76,186,0.22,0.12,0.18,2748,200,490,1325
220075,EAST TENNESSEE STATE UNIVERSITY,1,0,2003,NA,NA,1563,921,642,301,99,202,0.21,0.15,0.19,3132,205,500,1433
220075,EAST TENNESSEE STATE UNIVERSITY,1,0,2004,NA,NA,1479,846,633,259,76,183,0.21,0.12,0.18,3352,204,462,1311
220075,East Tennessee State University,1,0,2005,NA,NA,1565,897,668,308,102,206,0.22,0.15,0.2,3678,219,469,1404
220075,East Tennessee State University,1,0,2006,NA,NA,1712,966,746,279,106,173,0.17,0.14,0.16,3828,234,479,1495
220075,East Tennessee State University,1,0,2007,NA,NA,1918,1063,855,330,110,220,0.2,0.13,0.17,4058,247,499,1669
220075,East Tennessee State University,1,0,2008,NA,NA,1932,1069,863,380,133,247,0.23,0.15,0.2,4302,276,505,1665
220075,East Tennessee State University,1,0,2009,NA,NA,2063,1144,919,415,146,269,0.23,0.16,0.2,4584,291,516,1785
220075,East Tennessee State University,1,0,2010,NA,NA,2052,1165,887,406,147,259,0.22,0.17,0.2,4824,297,536,1714
220215,FREED-HARDEMAN UNIVERSITY,1,0,1991,NA,NA,295,147,148,80,38,42,0.28,0.26,0.27,5040,14,70,275
220215,FREED-HARDEMAN UNIVERSITY,1,0,1992,NA,NA,286,156,130,92,32,60,0.38,0.25,0.32,5560,14,65,269
220215,FREED-HARDEMAN UNIVERSITY,1,0,1993,NA,NA,296,169,127,83,31,52,0.3,0.24,0.28,5605,15,75,276
220215,FREED-HARDEMAN UNIVERSITY,1,0,1995,NA,NA,294,170,124,90,37,53,0.31,0.3,0.31,6620,17,79,279
220215,FREED-HARDEMAN UNIVERSITY,1,0,1996,NA,NA,314,194,120,107,30,77,0.39,0.25,0.34,7120,18,83,298
220215,FREED-HARDEMAN UNIVERSITY,1,0,1997,NA,NA,294,181,113,100,40,60,0.33,0.35,0.34,7524,15,84,279
220215,FREED-HARDEMAN UNIVERSITY,1,0,1998,NA,NA,358,199,159,116,53,63,0.31,0.33,0.32,7894,15,87,339
220215,FREED-HARDEMAN UNIVERSITY,1,0,1999,NA,NA,322,187,135,125,59,66,0.35000000000000003,0.44,0.39,7328,19,95,287
220215,FREED-HARDEMAN UNIVERSITY,1,0,2000,NA,NA,357,198,159,132,60,72,0.36,0.38,0.37,7696,22,94,336
220215,FREED-HARDEMAN UNIVERSITY,1,0,2001,NA,NA,346,191,155,146,58,88,0.46,0.37,0.42,8080,23,93,317
220215,FREED-HARDEMAN UNIVERSITY,1,0,2002,NA,NA,414,231,183,181,73,108,0.46,0.4,0.44,8568,25,94,385
220215,FREED-HARDEMAN UNIVERSITY,1,0,2003,NA,NA,374,211,163,138,53,85,0.4,0.33,0.37,9300,26,97,347
220215,FREED-HARDEMAN UNIVERSITY,1,0,2004,NA,NA,371,205,166,145,54,91,0.44,0.33,0.39,10080,28,99,342
220215,Freed-Hardeman University,1,0,2005,NA,NA,373,203,170,139,61,78,0.38,0.36,0.37,10500,31,106,340
220215,Freed-Hardeman University,1,0,2006,NA,NA,358,206,152,145,48,97,0.47000000000000003,0.32,0.41,11100,34,112,331
220215,Freed-Hardeman University,1,0,2007,NA,NA,385,222,163,148,58,90,0.4,0.36,0.38,11100,35,108,346
220215,Freed-Hardeman University,1,0,2008,NA,NA,405,220,185,154,61,93,0.42,0.33,0.38,11700,36,113,368
220215,Freed-Hardeman University,1,0,2009,NA,NA,405,240,165,177,72,105,0.43,0.44,0.44,12060,37,106,358
220215,Freed-Hardeman University,1,0,2010,NA,NA,370,214,156,164,62,102,0.47000000000000003,0.4,0.44,12840,34,97,328
220613,LEE COLLEGE,1,0,1991,NA,NA,368,185,183,62,24,38,0.2,0.13,0.17,4418,13,73,336
220613,LEE COLLEGE,1,0,1992,NA,NA,359,207,152,63,20,43,0.2,0.13,0.18,4282,14,75,278
220613,LEE COLLEGE,1,0,1993,NA,NA,395,205,190,87,37,50,0.24,0.19,0.22,4560,15,74,337
220613,LEE COLLEGE,1,0,1995,NA,NA,493,287,206,115,37,78,0.27,0.18,0.23,5132,17,94,479
220613,LEE COLLEGE,1,0,1996,NA,NA,525,304,221,128,45,83,0.27,0.2,0.24,5472,20,87,504
220613,LEE UNIVERSITY,1,0,1997,NA,NA,655,379,276,149,50,99,0.26,0.18,0.23,5636,23,94,627
220613,LEE UNIVERSITY,1,0,1998,NA,NA,722,417,305,193,62,131,0.31,0.2,0.27,5966,24,99,640
220613,LEE UNIVERSITY,1,0,1999,NA,NA,690,400,290,213,80,133,0.33,0.28,0.31,6118,27,119,626
220613,LEE UNIVERSITY,1,0,2000,NA,NA,711,435,276,204,72,132,0.3,0.26,0.29,6700,31,125,594
220613,LEE UNIVERSITY,1,0,2001,NA,NA,663,405,258,204,57,147,0.36,0.22,0.31,7336,29,132,588
220613,LEE UNIVERSITY,1,0,2002,NA,NA,705,423,282,195,60,135,0.31,0.21,0.28,8040,31,133,610
220613,LEE UNIVERSITY,1,0,2003,NA,NA,646,393,253,197,66,131,0.33,0.26,0.3,8520,35,152,548
220613,LEE UNIVERSITY,1,0,2004,NA,NA,723,430,293,223,67,156,0.36,0.23,0.31,8950,38,142,621
220613,Lee University,1,0,2005,NA,NA,755,454,301,297,99,198,0.43,0.33,0.39,9400,40,168,629
220613,Lee University,1,0,2006,NA,NA,810,473,337,270,77,193,0.4,0.23,0.33,9888,44,169,648
220613,Lee University,1,0,2007,NA,NA,783,437,346,271,88,183,0.41000000000000003,0.25,0.35,10392,47,174,624
220613,Lee University,1,0,2008,NA,NA,848,501,347,333,103,230,0.45,0.3,0.39,10824,49,160,705
220613,Lee University,1,0,2009,NA,NA,829,507,322,288,80,208,0.41000000000000003,0.25,0.35,11100,50,148,692
220613,Lee University,1,0,2010,NA,NA,851,494,357,288,93,195,0.39,0.26,0.34,11660,51,161,678
220631,LINCOLN MEMORIAL UNIVERSITY,1,0,1991,NA,NA,311,209,102,126,40,86,0.41000000000000003,0.39,0.41,4790,11,55,290
220631,LINCOLN MEMORIAL UNIVERSITY,1,0,1992,NA,NA,328,207,121,127,47,80,0.38,0.39,0.39,5250,12,61,302
220631,LINCOLN MEMORIAL UNIVERSITY,1,0,1993,NA,NA,217,134,83,59,23,36,0.26,0.28,0.27,5530,12,69,197
220631,LINCOLN MEMORIAL UNIVERSITY,1,0,1995,NA,NA,204,131,73,31,9,22,0.16,0.12,0.15,6550,12,70,185
220631,LINCOLN MEMORIAL UNIVERSITY,1,0,1996,NA,NA,212,134,78,58,23,35,0.26,0.29,0.27,6950,12,72,186
220631,LINCOLN MEMORIAL UNIVERSITY,1,0,1997,NA,NA,134,88,46,39,15,24,0.27,0.33,0.29,7400,12,72,110
220631,LINCOLN MEMORIAL UNIVERSITY,1,0,1998,NA,NA,179,122,57,31,10,21,0.17,0.18,0.17,8100,12,77,156
220631,LINCOLN MEMORIAL UNIVERSITY,1,0,1999,NA,NA,113,80,33,35,9,26,0.32,0.27,0.31,8520,13,74,102
220631,LINCOLN MEMORIAL UNIVERSITY,1,0,2000,NA,NA,168,104,64,50,21,29,0.27,0.33,0.3,9600,14,76,146
220631,LINCOLN MEMORIAL UNIVERSITY,1,0,2001,NA,NA,153,101,52,34,12,22,0.21,0.23,0.22,10800,15,79,124
220631,LINCOLN MEMORIAL UNIVERSITY,1,0,2002,NA,NA,151,109,42,33,8,25,0.22,0.19,0.22,11760,14,80,135
220631,LINCOLN MEMORIAL UNIVERSITY,1,0,2003,NA,NA,183,129,54,33,7,26,0.2,0.13,0.18,11760,18,91,160
220631,LINCOLN MEMORIAL UNIVERSITY,1,0,2004,NA,NA,201,138,63,50,18,32,0.23,0.29,0.25,12600,19,94,143
220631,Lincoln Memorial University,1,0,2005,NA,NA,139,90,49,25,6,19,0.21,0.12,0.18,13104,21,101,105
220631,Lincoln Memorial University,1,0,2006,NA,NA,219,135,84,3,0,3,0.02,0,0.01,13752,25,113,185
220631,Lincoln Memorial University,1,0,2007,NA,NA,230,159,71,23,19,4,0.02,0.27,0.1,14400,29,116,198
220631,Lincoln Memorial University,1,0,2008,NA,NA,256,169,87,31,10,21,0.12,0.11,0.12,15120,37,120,209
220631,Lincoln Memorial University,1,0,2009,NA,NA,314,218,96,61,15,46,0.21,0.16,0.19,15120,53,138,243
220631,Lincoln Memorial University,1,0,2010,NA,NA,352,232,120,115,46,69,0.29,0.38,0.33,16200,56,150,254
220710,MARYVILLE COLLEGE,1,0,1991,NA,NA,154,80,74,50,16,34,0.42,0.22,0.32,8400,10,47,128
220710,MARYVILLE COLLEGE,1,0,1992,NA,NA,194,94,100,67,23,44,0.46,0.23,0.35,9580,11,50,172
220710,MARYVILLE COLLEGE,1,0,1993,NA,NA,175,73,102,56,28,28,0.38,0.27,0.32,10428,12,50,161
220710,MARYVILLE COLLEGE,1,0,1995,NA,NA,217,106,111,86,32,54,0.5,0.29,0.4,12246,15,51,197
220710,MARYVILLE COLLEGE,1,0,1996,NA,NA,259,134,125,134,54,80,0.59,0.43,0.52,13030,18,57,231
220710,MARYVILLE COLLEGE,1,0,1997,NA,NA,245,117,128,99,44,55,0.47000000000000003,0.34,0.4,14425,13,61,227
220710,MARYVILLE COLLEGE,1,0,1998,NA,NA,228,132,96,96,35,61,0.46,0.36,0.42,15425,14,61,206
220710,MARYVILLE COLLEGE,1,0,1999,NA,NA,313,174,139,141,50,91,0.52,0.36,0.45,15600,15,58,285
220710,MARYVILLE COLLEGE,1,0,2000,NA,NA,269,132,137,135,54,81,0.61,0.39,0.5,16224,16,58,244
220710,MARYVILLE COLLEGE,1,0,2001,NA,NA,288,166,122,133,35,98,0.59,0.29,0.46,16985,17,59,257
220710,MARYVILLE COLLEGE,1,0,2002,NA,NA,246,127,119,103,44,59,0.46,0.37,0.42,18260,18,64,208
220710,MARYVILLE COLLEGE,1,0,2003,NA,NA,293,140,153,133,51,82,0.58,0.33,0.45,19180,19,65,270
220710,MARYVILLE COLLEGE,1,0,2004,NA,NA,317,169,148,155,56,99,0.58,0.38,0.49,20465,21,66,292
220710,Maryville College,1,0,2005,NA,NA,333,163,170,158,67,91,0.55,0.39,0.47,21624,22,67,292
220710,Maryville College,1,0,2006,NA,NA,298,163,135,123,49,74,0.45,0.36,0.41,23125,23,79,265
220710,Maryville College,1,0,2007,NA,NA,317,158,159,148,49,99,0.62,0.31,0.47,24675,26,80,271
220710,Maryville College,1,0,2008,NA,NA,297,146,151,120,50,70,0.47000000000000003,0.33,0.4,26272,28,95,262
220710,Maryville College,1,0,2009,NA,NA,304,154,150,56,46,10,0.06,0.31,0.18,27296,28,79,260
220710,Maryville College,1,0,2010,NA,NA,277,126,151,129,53,76,0.6,0.35,0.47,28798,28,79,226
221351,RHODES COLLEGE,1,0,1991,NA,NA,379,208,171,258,108,150,0.72,0.63,0.68,12958,30,104,345
221351,RHODES COLLEGE,1,0,1992,NA,NA,360,202,158,256,113,143,0.7000000000000001,0.72,0.71,13950,33,109,330
221351,RHODES COLLEGE,1,0,1993,NA,NA,385,215,170,284,124,160,0.74,0.73,0.74,14916,34,110,350
221351,RHODES COLLEGE,1,0,1995,NA,NA,373,204,169,256,105,151,0.74,0.62,0.69,15920,35,109,340
221351,RHODES COLLEGE,1,0,1996,NA,NA,375,196,179,264,128,136,0.6900000000000001,0.72,0.7,16550,40,116,357
221351,RHODES COLLEGE,1,0,1997,NA,NA,422,239,183,301,128,173,0.72,0.7,0.71,17518,32,115,370
221351,RHODES COLLEGE,1,0,1998,NA,NA,383,206,177,291,128,163,0.79,0.72,0.76,18196,35,119,343
221351,RHODES COLLEGE,1,0,1999,NA,NA,438,251,187,338,143,195,0.77,0.76,0.77,18561,37,114,382
221351,RHODES COLLEGE,1,0,2000,NA,NA,396,227,169,296,125,171,0.75,0.74,0.75,19303,38,125,352
221351,RHODES COLLEGE,1,0,2001,NA,NA,417,249,168,292,107,185,0.74,0.64,0.7,20366,41,137,359
221351,RHODES COLLEGE,1,0,2002,NA,NA,439,238,201,306,136,170,0.71,0.68,0.7,21366,44,139,379
221351,RHODES COLLEGE,1,0,2003,NA,NA,456,274,182,343,140,203,0.74,0.77,0.75,22628,46,149,397
221351,RHODES COLLEGE,1,0,2004,NA,NA,474,269,205,360,144,216,0.8,0.7,0.76,23964,48,148,424
221351,Rhodes College,1,0,2005,NA,NA,440,255,185,313,131,182,0.71,0.71,0.71,26175,51,157,375
221351,Rhodes College,1,0,2006,NA,NA,451,272,179,363,141,222,0.81,0.79,0.8,27450,55,147,375
221351,Rhodes College,1,0,2007,NA,NA,452,252,200,335,148,187,0.74,0.74,0.74,30342,57,149,357
221351,Rhodes College,1,0,2008,NA,NA,475,276,199,353,143,210,0.76,0.72,0.74,32136,59,155,342
221351,Rhodes College,1,0,2009,NA,NA,427,236,191,320,133,187,0.79,0.7,0.75,33400,61,159,297
221351,Rhodes College,1,0,2010,NA,NA,500,307,193,382,139,243,0.79,0.72,0.76,34270,62,164,390
221519,THE UNIVERSITY OF THE SOUTH,1,0,1991,NA,NA,327,159,168,236,118,118,0.74,0.7,0.72,13505,31,97,297
221519,UNIVERSITY OF THE SOUTH,1,0,1992,NA,NA,338,171,167,230,111,119,0.6900000000000001,0.66,0.68,14060,37,95,317
221519,UNIVERSITY OF THE SOUTH,1,0,1993,NA,NA,322,157,165,250,131,119,0.75,0.79,0.78,14910,41,99,315
221519,UNIVERSITY OF THE SOUTH,1,0,1995,NA,NA,370,197,173,275,120,155,0.78,0.69,0.74,16140,41,107,356
221519,UNIVERSITY OF THE SOUTH,1,0,1996,NA,NA,365,205,160,264,115,149,0.72,0.72,0.72,16790,46,111,339
221519,UNIVERSITY OF THE SOUTH,1,0,1997,NA,NA,364,195,169,285,130,155,0.79,0.77,0.78,17555,46,114,343
221519,UNIVERSITY OF THE SOUTH,1,0,1998,NA,NA,382,198,184,284,124,160,0.8,0.67,0.74,18350,50,121,357
221519,UNIVERSITY OF THE SOUTH,1,0,1999,NA,NA,391,227,164,308,123,185,0.81,0.75,0.79,18900,52,122,358
221519,UNIVERSITY OF THE SOUTH,1,0,2000,NA,NA,385,203,182,276,126,150,0.73,0.69,0.72,19940,54,124,357
221519,UNIVERSITY OF THE SOUTH,1,0,2001,NA,NA,353,185,168,259,117,142,0.76,0.7,0.73,21140,57,126,319
221519,UNIVERSITY OF THE SOUTH,1,0,2002,NA,NA,368,198,170,270,116,154,0.77,0.68,0.73,22370,58,122,327
221519,SEWANEE-THE UNIVERSITY OF THE SOUTH,1,0,2003,NA,NA,426,239,187,318,142,176,0.73,0.76,0.75,23930,58,135,382
221519,SEWANEE: THE UNIVERSITY OF THE SOUTH,1,0,2004,NA,NA,397,207,190,309,142,167,0.8,0.75,0.78,25374,60,128,361
221519,Sewanee:  The University of the South,1,0,2005,NA,NA,420,241,179,337,144,193,0.8,0.8,0.8,26874,64,132,383
221519,Sewanee:  The University of the South,1,0,2006,NA,NA,412,202,210,305,150,155,0.76,0.71,0.74,28528,66,138,357
221519,Sewanee:  The University of the South,1,0,2007,NA,NA,401,235,166,303,115,188,0.8,0.69,0.76,30438,72,136,352
221519,Sewanee:  The University of the South,1,0,2008,NA,NA,409,199,210,310,149,161,0.8,0.71,0.76,32488,75,129,354
221519,Sewanee-The University of the South,1,0,2009,NA,NA,401,203,198,296,140,156,0.76,0.71,0.74,33900,79,133,331
221519,Sewanee-The University of the South,1,0,2010,NA,NA,401,216,185,317,138,179,0.8200000000000001,0.75,0.79,35590,77,136,338
221731,TENNESSEE WESLEYAN COLLEGE,1,0,1991,NA,NA,90,38,52,18,6,12,0.31,0.12,0.2,5564,6,26,74
221731,TENNESSEE WESLEYAN COLLEGE,1,0,1992,NA,NA,74,20,54,13,3,10,0.5,0.06,0.18,5990,6,32,54
221731,TENNESSEE WESLEYAN COLLEGE,1,0,1993,NA,NA,90,28,62,8,2,6,0.21,0.03,0.09,6430,5,35,66
221731,TENNESSEE WESLEYAN COLLEGE,1,0,1995,NA,NA,90,49,41,29,7,22,0.44,0.17,0.32,6100,5,28,71
221731,TENNESSEE WESLEYAN COLLEGE,1,0,1996,NA,NA,145,98,47,2,0,2,0.02,0,0.01,6300,5,30,132
221731,TENNESSEE WESLEYAN COLLEGE,1,0,1997,NA,NA,96,61,35,35,12,23,0.37,0.34,0.36,6500,4,28,94
221731,TENNESSEE WESLEYAN COLLEGE,1,0,1998,NA,NA,105,61,44,28,8,20,0.32,0.18,0.27,6950,4,31,102
221731,TENNESSEE WESLEYAN COLLEGE,1,0,1999,NA,NA,140,93,47,22,3,19,0.2,0.06,0.16,7400,5,40,130
221731,TENNESSEE WESLEYAN COLLEGE,1,0,2000,NA,NA,134,72,62,35,9,26,0.36,0.15,0.26,7900,5,41,121
221731,TENNESSEE WESLEYAN COLLEGE,1,0,2001,NA,NA,119,69,50,33,9,24,0.34,0.18,0.28,8500,6,42,111
221731,TENNESSEE WESLEYAN COLLEGE,1,0,2002,NA,NA,128,79,49,34,5,29,0.36,0.1,0.27,10000,7,43,112
221731,TENNESSEE WESLEYAN COLLEGE,1,0,2003,NA,NA,106,63,43,33,4,29,0.46,0.09,0.31,11000,7,44,86
221731,TENNESSEE WESLEYAN COLLEGE,1,0,2004,NA,NA,163,102,61,49,11,38,0.37,0.18,0.3,12000,7,42,124
221731,Tennessee Wesleyan College,1,0,2005,NA,NA,167,100,67,52,14,38,0.38,0.21,0.31,13000,8,45,122
221731,Tennessee Wesleyan College,1,0,2006,NA,NA,160,88,72,42,10,32,0.36,0.14,0.26,14000,9,46,132
221731,Tennessee Wesleyan College,1,0,2007,NA,NA,153,86,67,49,19,30,0.34,0.28,0.32,15000,10,49,138
221731,Tennessee Wesleyan College,1,0,2008,NA,NA,251,141,110,77,30,47,0.33,0.27,0.31,16500,12,46,215
221731,Tennessee Wesleyan College,1,0,2009,NA,NA,246,163,83,75,22,53,0.32,0.27,0.3,18000,13,52,218
221731,Tennessee Wesleyan College,1,0,2010,NA,NA,218,142,76,70,20,50,0.35000000000000003,0.26,0.32,18500,14,51,180
221847,TENNESSEE TECHNOLOGICAL UNIVERSITY,1,0,1991,NA,NA,1362,637,725,185,57,128,0.2,0.08,0.14,1485,69,371,1288
221847,TENNESSEE TECHNOLOGICAL UNIVERSITY,1,0,1992,NA,NA,1381,584,797,267,113,154,0.26,0.14,0.19,1634,70,369,1294
221847,TENNESSEE TECHNOLOGICAL UNIVERSITY,1,0,1993,NA,NA,1330,608,722,172,55,117,0.19,0.08,0.13,1710,72,376,1257
221847,TENNESSEE TECHNOLOGICAL UNIVERSITY,1,0,1995,NA,NA,1113,513,600,130,37,93,0.18,0.06,0.12,1840,76,386,1052
221847,TENNESSEE TECHNOLOGICAL UNIVERSITY,1,0,1996,NA,NA,1130,497,633,134,39,95,0.19,0.06,0.12,1890,79,371,1053
221847,TENNESSEE TECHNOLOGICAL UNIVERSITY,1,0,1997,NA,NA,1089,466,623,100,33,67,0.14,0.05,0.09,2116,80,362,1005
221847,TENNESSEE TECHNOLOGICAL UNIVERSITY,1,0,1998,NA,NA,1044,460,584,124,38,86,0.18,0.07,0.12,2306,80,363,956
221847,TENNESSEE TECHNOLOGICAL UNIVERSITY,1,0,1999,NA,NA,1175,524,651,67,63,4,0,0.1,0.06,2020,86,369,1087
221847,TENNESSEE TECHNOLOGICAL UNIVERSITY,1,0,2000,NA,NA,1305,609,696,241,85,156,0.25,0.12,0.18,2222,86,365,1183
221847,TENNESSEE TECHNOLOGICAL UNIVERSITY,1,0,2001,NA,NA,1289,529,760,230,108,122,0.23,0.14,0.18,2556,92,361,1173
221847,TENNESSEE TECHNOLOGICAL UNIVERSITY,1,0,2002,NA,NA,1376,585,791,251,99,152,0.25,0.13,0.18,2748,94,371,1228
221847,TENNESSEE TECHNOLOGICAL UNIVERSITY,1,0,2003,NA,NA,1374,577,797,300,133,167,0.28,0.17,0.22,3132,101,362,1221
221847,TENNESSEE TECHNOLOGICAL UNIVERSITY,1,0,2004,NA,NA,1476,611,865,312,122,190,0.31,0.14,0.21,3352,102,372,1258
221847,Tennessee Technological University,1,0,2005,NA,NA,1409,623,786,321,121,200,0.32,0.15,0.23,3678,108,358,1239
221847,Tennessee Technological University,1,0,2006,NA,NA,1515,653,862,301,127,174,0.26,0.15,0.2,3828,116,372,1337
221847,Tennessee Technological University,1,0,2007,NA,NA,1649,730,919,371,157,214,0.29,0.17,0.22,4058,122,373,1469
221847,Tennessee Technological University,1,0,2008,NA,NA,1659,736,923,379,165,214,0.29,0.18,0.23,4302,132,368,1414
221847,Tennessee Technological University,1,0,2009,NA,NA,1879,884,995,476,181,295,0.33,0.18,0.25,4584,140,371,1676
221847,Tennessee Technological University,1,0,2010,NA,NA,1898,846,1052,468,177,291,0.34,0.17,0.25,4824,135,380,1662
221892,TREVECCA NAZARENE COLLEGE,1,0,1991,NA,NA,193,113,80,46,23,23,0.2,0.29,0.24,5720,13,86,154
221892,TREVECCA NAZARENE COLLEGE,1,0,1992,NA,NA,180,96,84,27,10,17,0.17,0.12,0.15,6220,12,53,158
221892,TREVECCA NAZARENE COLLEGE,1,0,1993,NA,NA,139,84,55,25,9,16,0.19,0.16,0.18,6721,12,57,125
221892,TREVECCA NAZARENE UNIVERSITY,1,0,1995,NA,NA,214,113,101,43,14,29,0.25,0.14,0.2,7856,13,64,196
221892,TREVECCA NAZARENE UNIVERSITY,1,0,1996,NA,NA,189,108,81,37,9,28,0.25,0.11,0.2,8644,17,65,166
221892,TREVECCA NAZARENE UNIVERSITY,1,0,1997,NA,NA,179,100,79,30,9,21,0.21,0.11,0.17,8660,14,64,164
221892,TREVECCA NAZARENE UNIVERSITY,1,0,1998,NA,NA,187,111,76,40,16,24,0.21,0.21,0.21,9536,16,63,176
221892,TREVECCA NAZARENE UNIVERSITY,1,0,1999,NA,NA,192,119,73,43,14,29,0.24,0.19,0.22,10016,17,64,178
221892,TREVECCA NAZARENE UNIVERSITY,1,0,2000,NA,NA,220,130,90,80,24,56,0.43,0.27,0.36,10528,18,67,198
221892,TREVECCA NAZARENE UNIVERSITY,1,0,2001,NA,NA,216,112,104,82,36,46,0.41000000000000003,0.35,0.38,10848,19,71,199
221892,TREVECCA NAZARENE UNIVERSITY,1,0,2002,NA,NA,198,134,64,75,24,51,0.38,0.38,0.38,11390,22,74,180
221892,TREVECCA NAZARENE UNIVERSITY,1,0,2003,NA,NA,219,126,93,82,31,51,0.4,0.33,0.37,11960,23,77,195
221892,TREVECCA NAZARENE UNIVERSITY,1,0,2004,NA,NA,237,119,118,84,38,46,0.38,0.32,0.35,12792,24,77,208
221892,Trevecca Nazarene University,1,0,2005,NA,NA,239,124,115,95,40,55,0.44,0.35,0.4,13432,26,73,207
221892,Trevecca Nazarene University,1,0,2006,NA,NA,240,147,93,97,32,65,0.44,0.34,0.4,14774,28,79,211
221892,Trevecca Nazarene University,1,0,2007,NA,NA,238,139,99,85,31,54,0.38,0.31,0.36,15512,30,76,209
221892,Trevecca Nazarene University,1,0,2008,NA,NA,218,125,93,86,31,55,0.44,0.33,0.39,16288,33,80,183
221892,Trevecca Nazarene University,1,0,2009,NA,NA,240,145,95,96,35,61,0.42,0.37,0.4,16776,34,87,203
221892,Trevecca Nazarene University,1,0,2010,NA,NA,234,142,92,92,33,59,0.41000000000000003,0.36,0.39,18318,36,87,180
222178,ABILENE CHRISTIAN UNIVERSITY,1,0,1991,NA,NA,656,338,318,176,75,101,0.29,0.24,0.27,6510,43,175,546
222178,ABILENE CHRISTIAN UNIVERSITY,1,0,1992,NA,NA,672,323,349,168,66,102,0.31,0.19,0.25,6900,43,165,436
222178,ABILENE CHRISTIAN UNIVERSITY,1,0,1993,NA,NA,650,343,307,165,66,99,0.28,0.21,0.25,7170,45,160,441
222178,ABILENE CHRISTIAN UNIVERSITY,1,0,1995,NA,NA,917,506,411,250,93,157,0.31,0.23,0.27,7800,48,168,771
222178,ABILENE CHRISTIAN UNIVERSITY,1,0,1996,NA,NA,898,478,420,241,97,144,0.3,0.23,0.27,8660,54,186,761
222178,ABILENE CHRISTIAN UNIVERSITY,1,0,1997,NA,NA,964,530,434,259,97,162,0.3,0.22,0.27,9180,51,189,813
222178,ABILENE CHRISTIAN UNIVERSITY,1,0,1998,NA,NA,988,541,447,280,110,170,0.31,0.25,0.28,9710,54,201,857
222178,ABILENE CHRISTIAN UNIVERSITY,1,0,1999,NA,NA,924,533,391,335,120,215,0.4,0.31,0.36,9810,58,208,749
222178,ABILENE CHRISTIAN UNIVERSITY,1,0,2000,NA,NA,1023,565,458,355,139,216,0.38,0.3,0.35,10410,63,218,856
222178,ABILENE CHRISTIAN UNIVERSITY,1,0,2001,NA,NA,1031,598,433,387,127,260,0.43,0.29,0.38,11130,67,228,845
222178,ABILENE CHRISTIAN UNIVERSITY,1,0,2002,NA,NA,942,536,406,360,112,248,0.46,0.28,0.38,11910,69,226,761
222178,ABILENE CHRISTIAN UNIVERSITY,1,0,2003,NA,NA,948,489,459,369,125,244,0.49,0.27,0.39,12750,75,227,763
222178,ABILENE CHRISTIAN UNIVERSITY,1,0,2004,NA,NA,1018,553,465,377,127,250,0.45,0.27,0.37,13650,76,216,808
222178,Abilene Christian University,1,0,2005,NA,NA,1030,560,470,393,150,243,0.43,0.32,0.38,14610,82,211,821
222178,Abilene Christian University,1,0,2006,NA,NA,961,526,435,394,147,247,0.46,0.34,0.41,15630,84,216,777
222178,Abilene Christian University,1,0,2007,NA,NA,887,476,411,324,113,211,0.44,0.27,0.37,16710,94,222,683
222178,Abilene Christian University,1,0,2008,NA,NA,971,518,453,434,167,267,0.51,0.37,0.45,17880,96,221,761
222178,Abilene Christian University,1,0,2009,NA,NA,979,520,459,406,136,270,0.51,0.3,0.41,19200,105,228,730
222178,Abilene Christian University,1,0,2010,NA,NA,977,526,451,465,194,271,0.51,0.43,0.48,21510,105,241,785
222983,AUSTIN COLLEGE,1,0,1991,NA,NA,307,173,134,187,77,110,0.63,0.57,0.61,9465,21,85,251
222983,AUSTIN COLLEGE,1,0,1992,NA,NA,289,144,145,165,76,89,0.61,0.52,0.57,10085,21,84,219
222983,AUSTIN COLLEGE,1,0,1993,NA,NA,294,175,119,165,57,108,0.61,0.48,0.56,10740,21,84,218
222983,AUSTIN COLLEGE,1,0,1995,NA,NA,293,155,138,195,90,105,0.67,0.65,0.67,12070,23,87,215
222983,AUSTIN COLLEGE,1,0,1996,NA,NA,344,181,163,254,106,148,0.81,0.65,0.74,12675,23,87,289
222983,AUSTIN COLLEGE,1,0,1997,NA,NA,317,150,167,215,103,112,0.74,0.62,0.68,13435,23,83,246
222983,AUSTIN COLLEGE,1,0,1998,NA,NA,347,190,157,242,97,145,0.76,0.62,0.7,14205,25,83,262
222983,AUSTIN COLLEGE,1,0,1999,NA,NA,324,188,136,222,74,148,0.78,0.54,0.69,14785,26,79,254
222983,AUSTIN COLLEGE,1,0,2000,NA,NA,347,186,161,249,106,143,0.76,0.66,0.72,15177,29,82,280
222983,AUSTIN COLLEGE,1,0,2001,NA,NA,312,174,138,220,91,129,0.74,0.66,0.71,15792,31,85,235
222983,AUSTIN COLLEGE,1,0,2002,NA,NA,347,191,156,245,104,141,0.73,0.67,0.71,16392,32,91,261
222983,AUSTIN COLLEGE,1,0,2003,NA,NA,338,193,145,228,86,142,0.73,0.59,0.67,17740,33,94,257
222983,AUSTIN COLLEGE,1,0,2004,NA,NA,370,193,177,274,121,153,0.79,0.68,0.74,18980,34,97,283
222983,Austin College,1,0,2005,NA,NA,347,171,176,239,103,136,0.79,0.59,0.69,20310,34,91,253
222983,Austin College,1,0,2006,NA,NA,340,175,165,251,113,138,0.78,0.68,0.74,23355,37,92,241
222983,Austin College,1,0,2007,NA,NA,333,174,159,223,91,132,0.75,0.57,0.67,24760,41,95,233
222983,Austin College,1,0,2008,NA,NA,318,191,127,229,88,141,0.73,0.69,0.72,26370,42,94,203
222983,Austin College,1,0,2009,NA,NA,413,213,200,295,129,166,0.77,0.64,0.71,27690,42,95,260
222983,Austin College,1,0,2010,NA,NA,318,173,145,220,90,130,0.75,0.62,0.69,29075,45,93,195
223232,BAYLOR UNIVERSITY,1,0,1991,NA,NA,2150,1240,910,947,347,600,0.48,0.38,0.44,6110,126,598,1763
223232,BAYLOR UNIVERSITY,1,0,1992,NA,NA,2363,1400,963,930,336,594,0.42,0.35,0.39,6590,135,589,1879
223232,BAYLOR UNIVERSITY,1,0,1993,NA,NA,2426,1420,1006,978,350,628,0.44,0.35,0.4,7070,141,601,1958
223232,BAYLOR UNIVERSITY,1,0,1995,NA,NA,2329,1390,939,1004,337,667,0.47000000000000003,0.36,0.43,8444,155,600,1796
223232,BAYLOR UNIVERSITY,1,0,1996,NA,NA,2463,1444,1019,1062,350,712,0.49,0.34,0.43,8806,170,606,1895
223232,BAYLOR UNIVERSITY,1,0,1997,NA,NA,2404,1416,988,967,300,667,0.47000000000000003,0.3,0.4,9478,155,606,1856
223232,BAYLOR UNIVERSITY,1,0,1998,NA,NA,2933,1712,1221,1261,405,856,0.5,0.33,0.43,10316,165,629,2204
223232,BAYLOR UNIVERSITY,1,0,1999,NA,NA,2766,1668,1098,1272,379,893,0.53,0.35,0.46,9870,184,676,2107
223232,BAYLOR UNIVERSITY,1,0,2000,NA,NA,2822,1666,1156,1388,442,946,0.56,0.38,0.49,10650,203,700,2229
223232,BAYLOR UNIVERSITY,1,0,2001,NA,NA,2790,1664,1126,1340,434,906,0.54,0.39,0.48,11370,218,725,2198
223232,BAYLOR UNIVERSITY,1,0,2002,NA,NA,2601,1558,1043,1323,439,884,0.56,0.42,0.51,15700,245,756,1992
223232,BAYLOR UNIVERSITY,1,0,2003,NA,NA,2667,1673,994,1266,347,919,0.54,0.35,0.47,16750,273,777,1945
223232,BAYLOR UNIVERSITY,1,0,2004,NA,NA,2772,1674,1098,1398,488,910,0.54,0.44,0.5,17900,286,770,1924
223232,Baylor University,1,0,2005,NA,NA,3158,1867,1291,1641,582,1059,0.56,0.45,0.52,19050,304,755,2156
223232,Baylor University,1,0,2006,NA,NA,2775,1713,1062,1550,494,1056,0.61,0.47,0.56,20574,317,767,2065
223232,Baylor University,1,0,2007,NA,NA,2721,1618,1103,1556,552,1004,0.62,0.5,0.57,22220,343,813,1897
223232,Baylor University,1,0,2008,NA,NA,3054,1801,1253,1669,594,1075,0.59,0.47,0.55,23664,378,823,2041
223232,Baylor University,1,0,2009,NA,NA,3097,1825,1272,1672,592,1080,0.59,0.47,0.54,25320,410,859,1947
223232,Baylor University,1,0,2010,NA,NA,3254,1913,1341,1897,668,1229,0.64,0.5,0.58,26966,421,870,2050
224004,CONCORDIA LUTHERAN COLLEGE,1,0,1991,NA,NA,116,72,44,26,7,19,0.26,0.16,0.22,6090,6,26,94
224004,CONCORDIA LUTHERAN COLLEGE,1,0,1992,NA,NA,115,65,50,16,2,14,0.21,0.04,0.14,6360,6,27,95
224004,CONCORDIA LUTHERAN COLLEGE,1,0,1993,NA,NA,107,62,45,26,7,19,0.3,0.16,0.24,6760,6,31,87
224004,CONCORDIA UNIVERSITY AT AUSTIN,1,0,1995,NA,NA,90,55,35,18,5,13,0.23,0.14,0.2,7980,7,33,73
224004,CONCORDIA UNIVERSITY AT AUSTIN,1,0,1996,NA,NA,121,74,47,42,12,30,0.4,0.26,0.35,8680,8,33,101
224004,CONCORDIA UNIVERSITY AT AUSTIN,1,0,1997,NA,NA,125,57,68,15,7,8,0.14,0.1,0.12,9500,7,34,89
224004,CONCORDIA UNIVERSITY AT AUSTIN,1,0,1998,NA,NA,127,75,52,23,8,15,0.2,0.15,0.18,10500,7,38,99
224004,CONCORDIA UNIVERSITY AT AUSTIN,1,0,1999,NA,NA,134,66,68,15,10,5,0.07,0.15,0.11,11500,8,43,93
224004,CONCORDIA UNIVERSITY AT AUSTIN,1,0,2000,NA,NA,130,73,57,24,8,16,0.21,0.14,0.18,12500,9,40,88
224004,CONCORDIA UNIVERSITY AT AUSTIN,1,0,2001,NA,NA,189,104,85,28,10,18,0.17,0.12,0.15,13120,10,38,139
224004,CONCORDIA UNIVERSITY AT AUSTIN,1,0,2002,NA,NA,166,85,81,12,9,3,0.03,0.11,0.07,14300,11,40,120
224004,CONCORDIA UNIVERSITY AT AUSTIN,1,0,2003,NA,NA,154,83,71,26,13,13,0.15,0.18,0.17,15300,12,37,101
224004,CONCORDIA UNIVERSITY AT AUSTIN,1,0,2004,NA,NA,149,84,65,21,10,11,0.13,0.15,0.14,16050,12,44,98
224004,Concordia University at Austin,1,0,2005,NA,NA,196,96,100,40,12,28,0.29,0.12,0.2,16740,13,37,136
224004,Concordia University at Austin,1,0,2006,NA,NA,191,89,102,37,16,21,0.23,0.16,0.19,17800,14,38,133
224004,Concordia University Texas,1,0,2007,NA,NA,160,87,73,29,9,20,0.22,0.12,0.18,18600,17,44,100
224004,Concordia University Texas,1,0,2008,NA,NA,229,129,100,44,16,28,0.21,0.16,0.19,20100,24,51,144
224004,Concordia University Texas,1,0,2009,NA,NA,225,122,103,58,22,36,0.29,0.21,0.26,20800,26,55,146
224004,Concordia University-Texas,1,0,2010,NA,NA,235,157,78,54,11,43,0.27,0.14,0.23,21700,28,55,137
224323,UNIVERSITY OF DALLAS,1,0,1991,NA,NA,280,163,117,138,50,88,0.53,0.43,0.49,8600,24,99,209
224323,UNIVERSITY OF DALLAS,1,0,1992,NA,NA,251,137,114,114,42,72,0.52,0.37,0.45,9400,26,102,169
224323,UNIVERSITY OF DALLAS,1,0,1993,NA,NA,246,138,108,118,56,62,0.44,0.52,0.48,10200,30,108,171
224323,UNIVERSITY OF DALLAS,1,0,1995,NA,NA,244,146,98,134,58,76,0.52,0.59,0.55,11375,30,104,183
224323,UNIVERSITY OF DALLAS,1,0,1996,NA,NA,251,157,94,141,46,95,0.6,0.49,0.56,12113,33,104,190
224323,UNIVERSITY OF DALLAS,1,0,1997,NA,NA,261,160,101,136,47,89,0.55,0.47,0.52,12790,30,106,175
224323,UNIVERSITY OF DALLAS,1,0,1998,NA,NA,291,188,103,207,67,140,0.74,0.65,0.71,13672,33,118,217
224323,UNIVERSITY OF DALLAS,1,0,1999,NA,NA,309,191,118,188,67,121,0.63,0.57,0.61,14354,35,125,206
224323,UNIVERSITY OF DALLAS,1,0,2000,NA,NA,279,168,111,167,59,108,0.64,0.53,0.6,15028,38,127,184
224323,UNIVERSITY OF DALLAS,1,0,2001,NA,NA,310,180,130,170,77,93,0.51,0.59,0.55,15824,42,129,192
224323,UNIVERSITY OF DALLAS,1,0,2002,NA,NA,307,185,122,142,52,90,0.48,0.43,0.46,16694,44,130,207
224323,UNIVERSITY OF DALLAS,1,0,2003,NA,NA,299,189,110,185,58,127,0.67,0.53,0.62,17612,45,125,190
224323,UNIVERSITY OF DALLAS,1,0,2004,NA,NA,243,126,117,153,65,88,0.6900000000000001,0.56,0.63,18582,41,121,158
224323,University of Dallas,1,0,2005,NA,NA,256,165,91,160,53,107,0.64,0.58,0.62,19604,40,116,200
224323,University of Dallas,1,0,2006,NA,NA,315,169,146,189,82,107,0.63,0.56,0.6,20780,44,121,209
224323,University of Dallas,1,0,2007,NA,NA,362,200,162,201,85,116,0.58,0.52,0.56,21819,45,125,245
224323,University of Dallas,1,0,2008,NA,NA,341,168,173,216,104,112,0.66,0.6,0.63,23250,47,125,236
224323,University of Dallas,1,0,2009,NA,NA,319,169,150,212,96,116,0.68,0.64,0.66,24646,50,125,179
224323,University of Dallas,1,0,2010,NA,NA,375,207,168,223,89,134,0.64,0.53,0.59,27815,48,135,257
225432,UNIVERSITY OF HOUSTON-DOWNTOWN,1,0,1991,NA,NA,570,299,271,10,6,4,0.01,0.02,0.02,1150,29,149,95
225432,UNIVERSITY OF HOUSTON-DOWNTOWN,1,0,1992,NA,NA,540,275,265,3,1,2,0,0,0.01,1358,30,153,85
225432,UNIVERSITY OF HOUSTON-DOWNTOWN,1,0,1993,NA,NA,666,362,304,8,2,6,0.01,0.01,0.01,1506,31,153,103
225432,UNIVERSITY OF HOUSTON-DOWNTOWN,1,0,1995,NA,NA,624,351,273,10,3,7,0.01,0.01,0.02,1646,33,166,86
225432,UNIVERSITY OF HOUSTON-DOWNTOWN,1,0,1996,NA,NA,638,385,253,13,5,8,0.02,0.02,0.02,1866,39,166,69
225432,UNIVERSITY OF HOUSTON-DOWNTOWN,1,0,1997,NA,NA,679,374,305,14,2,12,0.03,0.01,0.02,2046,39,175,85
225432,UNIVERSITY OF HOUSTON-DOWNTOWN,1,0,1998,NA,NA,696,406,290,8,3,5,0.01,0.01,0.01,2106,41,181,89
225432,UNIVERSITY OF HOUSTON-DOWNTOWN,1,0,1999,NA,NA,729,418,311,10,3,7,0.01,0.01,0.01,1140,48,191,58
225432,UNIVERSITY OF HOUSTON-DOWNTOWN,1,0,2000,NA,NA,794,437,357,16,6,10,0.02,0.02,0.02,1200,51,205,94
225432,UNIVERSITY OF HOUSTON-DOWNTOWN,1,0,2001,NA,NA,869,481,388,19,5,14,0.02,0.01,0.02,1200,63,219,97
225432,UNIVERSITY OF HOUSTON-DOWNTOWN,1,0,2002,NA,NA,905,498,407,14,4,10,0.02,0.01,0.02,2220,73,243,76
225432,UNIVERSITY OF HOUSTON-DOWNTOWN,1,0,2003,NA,NA,1012,559,453,16,5,11,0.01,0.01,0.02,2088,89,236,115
225432,UNIVERSITY OF HOUSTON-DOWNTOWN,1,0,2004,NA,NA,964,541,423,10,5,5,0,0.01,0.01,3170,75,246,99
225432,University of Houston-Downtown,1,0,2005,NA,NA,889,487,402,20,8,12,0.02,0.02,0.02,2700,81,261,86
225432,University of Houston-Downtown,1,0,2006,NA,NA,840,452,388,12,7,5,0.01,0.02,0.01,2898,88,289,79
225432,University of Houston-Downtown,1,0,2007,NA,NA,831,438,393,22,7,15,0.03,0.02,0.03,3240,91,281,73
225432,University of Houston-Downtown,1,0,2008,NA,NA,699,400,299,20,9,11,0.02,0.03,0.03,3240,102,281,71
225432,University of Houston-Downtown,1,0,2009,NA,NA,722,378,344,10,6,4,0.01,0.02,0.01,3360,112,290,71
225432,University of Houston-Downtown,1,0,2010,NA,NA,824,453,371,11,3,8,0.01,0.01,0.01,3552,131,291,51
225548,HOWARD PAYNE UNIVERSITY,1,0,1991,NA,NA,266,125,141,42,14,28,0.22,0.1,0.16,4160,10,73,203
225548,HOWARD PAYNE UNIVERSITY,1,0,1992,NA,NA,265,123,142,60,31,29,0.23,0.22,0.23,4430,11,70,219
225548,HOWARD PAYNE UNIVERSITY,1,0,1993,NA,NA,322,133,189,56,31,25,0.18,0.16,0.17,5070,12,84,259
225548,HOWARD PAYNE UNIVERSITY,1,0,1995,NA,NA,325,170,155,82,28,54,0.31,0.18,0.25,5940,14,90,267
225548,HOWARD PAYNE UNIVERSITY,1,0,1996,NA,NA,335,151,184,83,27,56,0.37,0.15,0.25,6450,16,93,265
225548,HOWARD PAYNE UNIVERSITY,1,0,1997,NA,NA,323,112,211,66,32,34,0.3,0.15,0.2,7109,14,90,237
225548,HOWARD PAYNE UNIVERSITY,1,0,1998,NA,NA,315,143,172,66,25,41,0.28,0.15,0.21,8460,14,85,255
225548,HOWARD PAYNE UNIVERSITY,1,0,1999,NA,NA,286,137,149,10,3,7,0.05,0.02,0.03,8400,16,90,228
225548,HOWARD PAYNE UNIVERSITY,1,0,2000,NA,NA,355,175,180,82,28,54,0.3,0.16,0.23,8400,18,82,301
225548,HOWARD PAYNE UNIVERSITY,1,0,2001,NA,NA,319,152,167,80,34,46,0.3,0.2,0.25,9200,20,74,241
225548,HOWARD PAYNE UNIVERSITY,1,0,2002,NA,NA,325,157,168,78,24,54,0.34,0.14,0.24,9700,19,70,241
225548,HOWARD PAYNE UNIVERSITY,1,0,2003,NA,NA,293,136,157,76,27,49,0.36,0.17,0.26,10300,19,71,217
225548,HOWARD PAYNE UNIVERSITY,1,0,2004,NA,NA,285,126,159,62,29,33,0.26,0.18,0.22,11000,19,75,209
225548,Howard Payne University,1,0,2005,NA,NA,281,146,135,104,41,63,0.43,0.3,0.37,11500,20,72,206
225548,Howard Payne University,1,0,2006,NA,NA,318,130,188,109,46,63,0.48,0.24,0.34,13440,21,78,238
225548,Howard Payne University,1,0,2007,NA,NA,255,103,152,77,31,46,0.44,0.2,0.3,15000,18,78,159
225548,Howard Payne University,1,0,2008,NA,NA,304,128,176,107,48,59,0.46,0.27,0.35,16350,19,76,222
225548,Howard Payne University,1,0,2009,NA,NA,209,84,125,74,31,43,0.51,0.25,0.35,17600,19,77,126
225548,Howard Payne University,1,0,2010,NA,NA,318,149,169,88,32,56,0.37,0.19,0.28,18850,19,82,224
225627,INCARNATE WORD COLLEGE,1,0,1991,NA,NA,330,246,84,35,4,31,0.12,0.05,0.11,7200,21,100,97
225627,INCARNATE WORD COLLEGE,1,0,1992,NA,NA,310,224,86,33,4,29,0.12,0.05,0.11,7800,21,123,82
225627,INCARNATE WORD COLLEGE,1,0,1993,NA,NA,297,202,95,29,8,21,0.1,0.08,0.1,8250,23,136,81
225627,UNIVERSITY OF THE INCARNATE WORD,1,0,1995,NA,NA,370,259,111,50,11,39,0.15,0.1,0.14,9690,27,134,101
225627,UNIVERSITY OF THE INCARNATE WORD,1,0,1996,NA,NA,404,288,116,46,6,40,0.13,0.05,0.11,10150,31,124,106
225627,UNIVERSITY OF THE INCARNATE WORD,1,0,1997,NA,NA,341,233,108,47,10,37,0.15,0.09,0.14,10600,27,122,91
225627,UNIVERSITY OF THE INCARNATE WORD,1,0,1998,NA,NA,375,265,110,59,10,49,0.18,0.09,0.16,11200,29,129,101
225627,UNIVERSITY OF THE INCARNATE WORD,1,0,1999,NA,NA,380,253,127,51,9,42,0.16,0.07,0.13,11850,33,123,87
225627,UNIVERSITY OF THE INCARNATE WORD,1,0,2000,NA,NA,388,253,135,77,20,57,0.22,0.15,0.2,12470,36,122,102
225627,UNIVERSITY OF THE INCARNATE WORD,1,0,2001,NA,NA,416,285,131,66,10,56,0.19,0.08,0.16,13220,39,122,93
225627,UNIVERSITY OF THE INCARNATE WORD,1,0,2002,NA,NA,395,244,151,58,18,40,0.16,0.12,0.15,14000,45,130,105
225627,UNIVERSITY OF THE INCARNATE WORD,1,0,2003,NA,NA,396,280,116,70,18,52,0.18,0.16,0.18,14800,51,138,95
225627,UNIVERSITY OF THE INCARNATE WORD,1,0,2004,NA,NA,474,331,143,61,12,49,0.14,0.08,0.13,15600,48,148,107
225627,University of the Incarnate Word,1,0,2005,NA,NA,571,394,177,114,23,91,0.23,0.13,0.2,16500,51,160,131
225627,University of the Incarnate Word,1,0,2006,NA,NA,613,439,174,119,23,96,0.21,0.13,0.19,17400,56,175,129
225627,University of the Incarnate Word,1,0,2007,NA,NA,715,463,252,138,41,97,0.2,0.16,0.19,18400,63,183,146
225627,University of the Incarnate Word,1,0,2008,NA,NA,880,553,327,157,39,118,0.21,0.12,0.18,19400,73,200,193
225627,University of the Incarnate Word,1,0,2009,NA,NA,717,469,248,178,49,129,0.27,0.2,0.25,20400,84,219,156
225627,University of the Incarnate Word,1,0,2010,NA,NA,871,571,300,257,70,187,0.32,0.23,0.3,21000,89,245,169
226231,LETOURNEAU UNIVERSITY,1,0,1991,NA,NA,207,26,181,51,44,7,0.26,0.24,0.25,7350,11,49,181
226231,LETOURNEAU UNIVERSITY,1,0,1992,NA,NA,182,26,156,37,30,7,0.26,0.19,0.2,7940,16,50,157
226231,LETOURNEAU UNIVERSITY,1,0,1993,NA,NA,202,33,169,46,36,10,0.3,0.21,0.23,8460,16,50,180
226231,LETOURNEAU UNIVERSITY,1,0,1995,NA,NA,218,66,152,68,42,26,0.39,0.28,0.31,9430,21,55,195
226231,LETOURNEAU UNIVERSITY,1,0,1996,NA,NA,163,35,128,26,19,7,0.2,0.15,0.16,10220,23,56,146
226231,LETOURNEAU UNIVERSITY,1,0,1997,NA,NA,209,50,159,65,45,20,0.4,0.28,0.31,10724,20,52,182
226231,LETOURNEAU UNIVERSITY,1,0,1998,NA,NA,257,55,202,72,48,24,0.43,0.24,0.28,11264,21,58,236
226231,LETOURNEAU UNIVERSITY,1,0,1999,NA,NA,259,58,201,75,52,23,0.39,0.26,0.29,11570,26,59,229
226231,LETOURNEAU UNIVERSITY,1,0,2000,NA,NA,286,79,207,96,58,38,0.48,0.28,0.34,12090,27,59,261
226231,LETOURNEAU UNIVERSITY,1,0,2001,NA,NA,242,66,176,74,47,27,0.4,0.27,0.31,12670,27,59,211
226231,LETOURNEAU UNIVERSITY,1,0,2002,NA,NA,243,55,188,68,46,22,0.4,0.24,0.28,13240,31,62,214
226231,LETOURNEAU UNIVERSITY,1,0,2003,NA,NA,333,94,239,93,52,41,0.43,0.22,0.28,14010,35,66,294
226231,LETOURNEAU UNIVERSITY,1,0,2004,NA,NA,327,92,235,98,58,40,0.43,0.25,0.3,14850,37,70,272
226231,LeTourneau University,1,0,2005,NA,NA,317,74,243,95,66,29,0.39,0.27,0.3,15710,39,72,276
226231,LeTourneau University,1,0,2006,NA,NA,309,88,221,130,75,55,0.62,0.34,0.42,16720,43,72,271
226231,LeTourneau University,1,0,2007,NA,NA,322,97,225,108,71,37,0.38,0.32,0.34,17710,47,84,263
226231,LeTourneau University,1,0,2008,NA,NA,340,106,234,118,76,42,0.39,0.32,0.35,18940,51,85,283
226231,LeTourneau University,1,0,2009,NA,NA,341,109,232,123,83,40,0.36,0.36,0.36,20100,52,79,265
226231,LeTourneau University,1,0,2010,NA,NA,425,169,256,152,85,67,0.39,0.33,0.36,21510,49,87,244
226833,MIDWESTERN STATE UNIVERSITY,1,0,1991,NA,NA,708,332,376,14,8,6,0.01,0.02,0.02,1359,26,154,569
226833,MIDWESTERN STATE UNIVERSITY,1,0,1992,NA,NA,641,313,328,43,16,27,0.08,0.05,0.07,1474,28,155,509
226833,MIDWESTERN STATE UNIVERSITY,1,0,1993,NA,NA,553,284,269,49,23,26,0.09,0.09,0.09,1666,30,163,440
226833,MIDWESTERN STATE UNIVERSITY,1,0,1995,NA,NA,578,276,302,49,16,33,0.11,0.05,0.08,1870,33,178,458
226833,MIDWESTERN STATE UNIVERSITY,1,0,1996,NA,NA,602,312,290,52,17,35,0.11,0.06,0.09,1477,38,180,482
226833,MIDWESTERN STATE UNIVERSITY,1,0,1997,NA,NA,668,329,339,37,13,24,0.07,0.04,0.06,1498,42,188,505
226833,MIDWESTERN STATE UNIVERSITY,1,0,1998,NA,NA,685,350,335,74,26,48,0.13,0.08,0.11,1789,43,192,531
226833,MIDWESTERN STATE UNIVERSITY,1,0,1999,NA,NA,732,409,323,67,21,46,0.11,0.07,0.09,1140,46,197,550
226833,MIDWESTERN STATE UNIVERSITY,1,0,2000,NA,NA,696,355,341,64,33,31,0.08,0.1,0.09,1200,53,198,495
226833,MIDWESTERN STATE UNIVERSITY,1,0,2001,NA,NA,668,376,292,69,22,47,0.12,0.08,0.1,1260,52,199,480
226833,MIDWESTERN STATE UNIVERSITY,1,0,2002,NA,NA,624,327,297,66,23,43,0.13,0.08,0.11,1320,52,200,461
226833,MIDWESTERN STATE UNIVERSITY,1,0,2003,NA,NA,613,302,311,41,18,23,0.07,0.06,0.07,1380,56,200,438
226833,MIDWESTERN STATE UNIVERSITY,1,0,2004,NA,NA,611,301,310,35,13,22,0.07,0.04,0.06,1152,55,215,391
226833,Midwestern State University,1,0,2005,NA,NA,818,447,371,100,27,73,0.16,0.07,0.12,1200,58,203,544
226833,Midwestern State University,1,0,2006,NA,NA,657,355,302,108,33,75,0.21,0.11,0.16,1200,65,216,481
226833,Midwestern State University,1,0,2007,NA,NA,735,384,351,118,43,75,0.19,0.12,0.16,1200,69,213,542
226833,Midwestern State University,1,0,2008,NA,NA,706,405,301,119,44,75,0.18,0.15,0.17,1200,73,212,490
226833,Midwestern State University,1,0,2009,NA,NA,701,386,315,139,40,99,0.25,0.13,0.2,1200,76,225,487
226833,Midwestern State University,1,0,2010,NA,NA,742,380,362,141,39,102,0.26,0.11,0.19,1200,86,226,511
227216,UNIVERSITY OF NORTH TEXAS,1,0,1991,NA,NA,2085,1169,916,210,62,148,0.12,0.07,0.1,1046,172,782,1655
227216,UNIVERSITY OF NORTH TEXAS,1,0,1992,NA,NA,1794,1014,780,191,41,150,0.14,0.05,0.11,1196,183,762,1382
227216,UNIVERSITY OF NORTH TEXAS,1,0,1993,NA,NA,1872,1045,827,211,63,148,0.14,0.08,0.11,1273,197,751,1457
227216,UNIVERSITY OF NORTH TEXAS,1,0,1995,NA,NA,2134,1180,954,201,50,151,0.12,0.05,0.09,1439,203,733,1597
227216,UNIVERSITY OF NORTH TEXAS,1,0,1996,NA,NA,2268,1304,964,256,70,186,0.14,0.07,0.11,1705,211,735,1630
227216,UNIVERSITY OF NORTH TEXAS,1,0,1997,NA,NA,2292,1310,982,303,83,220,0.16,0.08,0.13,1776,217,725,1646
227216,UNIVERSITY OF NORTH TEXAS,1,0,1998,NA,NA,2449,1400,1049,363,105,258,0.18,0.1,0.15,2075,232,729,1772
227216,UNIVERSITY OF NORTH TEXAS,1,0,1999,NA,NA,2687,1550,1137,410,111,299,0.19,0.1,0.15,1656,245,729,1903
227216,UNIVERSITY OF NORTH TEXAS,1,0,2000,NA,NA,2841,1664,1177,515,142,373,0.22,0.12,0.18,1824,266,752,2003
227216,UNIVERSITY OF NORTH TEXAS,1,0,2001,NA,NA,2803,1665,1138,466,146,320,0.19,0.13,0.17,2016,307,775,2005
227216,UNIVERSITY OF NORTH TEXAS,1,0,2002,NA,NA,2912,1683,1229,523,147,376,0.22,0.12,0.18,2288,324,808,2044
227216,UNIVERSITY OF NORTH TEXAS,1,0,2003,NA,NA,3320,1945,1375,632,194,438,0.22,0.14,0.19,2392,328,786,2310
227216,UNIVERSITY OF NORTH TEXAS,1,0,2004,NA,NA,3216,1872,1344,611,180,431,0.23,0.13,0.19,3444,339,824,2234
227216,University of North Texas,1,0,2005,NA,NA,3557,2008,1549,760,214,546,0.27,0.14,0.21,3144,364,838,2363
227216,University of North Texas,1,0,2006,NA,NA,3599,2039,1560,784,252,532,0.26,0.16,0.22,3372,380,836,2385
227216,University of North Texas,1,0,2007,NA,NA,3495,1996,1499,862,254,608,0.3,0.17,0.25,4035,389,871,2236
227216,University of North Texas,1,0,2008,NA,NA,3442,1928,1514,891,271,620,0.32,0.18,0.26,4528,431,898,2187
227216,University of North Texas,1,0,2009,NA,NA,3255,1832,1423,881,271,610,0.33,0.19,0.27,5060,476,960,1888
227216,University of North Texas,1,0,2010,NA,NA,3534,1908,1626,1009,345,664,0.34,0.21,0.29,5363,537,1004,1857
227331,OUR LADY OF THE LAKE UNIVERSITY SAN ANTONIO,1,0,1991,NA,NA,361,278,83,38,6,32,0.11,0.07,0.11,6472,19,92,34
227331,OUR LADY OF THE LAKE UNIVERSITY SAN ANTONIO,1,0,1992,NA,NA,315,241,74,40,8,32,0.13,0.11,0.13,7564,21,95,39
227331,OUR LADY OF THE LAKE UNIVERSITY-SAN ANTONIO,1,0,1993,NA,NA,291,224,67,29,0,29,0.12,0,0.1,8160,24,101,31
227331,OUR LADY OF THE LAKE UNIVERSITY-SAN ANTONIO,1,0,1995,NA,NA,258,189,69,34,8,26,0.13,0.12,0.13,9134,30,102,24
227331,OUR LADY OF THE LAKE UNIVERSITY-SAN ANTONIO,1,0,1996,NA,NA,355,257,98,66,12,54,0.21,0.12,0.19,9674,30,109,47
227331,OUR LADY OF THE LAKE UNIVERSITY-SAN ANTONIO,1,0,1997,NA,NA,372,293,79,59,10,49,0.16,0.13,0.16,10366,27,121,58
227331,OUR LADY OF THE LAKE UNIVERSITY-SAN ANTONIO,1,0,1998,NA,NA,310,251,59,50,2,48,0.19,0.03,0.16,10872,30,124,49
227331,OUR LADY OF THE LAKE UNIVERSITY-SAN ANTONIO,1,0,1999,NA,NA,308,241,67,44,10,34,0.14,0.15,0.14,11150,32,128,36
227331,OUR LADY OF THE LAKE UNIVERSITY-SAN ANTONIO,1,0,2000,NA,NA,267,205,62,42,7,35,0.17,0.11,0.16,11708,34,128,24
227331,OUR LADY OF THE LAKE UNIVERSITY-SAN ANTONIO,1,0,2001,NA,NA,401,323,78,49,7,42,0.13,0.09,0.12,12528,37,128,37
227331,OUR LADY OF THE LAKE UNIVERSITY-SAN ANTONIO,1,0,2002,NA,NA,331,241,90,55,11,44,0.18,0.12,0.17,13404,40,129,27
227331,OUR LADY OF THE LAKE UNIVERSITY-SAN ANTONIO,1,0,2003,NA,NA,322,238,84,60,10,50,0.21,0.12,0.19,14650,42,83,53
227331,OUR LADY OF THE LAKE UNIVERSITY-SAN ANTONIO,1,0,2004,NA,NA,216,171,45,30,3,27,0.15,0.07,0.14,15594,44,125,28
227331,Our Lady of the Lake University-San Antonio,1,0,2005,NA,NA,269,204,65,1,1,0,0,0.02,0,17048,45,118,28
227331,Our Lady of the Lake University-San Antonio,1,0,2006,NA,NA,262,195,67,27,6,21,0.1,0.09,0.1,17900,44,97,24
227331,Our Lady of the Lake University-San Antonio,1,0,2007,NA,NA,283,189,94,51,13,38,0.2,0.14,0.18,18616,44,112,25
227331,Our Lady of the Lake University-San Antonio,1,0,2008,NA,NA,306,213,93,67,14,53,0.24,0.15,0.22,19732,42,111,30
227331,Our Lady of the Lake University-San Antonio,1,0,2009,NA,NA,246,170,76,54,14,40,0.23,0.18,0.22,20324,42,108,21
227331,Our Lady of the Lake University-San Antonio,1,0,2010,NA,NA,299,219,80,77,18,59,0.26,0.22,0.26,21400,43,112,46
227526,PRAIRIE VIEW A & M UNIVERSITY,1,0,1991,NA,NA,1116,534,582,91,24,67,0.12,0.04,0.08,1148,57,234,13
227526,PRAIRIE VIEW A & M UNIVERSITY,1,0,1992,NA,NA,1194,579,615,261,97,164,0.28,0.16,0.22,1316,65,245,24
227526,PRAIRIE VIEW A & M UNIVERSITY,1,0,1993,NA,NA,1208,610,598,110,27,83,0.13,0.05,0.09,1537,71,232,32
227526,PRAIRIE VIEW A & M UNIVERSITY,1,0,1995,NA,NA,1114,536,578,105,29,76,0.14,0.05,0.09,1926,72,235,20
227526,PRAIRIE VIEW A & M UNIVERSITY,1,0,1996,NA,NA,1166,568,598,133,48,85,0.14,0.08,0.11,2146,80,234,21
227526,PRAIRIE VIEW A & M UNIVERSITY,1,0,1997,NA,NA,1183,670,513,127,34,93,0.13,0.07,0.11,2436,80,235,10
227526,PRAIRIE VIEW A & M UNIVERSITY,1,0,1998,NA,NA,1197,626,571,132,42,90,0.14,0.07,0.11,2496,82,236,11
227526,PRAIRIE VIEW A & M UNIVERSITY,1,0,1999,NA,NA,967,504,463,113,33,80,0.15,0.07,0.12,1140,90,289,5
227526,PRAIRIE VIEW A & M UNIVERSITY,1,0,2000,NA,NA,1230,657,573,163,46,117,0.17,0.08,0.13,1200,97,273,21
227526,PRAIRIE VIEW A & M UNIVERSITY,1,0,2001,NA,NA,1380,771,609,182,62,120,0.15,0.1,0.13,1260,102,258,17
227526,PRAIRIE VIEW A & M UNIVERSITY,1,0,2002,NA,NA,1431,769,662,222,74,148,0.19,0.11,0.16,1320,99,280,22
227526,PRAIRIE VIEW A & M UNIVERSITY,1,0,2003,NA,NA,1553,820,733,175,71,104,0.12,0.1,0.11,1380,114,343,17
227526,PRAIRIE VIEW A & M UNIVERSITY,1,0,2004,NA,NA,1573,823,750,156,56,100,0.12,0.07,0.1,1440,121,334,17
227526,Prairie View A & M University,1,0,2005,NA,NA,1155,668,487,126,39,87,0.13,0.08,0.11,1500,134,327,18
227526,Prairie View A & M University,1,0,2006,NA,NA,1231,689,542,121,28,93,0.13,0.05,0.1,3765,151,341,11
227526,Prairie View A & M University,1,0,2007,NA,NA,1391,784,607,155,36,119,0.15,0.06,0.11,4350,153,333,18
227526,Prairie View A & M University,1,0,2008,NA,NA,1290,761,529,355,112,243,0.31,0.21,0.28,4590,172,340,35
227526,Prairie View A & M University,1,0,2009,NA,NA,1638,957,681,180,42,138,0.14,0.06,0.11,4884,180,341,21
227526,Prairie View A & M University,1,0,2010,NA,NA,1731,1046,685,154,43,111,0.1,0.06,0.09,5077,186,347,24
227757,RICE UNIVERSITY,1,0,1991,NA,NA,625,257,368,437,239,198,0.77,0.65,0.7,7700,159,421,416
227757,RICE UNIVERSITY,1,0,1992,NA,NA,598,266,332,437,221,216,0.81,0.67,0.73,8500,169,416,416
227757,RICE UNIVERSITY,1,0,1993,NA,NA,639,281,358,440,228,212,0.75,0.64,0.69,9644,175,422,421
227757,RICE UNIVERSITY,1,0,1995,NA,NA,688,338,350,472,213,259,0.76,0.61,0.69,11122,196,449,409
227757,RICE UNIVERSITY,1,0,1996,NA,NA,668,314,354,499,240,259,0.8200000000000001,0.68,0.75,12031,206,435,354
227757,RICE UNIVERSITY,1,0,1997,NA,NA,703,334,369,516,248,268,0.8,0.67,0.73,13094,197,436,451
227757,RICE UNIVERSITY,1,0,1998,NA,NA,642,320,322,489,228,261,0.81,0.71,0.76,14131,206,455,403
227757,RICE UNIVERSITY,1,0,1999,NA,NA,670,325,345,512,251,261,0.8,0.73,0.76,15350,221,463,393
227757,RICE UNIVERSITY,1,0,2000,NA,NA,628,290,338,498,249,249,0.85,0.74,0.79,15438,240,467,423
227757,RICE UNIVERSITY,1,0,2001,NA,NA,657,326,331,509,247,262,0.8,0.75,0.77,16300,259,471,343
227757,RICE UNIVERSITY,1,0,2002,NA,NA,700,318,382,570,301,269,0.84,0.79,0.81,16925,287,503,388
227757,RICE UNIVERSITY,1,0,2003,NA,NA,716,364,352,591,279,312,0.85,0.79,0.83,17800,315,530,393
227757,RICE UNIVERSITY,1,0,2004,NA,NA,725,380,345,574,259,315,0.8200000000000001,0.75,0.79,18863,334,545,416
227757,Rice University,1,0,2005,NA,NA,722,337,385,571,279,292,0.86,0.72,0.79,21203,350,567,386
227757,Rice University,1,0,2006,NA,NA,713,357,356,597,282,315,0.88,0.79,0.84,23786,371,567,338
227757,Rice University,1,0,2007,NA,NA,742,346,396,585,288,297,0.85,0.73,0.79,26633,396,583,340
227757,Rice University,1,0,2008,NA,NA,777,386,391,636,307,329,0.85,0.79,0.82,29188,424,598,339
227757,Rice University,1,0,2009,NA,NA,887,427,460,710,342,368,0.86,0.74,0.8,31303,467,619,355
227757,Rice University,1,0,2010,NA,NA,944,453,491,783,376,407,0.89,0.77,0.83,33120,498,627,416
227845,SAINT EDWARD'S UNIVERSITY,1,0,1991,NA,NA,347,198,149,67,22,45,0.22,0.15,0.19,7764,24,81,168
227845,SAINT EDWARD'S UNIVERSITY,1,0,1992,NA,NA,337,196,141,57,27,30,0.15,0.19,0.17,8376,26,80,169
227845,SAINT EDWARDS UNIVERSITY,1,0,1993,NA,NA,370,235,135,98,32,66,0.28,0.24,0.26,8902,28,83,194
227845,SAINT EDWARDS UNIVERSITY,1,0,1995,NA,NA,387,230,157,119,37,82,0.35000000000000003,0.24,0.31,9950,31,91,199
227845,SAINT EDWARDS UNIVERSITY,1,0,1996,NA,NA,373,239,134,107,35,72,0.3,0.26,0.29,10400,32,93,197
227845,SAINT EDWARDS UNIVERSITY,1,0,1997,NA,NA,359,216,143,98,38,60,0.27,0.27,0.27,10730,26,92,197
227845,SAINT EDWARDS UNIVERSITY,1,0,1998,NA,NA,367,212,155,95,34,61,0.28,0.22,0.26,11160,28,91,192
227845,SAINT EDWARDSS UNIVERSITY,1,0,1999,NA,NA,357,184,173,101,35,66,0.35000000000000003,0.2,0.28,11438,30,99,182
227845,SAINT EDWARD'S UNIVERSITY,1,0,2000,NA,NA,397,207,190,118,42,76,0.36,0.22,0.3,11896,34,108,223
227845,SAINT EDWARD'S UNIVERSITY,1,0,2001,NA,NA,413,254,159,131,37,94,0.37,0.23,0.32,12728,40,118,220
227845,SAINT EDWARD'S UNIVERSITY,1,0,2002,NA,NA,445,255,190,164,60,104,0.4,0.32,0.37,13620,48,125,256
227845,SAINT EDWARD'S UNIVERSITY,1,0,2003,NA,NA,544,327,217,239,78,161,0.49,0.36,0.44,14710,54,139,296
227845,SAINT EDWARD'S UNIVERSITY,1,0,2004,NA,NA,600,371,229,291,97,194,0.52,0.42,0.48,15960,58,141,334
227845,Saint Edward's University,1,0,2005,NA,NA,646,401,245,333,109,224,0.55,0.44,0.52,17320,64,155,341
227845,Saint Edward's University,1,0,2006,NA,NA,698,423,275,372,144,228,0.53,0.52,0.53,18800,71,169,387
227845,Saint Edward's University,1,0,2007,NA,NA,725,437,288,372,127,245,0.56,0.44,0.51,20400,77,182,413
227845,Saint Edward's University,1,0,2008,NA,NA,741,480,261,397,121,276,0.5700000000000001,0.46,0.54,22150,83,188,406
227845,Saint Edward's University,1,0,2009,NA,NA,755,470,285,383,123,260,0.55,0.43,0.51,24040,88,187,400
227845,Saint Edward's University,1,0,2010,NA,NA,770,505,265,403,122,281,0.55,0.46,0.52,26084,93,198,361
227863,UNIVERSITY OF SAINT THOMAS,1,0,1991,NA,NA,170,114,56,64,22,42,0.36,0.39,0.38,6830,11,86,79
227863,UNIVERSITY OF SAINT THOMAS,1,0,1992,NA,NA,173,123,50,2,0,2,0.01,0,0.01,7442,14,88,79
227863,UNIVERSITY OF SAINT THOMAS,1,0,1993,NA,NA,192,129,63,53,13,40,0.31,0.21,0.28,8042,16,91,90
227863,UNIVERSITY OF SAINT THOMAS,1,0,1995,NA,NA,232,145,87,58,17,41,0.28,0.2,0.25,9423,18,97,102
227863,UNIVERSITY OF SAINT THOMAS,1,0,1996,NA,NA,222,136,86,55,19,36,0.26,0.22,0.25,9975,20,114,102
227863,UNIVERSITY OF SAINT THOMAS,1,0,1997,NA,NA,235,155,80,58,19,39,0.25,0.24,0.25,10577,19,98,105
227863,UNIVERSITY OF SAINT THOMAS,1,0,1998,NA,NA,231,153,78,65,12,53,0.34,0.15,0.28,11210,21,101,93
227863,UNIVERSITY OF ST THOMAS,1,0,1999,NA,NA,215,128,87,50,16,34,0.26,0.18,0.23,11700,23,102,102
227863,UNIVERSITY OF ST THOMAS,1,0,2000,NA,NA,303,207,96,72,19,53,0.25,0.2,0.24,12300,25,107,98
227863,UNIVERSITY OF ST THOMAS,1,0,2001,NA,NA,272,166,106,68,23,45,0.27,0.22,0.25,13050,28,112,102
227863,UNIVERSITY OF ST THOMAS,1,0,2002,NA,NA,276,174,102,65,15,50,0.28,0.15,0.24,13800,32,117,98
227863,UNIVERSITY OF ST THOMAS,1,0,2003,NA,NA,292,172,120,87,33,54,0.31,0.28,0.3,15000,32,114,116
227863,UNIVERSITY OF ST THOMAS,1,0,2004,NA,NA,297,189,108,80,24,56,0.29,0.22,0.27,16200,35,117,116
227863,University of St Thomas,1,0,2005,NA,NA,289,185,104,75,27,48,0.25,0.26,0.26,16950,37,121,108
227863,University of St Thomas,1,0,2006,NA,NA,291,187,104,93,26,67,0.35000000000000003,0.25,0.32,17700,39,129,103
227863,University of St Thomas,1,0,2007,NA,NA,288,179,109,77,25,52,0.29,0.23,0.27,18900,43,131,98
227863,University of St Thomas,1,0,2008,NA,NA,293,187,106,101,30,71,0.37,0.28,0.34,20190,46,132,86
227863,University of St Thomas,1,0,2009,NA,NA,284,181,103,106,34,72,0.39,0.33,0.37,21510,49,125,104
227863,University of St Thomas,1,0,2010,NA,NA,191,127,64,63,14,49,0.38,0.22,0.33,23160,48,135,58
228042,SCHREINER COLLEGE,1,0,1991,NA,NA,156,79,77,27,15,12,0.15,0.19,0.17,7385,8,35,114
228042,SCHREINER COLLEGE,1,0,1992,NA,NA,140,75,65,12,3,9,0.12,0.05,0.09,7975,8,35,99
228042,SCHREINER COLLEGE,1,0,1993,NA,NA,134,77,57,26,10,16,0.2,0.18,0.19,8610,9,40,98
228042,SCHREINER COLLEGE,1,0,1995,NA,NA,221,107,114,35,15,20,0.18,0.13,0.16,9335,10,33,148
228042,SCHREINER COLLEGE,1,0,1996,NA,NA,180,112,68,34,10,24,0.21,0.15,0.19,9735,11,39,148
228042,SCHREINER COLLEGE,1,0,1997,NA,NA,194,116,78,40,16,24,0.2,0.21,0.21,9900,9,39,150
228042,SCHREINER COLLEGE,1,0,1998,NA,NA,198,118,80,39,17,22,0.18,0.21,0.2,10490,9,43,157
228042,SCHREINER COLLEGE,1,0,1999,NA,NA,225,148,77,44,7,37,0.25,0.09,0.2,10990,11,41,174
228042,SCHREINER COLLEGE,1,0,2000,NA,NA,207,124,83,40,16,24,0.19,0.19,0.19,11540,12,43,171
228042,SCHREINER UNIVERSITY,1,0,2001,NA,NA,180,110,70,46,12,34,0.3,0.17,0.26,12118,17,45,146
228042,SCHREINER UNIVERSITY,1,0,2002,NA,NA,165,80,85,45,18,27,0.33,0.21,0.27,12118,16,49,119
228042,SCHREINER UNIVERSITY,1,0,2003,NA,NA,168,88,80,40,14,26,0.29,0.17,0.24,13240,16,47,132
228042,SCHREINER UNIVERSITY,1,0,2004,NA,NA,204,122,82,53,20,33,0.27,0.24,0.26,14040,15,53,154
228042,Schreiner University,1,0,2005,NA,NA,167,92,75,50,19,31,0.33,0.25,0.3,14742,16,51,105
228042,Schreiner University,1,0,2006,NA,NA,243,128,115,57,20,37,0.28,0.17,0.23,15479,17,54,173
228042,Schreiner University,1,0,2007,NA,NA,262,135,127,92,36,56,0.41000000000000003,0.28,0.35,16408,17,56,179
228042,Schreiner University,1,0,2008,NA,NA,266,145,121,84,34,50,0.34,0.28,0.32,17392,18,59,183
228042,Schreiner University,1,0,2009,NA,NA,289,155,134,98,44,54,0.34,0.33,0.34,18132,19,60,190
228042,Schreiner University,1,0,2010,NA,NA,253,150,103,106,40,66,0.44,0.39,0.42,18948,21,59,163
228149,SAINT MARY'S UNIVERSITY,1,0,1991,NA,NA,429,260,169,131,43,88,0.33,0.25,0.31,7170,38,159,103
228149,SAINT MARY'S UNIVERSITY,1,0,1992,NA,NA,491,285,206,139,43,96,0.33,0.21,0.28,8000,42,149,116
228149,SAINT MARYS UNIVERSITY,1,0,1993,NA,NA,402,231,171,125,34,91,0.39,0.2,0.31,8276,45,169,114
228149,SAINT MARYS UNIVERSITY,1,0,1995,NA,NA,452,254,198,123,34,89,0.35000000000000003,0.17,0.27,9527,53,177,113
228149,ST MARYS UNIVERSITY,1,0,1996,NA,NA,507,312,195,177,56,121,0.38,0.29,0.35,9934,50,180,122
228149,ST MARYS UNIVERSITY,1,0,1997,NA,NA,507,311,196,170,50,120,0.38,0.26,0.34,10668,48,182,105
228149,ST MARYS UNIVERSITY,1,0,1998,NA,NA,499,313,186,147,49,98,0.31,0.26,0.29,11280,52,178,114
228149,ST MARYS UNIVERSITY,1,0,1999,NA,NA,485,277,208,165,54,111,0.4,0.26,0.34,11500,50,191,101
228149,ST MARYS UNIVERSITY,1,0,2000,NA,NA,656,399,257,201,60,141,0.35000000000000003,0.23,0.31,12160,53,187,143
228149,ST MARYS UNIVERSITY,1,0,2001,NA,NA,534,299,235,181,72,109,0.36,0.31,0.34,12980,57,183,92
228149,ST MARYS UNIVERSITY,1,0,2002,NA,NA,667,397,270,214,63,151,0.38,0.23,0.32,14727,61,185,136
228149,ST MARYS UNIVERSITY,1,0,2003,NA,NA,470,292,178,147,41,106,0.36,0.23,0.31,15992,67,189,107
228149,ST MARYS UNIVERSITY,1,0,2004,NA,NA,463,277,186,159,51,108,0.38,0.27,0.34,17256,69,190,93
228149,St Marys University,1,0,2005,NA,NA,494,314,180,147,38,109,0.34,0.21,0.3,18274,71,184,73
228149,St Marys University,1,0,2006,NA,NA,548,347,201,187,39,148,0.42,0.19,0.34,19334,71,183,99
228149,St Marys University,1,0,2007,NA,NA,565,334,231,187,54,133,0.39,0.23,0.33,20300,73,187,110
228149,St Marys University,1,0,2008,NA,NA,535,335,200,237,63,174,0.51,0.32,0.44,20600,78,192,87
228149,St Marys University,1,0,2009,NA,NA,530,335,195,270,76,194,0.5700000000000001,0.39,0.51,21320,80,197,99
228149,St Marys University,1,0,2010,NA,NA,585,358,227,249,85,164,0.45,0.37,0.43,21980,84,196,84
228246,SOUTHERN METHODIST UNIVERSITY,1,0,1991,NA,NA,1229,652,577,671,289,382,0.58,0.5,0.55,11768,150,490,1004
228246,SOUTHERN METHODIST UNIVERSITY,1,0,1992,NA,NA,1221,634,587,663,274,389,0.61,0.47,0.54,12688,159,484,961
228246,SOUTHERN METHODIST UNIVERSITY,1,0,1993,NA,NA,1161,630,531,657,265,392,0.62,0.5,0.57,13580,165,483,861
228246,SOUTHERN METHODIST UNIVERSITY,1,0,1995,NA,NA,1228,662,566,743,287,456,0.68,0.51,0.61,15228,180,485,963
228246,SOUTHERN METHODIST UNIVERSITY,1,0,1996,NA,NA,1217,663,554,687,270,417,0.62,0.49,0.56,15990,186,493,936
228246,SOUTHERN METHODIST UNIVERSITY,1,0,1997,NA,NA,1247,686,561,702,282,420,0.61,0.5,0.56,16790,181,502,977
228246,SOUTHERN METHODIST UNIVERSITY,1,0,1998,NA,NA,1306,720,586,689,249,440,0.61,0.42,0.53,17628,200,500,975
228246,SOUTHERN METHODIST UNIVERSITY,1,0,1999,NA,NA,1331,688,643,656,262,394,0.5700000000000001,0.41,0.49,16422,225,519,1002
228246,SOUTHERN METHODIST UNIVERSITY,1,0,2000,NA,NA,1276,713,563,736,280,456,0.63,0.5,0.58,17406,248,519,981
228246,SOUTHERN METHODIST UNIVERSITY,1,0,2001,NA,NA,1353,713,640,751,297,454,0.63,0.46,0.56,18450,253,520,1073
228246,SOUTHERN METHODIST UNIVERSITY,1,0,2002,NA,NA,1380,764,616,811,315,496,0.64,0.51,0.59,19466,254,535,1080
228246,SOUTHERN METHODIST UNIVERSITY,1,0,2003,NA,NA,1383,772,611,853,324,529,0.68,0.53,0.62,20926,265,563,1049
228246,SOUTHERN METHODIST UNIVERSITY,1,0,2004,NA,NA,1313,717,596,789,310,479,0.66,0.52,0.6,22496,281,575,1015
228246,Southern Methodist University,1,0,2005,NA,NA,1401,754,647,846,345,501,0.66,0.53,0.6,23846,299,603,1120
228246,Southern Methodist University,1,0,2006,NA,NA,1369,753,616,937,377,560,0.74,0.61,0.68,25400,315,609,1069
228246,Southern Methodist University,1,0,2007,NA,NA,1306,697,609,870,359,511,0.73,0.59,0.67,27400,346,633,1042
228246,Southern Methodist University,1,0,2008,NA,NA,1397,751,646,941,404,537,0.71,0.63,0.67,29430,367,656,1050
228246,Southern Methodist University,1,0,2009,NA,NA,1325,702,623,886,374,512,0.72,0.6,0.67,31200,406,660,958
228246,Southern Methodist University,1,0,2010,NA,NA,1476,786,690,1008,429,579,0.73,0.62,0.68,33040,394,668,1003
228343,SOUTHWESTERN UNIVERSITY,1,0,1991,NA,NA,324,173,151,191,89,102,0.58,0.59,0.59,9400,22,81,269
228343,SOUTHWESTERN UNIVERSITY,1,0,1992,NA,NA,317,176,141,175,62,113,0.64,0.44,0.55,10300,23,81,249
228343,SOUTHWESTERN UNIVERSITY,1,0,1993,NA,NA,351,207,144,218,79,139,0.67,0.55,0.62,11000,24,87,275
228343,SOUTHWESTERN UNIVERSITY,1,0,1995,NA,NA,326,188,138,188,69,119,0.63,0.5,0.58,12700,27,85,257
228343,SOUTHWESTERN UNIVERSITY,1,0,1996,NA,NA,310,198,112,179,60,119,0.6,0.54,0.58,13400,28,92,245
228343,SOUTHWESTERN UNIVERSITY,1,0,1997,NA,NA,332,177,155,201,85,116,0.65,0.55,0.61,14000,29,91,278
228343,SOUTHWESTERN UNIVERSITY,1,0,1998,NA,NA,378,218,160,227,74,153,0.7000000000000001,0.46,0.6,14600,32,95,331
228343,SOUTHWESTERN UNIVERSITY,1,0,1999,NA,NA,354,210,144,236,83,153,0.72,0.58,0.67,15000,35,97,288
228343,SOUTHWESTERN UNIVERSITY,1,0,2000,NA,NA,355,195,160,230,91,139,0.71,0.57,0.65,15750,39,103,270
228343,SOUTHWESTERN UNIVERSITY,1,0,2001,NA,NA,327,174,153,196,77,119,0.68,0.5,0.6,16650,41,110,260
228343,SOUTHWESTERN UNIVERSITY,1,0,2002,NA,NA,342,217,125,227,76,151,0.6900000000000001,0.61,0.66,17570,44,115,244
228343,SOUTHWESTERN UNIVERSITY,1,0,2003,NA,NA,343,196,147,234,80,154,0.78,0.54,0.68,18870,44,114,261
228343,SOUTHWESTERN UNIVERSITY,1,0,2004,NA,NA,366,221,145,228,68,160,0.72,0.47,0.62,20220,44,121,283
228343,Southwestern University,1,0,2005,NA,NA,327,192,135,223,87,136,0.7000000000000001,0.64,0.68,21900,48,118,262
228343,Southwestern University,1,0,2006,NA,NA,345,221,124,231,74,157,0.71,0.6,0.67,23650,51,120,267
228343,Southwestern University,1,0,2007,NA,NA,371,232,139,242,84,158,0.68,0.6,0.65,25740,52,122,286
228343,Southwestern University,1,0,2008,NA,NA,349,216,133,227,78,149,0.68,0.59,0.65,27940,53,121,252
228343,Southwestern University,1,0,2009,NA,NA,375,231,144,257,88,169,0.73,0.61,0.69,30220,55,125,284
228343,Southwestern University,1,0,2010,NA,NA,383,224,159,252,98,154,0.68,0.62,0.66,31630,58,124,268
228431,STEPHEN F AUSTIN STATE UNIVERSITY,1,0,1991,NA,NA,2047,1234,813,353,74,279,0.22,0.09,0.17,1042,81,403,1841
228431,STEPHEN F AUSTIN STATE UNIVERSITY,1,0,1992,NA,NA,2183,1255,928,332,95,237,0.18,0.1,0.15,1338,85,408,1923
228431,STEPHEN F AUSTIN STATE UNIVERSITY,1,0,1993,NA,NA,2247,1255,992,308,81,227,0.18,0.08,0.14,1515,92,391,1946
228431,STEPHEN F AUSTIN STATE UNIVERSITY,1,0,1995,NA,NA,1714,986,728,275,69,206,0.2,0.09,0.16,1907,98,378,1481
228431,STEPHEN F AUSTIN STATE UNIVERSITY,1,0,1996,NA,NA,2007,1188,819,332,71,261,0.21,0.09,0.17,2127,99,383,1632
228431,STEPHEN F AUSTIN STATE UNIVERSITY,1,0,1997,NA,NA,2360,1422,938,358,71,287,0.2,0.08,0.15,2247,103,402,1854
228431,STEPHEN F AUSTIN STATE UNIVERSITY,1,0,1998,NA,NA,2348,1432,916,388,69,319,0.22,0.08,0.17,2408,109,406,1830
228431,STEPHEN F AUSTIN STATE UNIVERSITY,1,0,1999,NA,NA,2255,1353,902,339,92,247,0.18,0.1,0.15,1140,119,412,1719
228431,STEPHEN F AUSTIN STATE UNIVERSITY,1,0,2000,NA,NA,2210,1371,839,370,88,282,0.2,0.1,0.17,960,121,411,1624
228431,STEPHEN F AUSTIN STATE UNIVERSITY,1,0,2001,NA,NA,2191,1370,821,360,90,270,0.19,0.11,0.16,1728,124,411,1521
228431,STEPHEN F AUSTIN STATE UNIVERSITY,1,0,2002,NA,NA,2006,1229,777,314,83,231,0.18,0.11,0.16,1848,128,442,1452
228431,STEPHEN F AUSTIN STATE UNIVERSITY,1,0,2003,NA,NA,1839,1148,691,348,88,260,0.22,0.13,0.19,2088,134,430,1322
228431,STEPHEN F AUSTIN STATE UNIVERSITY,1,0,2004,NA,NA,1736,1091,645,381,95,286,0.26,0.15,0.22,2688,132,417,1257
228431,Stephen F Austin State University,1,0,2005,NA,NA,1967,1199,768,441,125,316,0.26,0.16,0.22,3024,132,431,1343
228431,Stephen F Austin State University,1,0,2006,NA,NA,2305,1420,885,538,132,406,0.28,0.15,0.23,3240,147,432,1515
228431,Stephen F Austin State University,1,0,2007,NA,NA,2268,1375,893,521,156,365,0.26,0.17,0.23,3528,165,429,1421
228431,Stephen F Austin State University,1,0,2008,NA,NA,2480,1545,935,590,131,459,0.29,0.14,0.24,3744,177,432,1416
228431,Stephen F Austin State University,1,0,2009,NA,NA,2553,1613,940,576,135,441,0.27,0.14,0.23,3864,186,451,1440
228431,Stephen F Austin State University,1,0,2010,NA,NA,2280,1473,807,556,128,428,0.29,0.16,0.24,4076,198,447,1192
228459,SOUTHWEST TEXAS STATE UNIVERSITY,1,0,1991,NA,NA,2916,1634,1282,201,61,140,0.08,0.05,0.07,1130,130,625,2010
228459,SOUTHWEST TEXAS STATE UNIVERSITY,1,0,1992,NA,NA,2310,1372,938,229,59,170,0.12,0.06,0.1,1406,141,608,1690
228459,SOUTHWEST TEXAS STATE UNIVERSITY,1,0,1993,NA,NA,2281,1358,923,248,62,186,0.13,0.07,0.11,1578,151,641,1647
228459,SOUTHWEST TEXAS STATE UNIVERSITY,1,0,1995,NA,NA,2426,1461,965,309,80,229,0.15,0.08,0.13,1588,160,625,1802
228459,SOUTHWEST TEXAS STATE UNIVERSITY,1,0,1996,NA,NA,2396,1472,924,408,88,320,0.21,0.1,0.17,2022,164,625,1753
228459,SOUTHWEST TEXAS STATE UNIVERSITY,1,0,1997,NA,NA,2331,1399,932,413,107,306,0.21,0.11,0.18,2214,172,607,1737
228459,SOUTHWEST TEXAS STATE UNIVERSITY,1,0,1998,NA,NA,2592,1546,1046,458,127,331,0.21,0.12,0.18,2388,184,616,1923
228459,SOUTHWEST TEXAS STATE UNIVERSITY,1,0,1999,NA,NA,2447,1479,968,504,130,374,0.25,0.13,0.21,1140,196,635,1806
228459,SOUTHWEST TEXAS STATE UNIVERSITY,1,0,2000,NA,NA,2531,1553,978,522,122,400,0.25,0.12,0.21,1200,215,661,1873
228459,SOUTHWEST TEXAS STATE UNIVERSITY,1,0,2001,NA,NA,2469,1508,961,553,134,419,0.27,0.14,0.22,1260,237,688,1872
228459,SOUTHWEST TEXAS STATE UNIVERSITY,1,0,2002,NA,NA,2674,1665,1009,587,140,447,0.26,0.14,0.22,2640,243,693,1997
228459,TEXAS STATE UNIVERSITY-SAN MARCOS,1,0,2003,NA,NA,2818,1681,1137,667,195,472,0.28,0.17,0.24,2208,279,707,2104
228459,TEXAS STATE UNIVERSITY-SAN MARCOS,1,0,2004,NA,NA,2783,1616,1167,691,187,504,0.31,0.16,0.25,2616,281,736,2067
228459,Texas State University-San Marcos,1,0,2005,NA,NA,3053,1786,1267,825,235,590,0.33,0.19,0.27,3024,299,779,2172
228459,Texas State University-San Marcos,1,0,2006,NA,NA,2975,1746,1229,815,250,565,0.32,0.2,0.27,3312,308,833,2038
228459,Texas State University-San Marcos,1,0,2007,NA,NA,3237,1900,1337,983,288,695,0.36,0.22,0.3,3840,367,870,2148
228459,Texas State University-San Marcos,1,0,2008,NA,NA,3444,2051,1393,916,289,627,0.3,0.21,0.27,4080,376,934,2253
228459,Texas State University-San Marcos,1,0,2009,NA,NA,3804,2260,1544,985,271,714,0.31,0.18,0.26,4368,430,983,2371
228459,Texas State University-San Marcos,1,0,2010,NA,NA,4033,2403,1630,1091,306,785,0.32,0.19,0.27,4584,463,1053,2323
228501,SUL ROSS STATE UNIVERSITY,1,0,1991,NA,NA,335,123,212,19,9,10,0.08,0.04,0.06,946,16,91,154
228501,SUL ROSS STATE UNIVERSITY,1,0,1992,NA,NA,278,124,154,17,6,11,0.08,0.04,0.06,1108,17,90,130
228501,SUL ROSS STATE UNIVERSITY,1,0,1993,NA,NA,317,107,210,23,9,14,0.13,0.04,0.07,1224,20,95,145
228501,SUL ROSS STATE UNIVERSITY,1,0,1995,NA,NA,393,140,253,34,16,18,0.12,0.06,0.09,1508,22,102,205
228501,SUL ROSS STATE UNIVERSITY,1,0,1996,NA,NA,355,135,220,22,8,14,0.1,0.04,0.06,1642,26,106,175
228501,SUL ROSS STATE UNIVERSITY,1,0,1997,NA,NA,280,113,167,20,12,8,0.07,0.07,0.07,1750,32,117,138
228501,SUL ROSS STATE UNIVERSITY,1,0,1998,NA,NA,316,113,203,26,10,16,0.14,0.05,0.08,1834,31,118,148
228501,SUL ROSS STATE UNIVERSITY,1,0,1999,NA,NA,227,95,132,25,11,14,0.14,0.08,0.11,912,30,121,117
228501,SUL ROSS STATE UNIVERSITY,1,0,2000,NA,NA,263,105,158,13,7,6,0.05,0.04,0.05,960,33,116,130
228501,SUL ROSS STATE UNIVERSITY,1,0,2001,NA,NA,333,124,209,28,7,21,0.16,0.03,0.08,1536,35,111,139
228501,SUL ROSS STATE UNIVERSITY,1,0,2002,NA,NA,315,130,185,14,3,11,0.08,0.02,0.04,1632,40,117,98
228501,SUL ROSS STATE UNIVERSITY,1,0,2003,NA,NA,357,163,194,30,11,19,0.11,0.06,0.08,1824,40,118,127
228501,SUL ROSS STATE UNIVERSITY,1,0,2004,NA,NA,275,113,162,25,11,14,0.12,0.07,0.09,2064,41,118,115
228501,Sul Ross State University,1,0,2005,NA,NA,329,127,202,31,19,12,0.09,0.09,0.09,2256,43,121,132
228501,Sul Ross State University,1,0,2006,NA,NA,192,73,119,22,8,14,0.19,0.07,0.11,2400,50,125,81
228501,Sul Ross State University,1,0,2007,NA,NA,242,92,150,34,6,28,0.3,0.04,0.14,2688,50,123,84
228501,Sul Ross State University,1,0,2008,NA,NA,315,124,191,43,18,25,0.2,0.09,0.14,2784,53,128,109
228501,Sul Ross State University,1,0,2009,NA,NA,374,135,239,36,15,21,0.15,0.06,0.1,2928,53,128,112
228501,Sul Ross State University,1,0,2010,NA,NA,322,146,176,42,17,25,0.17,0.1,0.13,3072,57,127,95
228529,TARLETON STATE UNIVERSITY,1,0,1991,NA,NA,924,421,503,88,35,53,0.12,0.07,0.1,992,34,196,806
228529,TARLETON STATE UNIVERSITY,1,0,1992,NA,NA,942,428,514,69,28,41,0.09,0.05,0.07,1104,37,198,833
228529,TARLETON STATE UNIVERSITY,1,0,1993,NA,NA,923,432,491,82,24,58,0.13,0.05,0.09,1184,41,204,829
228529,TARLETON STATE UNIVERSITY,1,0,1995,NA,NA,1021,531,490,140,52,88,0.16,0.11,0.14,1566,41,221,935
228529,TARLETON STATE UNIVERSITY,1,0,1996,NA,NA,919,455,464,117,35,82,0.18,0.08,0.13,1774,43,203,850
228529,TARLETON STATE UNIVERSITY,1,0,1997,NA,NA,595,306,289,98,38,60,0.19,0.13,0.16,2331,45,228,546
228529,TARLETON STATE UNIVERSITY,1,0,1998,NA,NA,605,296,309,102,44,58,0.19,0.14,0.17,2412,52,234,562
228529,TARLETON STATE UNIVERSITY,1,0,1999,NA,NA,585,303,282,109,45,64,0.21,0.16,0.19,1488,53,255,547
228529,TARLETON STATE UNIVERSITY,1,0,2000,NA,NA,475,238,237,100,40,60,0.25,0.17,0.21,1608,66,274,421
228529,TARLETON STATE UNIVERSITY,1,0,2001,NA,NA,783,411,372,126,37,89,0.21,0.1,0.16,1728,74,294,701
228529,TARLETON STATE UNIVERSITY,1,0,2002,NA,NA,974,507,467,148,46,102,0.2,0.1,0.15,1920,81,278,862
228529,TARLETON STATE UNIVERSITY,1,0,2003,NA,NA,1277,686,591,201,62,139,0.2,0.1,0.16,2136,83,281,1118
228529,TARLETON STATE UNIVERSITY,1,0,2004,NA,NA,1178,655,523,200,59,141,0.21,0.11,0.17,2400,86,284,1041
228529,Tarleton State University,1,0,2005,NA,NA,1188,678,510,212,65,147,0.21,0.13,0.18,2640,91,304,1013
228529,Tarleton State University,1,0,2006,NA,NA,1256,667,589,230,94,136,0.2,0.16,0.18,2880,100,315,1066
228529,Tarleton State University,1,0,2007,NA,NA,1190,685,505,259,86,173,0.25,0.17,0.22,3120,109,320,1011
228529,Tarleton State University,1,0,2008,NA,NA,1274,722,552,276,92,184,0.25,0.17,0.22,3324,118,359,1053
228529,Tarleton State University,1,0,2009,NA,NA,1207,668,539,293,96,197,0.29,0.18,0.24,3324,133,345,991
228529,Tarleton State University,1,0,2010,NA,NA,1435,858,577,339,98,241,0.28,0.17,0.24,3455,142,344,1129
228705,TEXAS A & I UNIVERSITY,1,0,1991,NA,NA,979,465,514,49,16,33,0.07,0.03,0.05,882,42,188,224
228705,TEXAS A & I UNIVERSITY,1,0,1992,NA,NA,987,484,503,72,20,52,0.1,0.04,0.07,882,45,188,234
228705,TEXAS A & I UNIVERSITY,1,0,1993,NA,NA,1012,481,531,50,19,31,0.06,0.04,0.05,882,49,192,268
228705,TEXAS A & M UNIVERSITY-KINGSVILLE,1,0,1995,NA,NA,893,420,473,40,17,23,0.05,0.04,0.04,1418,53,198,210
228705,TEXAS A & M UNIVERSITY-KINGSVILLE,1,0,1996,NA,NA,916,406,510,55,22,33,0.08,0.04,0.06,1634,56,186,253
228705,TEXAS A & M UNIVERSITY-KINGSVILLE,1,0,1997,NA,NA,898,402,496,47,15,32,0.07,0.03,0.05,1774,63,204,193
228705,TEXAS A & M UNIVERSITY-KINGSVILLE,1,0,1998,NA,NA,872,375,497,73,34,39,0.1,0.07,0.08,1822,69,202,225
228705,TEXAS A & M UNIVERSITY-KINGSVILLE,1,0,1999,NA,NA,736,293,443,53,24,29,0.09,0.05,0.07,1140,70,202,176
228705,TEXAS A & M UNIVERSITY-KINGSVILLE,1,0,2000,NA,NA,819,332,487,79,33,46,0.13,0.07,0.1,1200,78,245,224
228705,TEXAS A & M UNIVERSITY-KINGSVILLE,1,0,2001,NA,NA,820,388,432,66,28,38,0.09,0.06,0.08,1260,70,289,233
228705,TEXAS A & M UNIVERSITY-KINGSVILLE,1,0,2002,NA,NA,962,401,561,135,75,60,0.14,0.13,0.14,1320,89,209,226
228705,TEXAS A & M UNIVERSITY-KINGSVILLE,1,0,2003,NA,NA,828,370,458,60,24,36,0.09,0.05,0.07,1104,90,214,200
228705,TEXAS A & M UNIVERSITY-KINGSVILLE,1,0,2004,NA,NA,741,328,413,80,29,51,0.15,0.07,0.11,1440,90,211,171
228705,Texas A & M University-Kingsville,1,0,2005,NA,NA,606,244,362,83,40,43,0.17,0.11,0.14,2448,94,284,155
228705,Texas A & M University-Kingsville,1,0,2006,NA,NA,731,297,434,95,32,63,0.21,0.07,0.13,2640,98,294,189
228705,Texas A & M University-Kingsville,1,0,2007,NA,NA,651,251,400,115,58,57,0.22,0.14,0.18,2800,102,300,140
228705,Texas A & M University-Kingsville,1,0,2008,NA,NA,737,310,427,124,70,54,0.17,0.16,0.17,3104,112,302,194
228705,Texas A & M University-Kingsville,1,0,2009,NA,NA,971,414,557,165,75,90,0.21,0.13,0.17,3104,130,340,193
228705,Texas A & M University-Kingsville,1,0,2010,NA,NA,1287,539,748,196,70,126,0.23,0.09,0.15,4066,153,360,213
228723,TEXAS A & M UNIVERSITY,1,0,1991,NA,NA,6034,2816,3218,1454,510,944,0.33,0.16,0.24,1224,741,1540,4915
228723,TEXAS A & M UNIVERSITY,1,0,1992,NA,NA,5968,2872,3096,2475,953,1522,0.52,0.31,0.41,1488,763,1550,4745
228723,TEXAS A & M UNIVERSITY,1,0,1993,NA,NA,6341,3083,3258,1631,524,1107,0.35000000000000003,0.16,0.26,1646,801,1546,4975
228723,TEXAS A & M UNIVERSITY,1,0,1995,NA,NA,5985,2986,2999,1643,498,1145,0.38,0.17,0.27,1988,871,1505,4602
228723,TEXAS A & M UNIVERSITY,1,0,1996,NA,NA,6326,3218,3108,1931,625,1306,0.4,0.2,0.31,1948,911,1496,5154
228723,TEXAS A & M UNIVERSITY,1,0,1997,NA,NA,6169,3158,3011,1953,619,1334,0.42,0.21,0.32,2740,965,1637,5098
228723,TEXAS A & M UNIVERSITY,1,0,1998,NA,NA,7322,3701,3621,2350,782,1568,0.42,0.22,0.32,2897,1025,1651,6011
228723,TEXAS A & M UNIVERSITY,1,0,1999,NA,NA,6659,3419,3240,2359,722,1637,0.47000000000000003,0.22,0.35,2280,1084,1753,5529
228723,TEXAS A & M UNIVERSITY,1,0,2000,NA,NA,6591,3453,3138,2409,774,1635,0.47000000000000003,0.25,0.37,2400,1202,1667,5346
228723,TEXAS A & M UNIVERSITY,1,0,2001,NA,NA,6271,3265,3006,2408,815,1593,0.48,0.27,0.38,2520,1159,1582,5149
228723,TEXAS A & M UNIVERSITY,1,0,2002,NA,NA,6589,3528,3061,2734,863,1871,0.53,0.28,0.41,2640,1383,1775,5445
228723,TEXAS A & M UNIVERSITY,1,0,2003,NA,NA,6389,3358,3031,2898,981,1917,0.5700000000000001,0.32,0.45,2895,1430,1813,5236
228723,TEXAS A & M UNIVERSITY,1,0,2004,NA,NA,6645,3465,3180,3071,1049,2022,0.58,0.33,0.46,3675,1418,1898,5276
228723,Texas A & M University,1,0,2005,NA,NA,6713,3406,3307,3352,1259,2093,0.61,0.38,0.5,4110,1561,1907,5099
228723,Texas A & M University,1,0,2006,NA,NA,7472,3774,3698,3636,1358,2278,0.6,0.37,0.49,4371,1557,2116,5620
228723,Texas A & M University,1,0,2007,NA,NA,8025,4074,3951,3968,1491,2477,0.6,0.38,0.49,4680,1621,2179,6107
228723,Texas A & M University,1,0,2008,NA,NA,8038,3940,4098,3989,1575,2414,0.61,0.38,0.5,4898,1917,2648,5754
228723,Texas A & M University,1,0,2009,NA,NA,7933,3908,4025,4017,1602,2415,0.61,0.4,0.51,5152,1992,2316,5630
228723,Texas A & M University-College Station,1,0,2010,NA,NA,8033,3862,4171,4175,1709,2466,0.63,0.41,0.52,5297,2042,2625,5544
228769,UNIVERSITY OF TEXAS AT ARLINGTON,1,0,1991,NA,NA,1608,759,849,116,45,71,0.09,0.05,0.07,1054,139,602,1077
228769,UNIVERSITY OF TEXAS AT ARLINGTON,1,0,1992,NA,NA,1523,724,799,105,39,66,0.09,0.05,0.07,1236,144,613,1010
228769,THE UNIVERSITY OF TEXAS AT ARLINGTON,1,0,1993,NA,NA,1314,638,676,81,34,47,0.07,0.05,0.06,1159,153,608,832
228769,THE UNIVERSITY OF TEXAS AT ARLINGTON,1,0,1995,NA,NA,1243,623,620,117,47,70,0.11,0.08,0.09,1560,167,655,777
228769,THE UNIVERSITY OF TEXAS AT ARLINGTON,1,0,1996,NA,NA,1208,617,591,235,90,145,0.23,0.15,0.19,1859,181,673,707
228769,THE UNIVERSITY OF TEXAS AT ARLINGTON,1,0,1997,NA,NA,1270,644,626,250,105,145,0.22,0.17,0.2,2106,182,618,716
228769,THE UNIVERSITY OF TEXAS AT ARLINGTON,1,0,1998,NA,NA,1241,568,673,155,64,91,0.16,0.1,0.12,2398,190,665,723
228769,THE UNIVERSITY OF TEXAS AT ARLINGTON,1,0,1999,NA,NA,1402,714,688,214,95,119,0.16,0.14,0.15,1824,188,636,775
228769,THE UNIVERSITY OF TEXAS AT ARLINGTON,1,0,2000,NA,NA,1589,801,788,225,102,123,0.15,0.13,0.14,1920,201,642,866
228769,THE UNIVERSITY OF TEXAS AT ARLINGTON,1,0,2001,NA,NA,1838,914,924,271,104,167,0.18,0.11,0.15,2016,222,649,1001
228769,THE UNIVERSITY OF TEXAS AT ARLINGTON,1,0,2002,NA,NA,2126,1070,1056,269,112,157,0.14,0.11,0.13,2112,227,678,1193
228769,THE UNIVERSITY OF TEXAS AT ARLINGTON,1,0,2003,NA,NA,2431,1182,1249,364,144,220,0.18,0.12,0.15,2208,235,743,1399
228769,THE UNIVERSITY OF TEXAS AT ARLINGTON,1,0,2004,NA,NA,2009,1068,941,325,115,210,0.19,0.12,0.16,2904,245,735,993
228769,The University of Texas at Arlington,1,0,2005,NA,NA,2075,1069,1006,347,130,217,0.2,0.13,0.17,3306,280,769,973
228769,The University of Texas at Arlington,1,0,2006,NA,NA,1974,984,990,340,124,216,0.21,0.13,0.17,5930,303,784,979
228769,The University of Texas at Arlington,1,0,2007,NA,NA,2096,1041,1055,354,130,224,0.21,0.12,0.17,6464,324,812,963
228769,The University of Texas at Arlington,1,0,2008,NA,NA,2254,1106,1148,396,151,245,0.22,0.13,0.18,7780,354,825,942
228769,The University of Texas at Arlington,1,0,2009,NA,NA,2435,1261,1174,502,206,296,0.23,0.18,0.21,8186,368,821,987
228769,The University of Texas at Arlington,1,0,2010,NA,NA,2585,1319,1266,549,228,321,0.24,0.18,0.21,8500,410,864,920
228778,UNIVERSITY OF TEXAS AT AUSTIN,1,0,1991,NA,NA,5850,2743,3107,1722,723,999,0.36,0.23,0.29,1189,756,2060,3881
228778,UNIVERSITY OF TEXAS AT AUSTIN,1,0,1992,NA,NA,5633,2670,2963,1696,691,1005,0.37,0.23,0.3,1372,784,2062,3696
228778,THE UNIVERSITY OF TEXAS AT AUSTIN,1,0,1993,NA,NA,5872,2810,3062,1776,741,1035,0.36,0.24,0.3,1691,849,2099,3737
228778,THE UNIVERSITY OF TEXAS AT AUSTIN,1,0,1995,NA,NA,6212,3139,3073,2207,865,1342,0.42,0.28,0.36,2208,876,2115,4001
228778,THE UNIVERSITY OF TEXAS AT AUSTIN,1,0,1996,NA,NA,6281,3087,3194,2420,985,1435,0.46,0.31,0.39,2612,934,2056,4071
228778,THE UNIVERSITY OF TEXAS AT AUSTIN,1,0,1997,NA,NA,6945,3568,3377,2531,990,1541,0.43,0.29,0.36,2866,984,2163,4638
228778,THE UNIVERSITY OF TEXAS AT AUSTIN,1,0,1998,NA,NA,6598,3388,3210,2590,1036,1554,0.45,0.32,0.39,3004,1016,2134,4305
228778,THE UNIVERSITY OF TEXAS AT AUSTIN,1,0,1999,NA,NA,6925,3508,3417,2888,1186,1702,0.48,0.35,0.42,2280,1065,2158,4370
228778,THE UNIVERSITY OF TEXAS AT AUSTIN,1,0,2000,NA,NA,7551,3857,3694,3447,1403,2044,0.52,0.38,0.46,2400,1202,2193,4727
228778,THE UNIVERSITY OF TEXAS AT AUSTIN,1,0,2001,NA,NA,7198,3742,3456,3385,1392,1993,0.53,0.4,0.47,2520,1283,2228,4383
228778,THE UNIVERSITY OF TEXAS AT AUSTIN,1,0,2002,NA,NA,7842,4111,3731,3769,1531,2238,0.54,0.41,0.48,2640,1379,2324,4828
228778,THE UNIVERSITY OF TEXAS AT AUSTIN,1,0,2003,NA,NA,6477,3537,2940,3300,1309,1991,0.56,0.45,0.51,2760,1409,2265,3831
228778,THE UNIVERSITY OF TEXAS AT AUSTIN,1,0,2004,NA,NA,6741,3693,3048,3540,1426,2114,0.5700000000000001,0.47,0.53,4260,1502,2320,3874
228778,The University of Texas at Austin,1,0,2005,NA,NA,6783,3630,3153,3572,1419,2153,0.59,0.45,0.53,6972,1545,2450,3764
228778,The University of Texas at Austin,1,0,2006,NA,NA,7369,4008,3361,3731,1482,2249,0.56,0.44,0.51,7630,1738,2522,4001
228778,The University of Texas at Austin,1,0,2007,NA,NA,7419,3973,3446,3776,1472,2304,0.5700000000000001,0.43,0.51,7670,1807,2448,3807
228778,The University of Texas at Austin,1,0,2008,NA,NA,6679,3679,3000,3487,1358,2129,0.5700000000000001,0.45,0.52,8532,2006,2509,3491
228778,The University of Texas at Austin,1,0,2009,NA,NA,7198,3853,3345,3746,1514,2232,0.5700000000000001,0.45,0.52,8936,2126,2593,3675
228778,The University of Texas at Austin,1,0,2010,NA,NA,7232,3869,3363,3986,1608,2378,0.61,0.48,0.55,9416,2239,2495,3445
228787,UNIVERSITY OF TEXAS AT DALLAS,1,0,1991,NA,NA,99,50,49,21,10,11,0.22,0.2,0.21,1070,62,199,54
228787,UNIVERSITY OF TEXAS AT DALLAS,1,0,1992,NA,NA,93,34,59,21,9,12,0.35000000000000003,0.15,0.23,1096,77,205,62
228787,THE UNIVERSITY OF TEXAS AT DALLAS,1,0,1993,NA,NA,414,156,258,125,76,49,0.31,0.29,0.3,1450,75,207,297
228787,THE UNIVERSITY OF TEXAS AT DALLAS,1,0,1995,NA,NA,351,154,197,113,45,68,0.44,0.23,0.32,2033,79,207,211
228787,THE UNIVERSITY OF TEXAS AT DALLAS,1,0,1996,NA,NA,451,199,252,138,59,79,0.39,0.23,0.31,2333,82,218,300
228787,THE UNIVERSITY OF TEXAS AT DALLAS,1,0,1997,NA,NA,444,183,261,143,77,66,0.36,0.3,0.32,2788,94,230,279
228787,THE UNIVERSITY OF TEXAS AT DALLAS,1,0,1998,NA,NA,494,213,281,187,98,89,0.41000000000000003,0.35,0.38,3117,105,244,308
228787,THE UNIVERSITY OF TEXAS AT DALLAS,1,0,1999,NA,NA,603,242,361,180,88,92,0.38,0.24,0.3,1140,111,256,376
228787,THE UNIVERSITY OF TEXAS AT DALLAS,1,0,2000,NA,NA,801,303,498,248,127,121,0.39,0.26,0.31,960,126,271,469
228787,THE UNIVERSITY OF TEXAS AT DALLAS,1,0,2001,NA,NA,984,402,582,304,145,159,0.39,0.25,0.31,1008,142,287,563
228787,THE UNIVERSITY OF TEXAS AT DALLAS,1,0,2002,NA,NA,903,405,498,325,141,184,0.45,0.28,0.36,1056,179,315,537
228787,THE UNIVERSITY OF TEXAS AT DALLAS,1,0,2003,NA,NA,1043,420,623,446,242,204,0.48,0.39,0.43,1104,183,453,647
228787,THE UNIVERSITY OF TEXAS AT DALLAS,1,0,2004,NA,NA,1129,429,700,473,255,218,0.5,0.36,0.42,1152,289,410,669
228787,The University of Texas at Dallas,1,0,2005,NA,NA,1058,403,655,433,235,198,0.49,0.36,0.41,5904,215,464,636
228787,The University of Texas at Dallas,1,0,2006,NA,NA,1053,394,659,470,252,218,0.55,0.38,0.45,6940,237,451,640
228787,The University of Texas at Dallas,1,0,2007,NA,NA,1030,421,609,472,237,235,0.55,0.39,0.46,7356,278,472,563
228787,The University of Texas at Dallas,1,0,2008,NA,NA,1090,434,656,553,280,273,0.62,0.43,0.51,9050,281,480,550
228787,The University of Texas at Dallas,1,0,2009,NA,NA,1293,560,733,615,304,311,0.55,0.41,0.48,9510,308,536,606
228787,The University of Texas at Dallas,1,0,2010,NA,NA,1346,544,802,680,362,318,0.58,0.45,0.51,9886,361,590,559
228796,UNIVERSITY OF TEXAS AT EL PASO,1,0,1991,NA,NA,1897,1005,892,45,16,29,0.02,0.02,0.02,990,97,398,352
228796,UNIVERSITY OF TEXAS AT EL PASO,1,0,1992,NA,NA,1846,989,857,38,18,20,0.02,0.02,0.02,1318,106,415,296
228796,THE UNIVERSITY OF TEXAS AT EL PASO,1,0,1993,NA,NA,1948,1023,925,59,22,37,0.03,0.02,0.03,1480,119,423,291
228796,THE UNIVERSITY OF TEXAS AT EL PASO,1,0,1995,NA,NA,1618,887,731,36,12,24,0.02,0.02,0.02,1897,137,480,192
228796,THE UNIVERSITY OF TEXAS AT EL PASO,1,0,1996,NA,NA,1393,728,665,38,13,25,0.03,0.02,0.03,1981,138,453,189
228796,THE UNIVERSITY OF TEXAS AT EL PASO,1,0,1997,NA,NA,1482,750,732,36,15,21,0.02,0.02,0.02,2272,151,510,158
228796,THE UNIVERSITY OF TEXAS AT EL PASO,1,0,1998,NA,NA,1639,847,792,58,21,37,0.04,0.03,0.04,2336,161,481,158
228796,THE UNIVERSITY OF TEXAS AT EL PASO,1,0,1999,NA,NA,1662,874,788,79,22,57,0.06,0.03,0.05,2040,170,471,194
228796,THE UNIVERSITY OF TEXAS AT EL PASO,1,0,2000,NA,NA,2018,1046,972,85,30,55,0.05,0.03,0.04,1776,192,515,202
228796,THE UNIVERSITY OF TEXAS AT EL PASO,1,0,2001,NA,NA,2156,1156,1000,89,30,59,0.05,0.03,0.04,1920,208,559,208
228796,THE UNIVERSITY OF TEXAS AT EL PASO,1,0,2002,NA,NA,2279,1202,1077,101,41,60,0.04,0.04,0.04,2064,218,590,190
228796,THE UNIVERSITY OF TEXAS AT EL PASO,1,0,2003,NA,NA,2386,1237,1149,111,46,65,0.05,0.04,0.05,2208,228,577,179
228796,THE UNIVERSITY OF TEXAS AT EL PASO,1,0,2004,NA,NA,2296,1205,1091,174,58,116,0.09,0.05,0.08,3780,228,612,170
228796,The University of Texas at El Paso,1,0,2005,NA,NA,2154,1085,1069,210,74,136,0.12,0.07,0.1,3930,252,645,175
228796,The University of Texas at El Paso,1,0,2006,NA,NA,2446,1256,1190,269,95,174,0.13,0.08,0.11,4065,272,643,161
228796,The University of Texas at El Paso,1,0,2007,NA,NA,2017,1046,971,245,94,151,0.14,0.1,0.12,4311,323,632,152
228796,The University of Texas at El Paso,1,0,2008,NA,NA,2060,1006,1054,251,83,168,0.16,0.08,0.12,4551,303,654,132
228796,The University of Texas at El Paso,1,0,2009,NA,NA,2281,1153,1128,274,95,179,0.15,0.08,0.12,4806,324,675,142
228796,The University of Texas at El Paso,1,0,2010,NA,NA,2450,1262,1188,363,134,229,0.18,0.11,0.15,5063,354,676,207
228875,TEXAS CHRISTIAN UNIVERSITY,1,0,1991,NA,NA,1212,745,467,417,128,289,0.38,0.27,0.34,8166,108,321,1068
228875,TEXAS CHRISTIAN UNIVERSITY,1,0,1992,NA,NA,1261,746,515,506,161,345,0.46,0.31,0.4,8570,104,329,1085
228875,TEXAS CHRISTIAN UNIVERSITY,1,0,1993,NA,NA,1189,690,499,467,162,305,0.44,0.32,0.39,8970,108,336,991
228875,TEXAS CHRISTIAN UNIVERSITY,1,0,1995,NA,NA,1325,813,512,511,146,365,0.44,0.29,0.39,10040,113,338,1099
228875,TEXAS CHRISTIAN UNIVERSITY,1,0,1996,NA,NA,1238,735,503,502,181,321,0.43,0.36,0.41,10510,127,347,1008
228875,TEXAS CHRISTIAN UNIVERSITY,1,0,1997,NA,NA,1463,885,578,563,167,396,0.44,0.29,0.38,11090,129,351,1204
228875,TEXAS CHRISTIAN UNIVERSITY,1,0,1998,NA,NA,1397,839,558,587,177,410,0.48,0.32,0.42,11590,138,355,1211
228875,TEXAS CHRISTIAN UNIVERSITY,1,0,1999,NA,NA,1427,869,558,678,208,470,0.54,0.37,0.48,10950,149,371,1202
228875,TEXAS CHRISTIAN UNIVERSITY,1,0,2000,NA,NA,1493,902,591,671,210,461,0.51,0.36,0.45,11700,167,381,1219
228875,TEXAS CHRISTIAN UNIVERSITY,1,0,2001,NA,NA,1514,894,620,761,251,510,0.5700000000000001,0.4,0.5,15000,183,392,1241
228875,TEXAS CHRISTIAN UNIVERSITY,1,0,2002,NA,NA,1450,904,546,719,207,512,0.56,0.38,0.5,16300,203,415,1172
228875,TEXAS CHRISTIAN UNIVERSITY,1,0,2003,NA,NA,1598,1005,593,877,273,604,0.6,0.46,0.55,17590,217,420,1269
228875,TEXAS CHRISTIAN UNIVERSITY,1,0,2004,NA,NA,1605,988,617,866,276,590,0.59,0.45,0.54,19700,236,442,1319
228875,Texas Christian University,1,0,2005,NA,NA,1610,977,633,875,284,591,0.6,0.45,0.54,21280,216,463,1268
228875,Texas Christian University,1,0,2006,NA,NA,1654,985,669,950,328,622,0.63,0.49,0.57,22980,233,479,1264
228875,Texas Christian University,1,0,2007,NA,NA,1642,965,677,961,348,613,0.63,0.51,0.59,24820,236,487,1244
228875,Texas Christian University,1,0,2008,NA,NA,1628,996,632,954,309,645,0.64,0.49,0.59,26900,265,505,1222
228875,Texas Christian University,1,0,2009,NA,NA,1818,1142,676,1068,348,720,0.63,0.51,0.59,28250,274,521,1381
228875,Texas Christian University,1,0,2010,NA,NA,1824,1104,720,1141,397,744,0.67,0.55,0.63,30000,291,532,1400
228981,TEXAS LUTHERAN COLLEGE,1,0,1991,NA,NA,241,156,85,63,20,43,0.27,0.24,0.26,6340,12,60,171
228981,TEXAS LUTHERAN COLLEGE,1,0,1992,NA,NA,251,148,103,65,22,43,0.29,0.21,0.26,6840,13,63,190
228981,TEXAS LUTHERAN COLLEGE,1,0,1993,NA,NA,213,134,79,65,24,41,0.3,0.3,0.31,7460,14,60,163
228981,TEXAS LUTHERAN COLLEGE,1,0,1995,NA,NA,213,142,71,78,20,58,0.4,0.28,0.37,8626,15,55,165
228981,TEXAS LUTHERAN COLLEGE,1,0,1996,NA,NA,210,132,78,79,23,56,0.42,0.29,0.38,9450,16,57,156
228981,TEXAS LUTHERAN UNIVERSITY,1,0,1997,NA,NA,312,186,126,118,38,80,0.43,0.3,0.38,10370,16,56,228
228981,TEXAS LUTHERAN UNIVERSITY,1,0,1998,NA,NA,366,180,186,101,34,67,0.37,0.18,0.28,10876,18,59,250
228981,TEXAS LUTHERAN UNIVERSITY,1,0,1999,NA,NA,383,170,213,112,45,67,0.39,0.21,0.29,11374,20,63,275
228981,TEXAS LUTHERAN UNIVERSITY,1,0,2000,NA,NA,330,175,155,125,48,77,0.44,0.31,0.38,12500,21,63,242
228981,TEXAS LUTHERAN UNIVERSITY,1,0,2001,NA,NA,376,208,168,133,42,91,0.43,0.25,0.35,13440,21,63,282
228981,TEXAS LUTHERAN UNIVERSITY,1,0,2002,NA,NA,371,181,190,111,34,77,0.42,0.18,0.3,14450,21,74,267
228981,TEXAS LUTHERAN UNIVERSITY,1,0,2003,NA,NA,375,212,163,117,38,79,0.37,0.23,0.31,15470,22,68,256
228981,TEXAS LUTHERAN UNIVERSITY,1,0,2004,NA,NA,399,202,197,105,40,65,0.32,0.2,0.26,16480,24,74,270
228981,Texas Lutheran University,1,0,2005,NA,NA,379,182,197,106,35,71,0.39,0.18,0.28,17600,26,66,275
228981,Texas Lutheran University,1,0,2006,NA,NA,387,197,190,105,39,66,0.33,0.21,0.27,18720,26,77,261
228981,Texas Lutheran University,1,0,2007,NA,NA,365,177,188,114,39,75,0.42,0.21,0.31,19940,27,73,228
228981,Texas Lutheran University,1,0,2008,NA,NA,396,191,205,123,44,79,0.41000000000000003,0.21,0.31,20840,28,76,233
228981,Texas Lutheran University,1,0,2009,NA,NA,345,171,174,104,43,61,0.35000000000000003,0.25,0.3,21780,31,68,198
228981,Texas Lutheran University,1,0,2010,NA,NA,338,159,179,102,39,63,0.39,0.22,0.3,22760,30,72,173
229018,UNIVERSITY OF TEXAS OF THE PERMIAN BASIN,1,0,1991,NA,NA,46,26,20,5,4,1,0.03,0.2,0.11,1311,11,65,34
229018,UNIVERSITY OF TEXAS OF THE PERMIAN BASIN,1,0,1992,NA,NA,71,46,25,6,3,3,0.06,0.12,0.08,1275,11,73,43
229018,THE UNIVERSITY OF TEXAS OF THE PERMIAN BASIN,1,0,1993,NA,NA,78,41,37,8,3,5,0.12,0.08,0.1,1462,12,76,49
229018,THE UNIVERSITY OF TEXAS OF THE PERMIAN BASIN,1,0,1995,NA,NA,100,61,39,10,3,7,0.11,0.08,0.1,1830,15,74,56
229018,THE UNIVERSITY OF TEXAS OF THE PERMIAN BASIN,1,0,1996,NA,NA,108,58,50,10,6,4,0.06,0.12,0.09,1638,16,80,56
229018,THE UNIVERSITY OF TEXAS OF THE PERMIAN BASIN,1,0,1997,NA,NA,113,60,53,17,2,15,0.25,0.04,0.15,2106,16,78,66
229018,THE UNIVERSITY OF TEXAS OF THE PERMIAN BASIN,1,0,1998,NA,NA,112,69,43,19,7,12,0.17,0.16,0.17,2280,17,77,54
229018,THE UNIVERSITY OF TEXAS OF THE PERMIAN BASIN,1,0,1999,NA,NA,97,65,32,15,5,10,0.15,0.16,0.15,912,19,75,62
229018,THE UNIVERSITY OF TEXAS OF THE PERMIAN BASIN,1,0,2000,NA,NA,144,86,58,23,8,15,0.17,0.14,0.16,960,23,79,67
229018,THE UNIVERSITY OF TEXAS OF THE PERMIAN BASIN,1,0,2001,NA,NA,165,104,61,36,9,27,0.25,0.15,0.22,1800,26,84,88
229018,THE UNIVERSITY OF TEXAS OF THE PERMIAN BASIN,1,0,2002,NA,NA,216,126,90,31,9,22,0.17,0.1,0.14,1920,24,88,123
229018,THE UNIVERSITY OF TEXAS OF THE PERMIAN BASIN,1,0,2003,NA,NA,292,160,132,52,19,33,0.2,0.14,0.18,2064,29,96,145
229018,THE UNIVERSITY OF TEXAS OF THE PERMIAN BASIN,1,0,2004,NA,NA,258,136,122,39,16,23,0.16,0.13,0.15,2400,32,106,147
229018,The University of Texas of the Permian Basin,1,0,2005,NA,NA,300,173,127,53,18,35,0.2,0.14,0.18,2616,33,110,134
229018,The University of Texas of the Permian Basin,1,0,2006,NA,NA,315,178,137,55,18,37,0.2,0.13,0.17,2832,38,117,144
229018,The University of Texas of the Permian Basin,1,0,2007,NA,NA,372,198,174,48,15,33,0.16,0.09,0.13,3096,37,117,170
229018,The University of Texas of the Permian Basin,1,0,2008,NA,NA,332,176,156,65,19,46,0.26,0.12,0.2,3264,44,116,158
229018,The University of Texas of the Permian Basin,1,0,2009,NA,NA,326,176,150,72,29,43,0.24,0.19,0.22,3504,46,119,135
229018,The University of Texas of the Permian Basin,1,0,2010,NA,NA,341,180,161,71,29,42,0.23,0.18,0.21,3600,56,137,156
229027,UNIVERSITY OF TEXAS AT SAN ANTONIO,1,0,1991,NA,NA,1479,799,680,69,27,42,0.05,0.04,0.05,1482,74,302,817
229027,UNIVERSITY OF TEXAS AT SAN ANTONIO,1,0,1992,NA,NA,1558,834,724,120,38,82,0.09,0.05,0.08,2086,78,303,872
229027,THE UNIVERSITY OF TEXAS AT SAN ANTONIO,1,0,1993,NA,NA,1591,855,736,84,43,41,0.04,0.06,0.05,2298,88,286,823
229027,THE UNIVERSITY OF TEXAS AT SAN ANTONIO,1,0,1995,NA,NA,1528,821,707,79,20,59,0.07,0.03,0.05,2542,102,323,750
229027,THE UNIVERSITY OF TEXAS AT SAN ANTONIO,1,0,1996,NA,NA,1679,852,827,93,39,54,0.06,0.05,0.06,2393,108,365,740
229027,THE UNIVERSITY OF TEXAS AT SAN ANTONIO,1,0,1997,NA,NA,1749,938,811,109,30,79,0.08,0.04,0.06,2110,115,370,740
229027,THE UNIVERSITY OF TEXAS AT SAN ANTONIO,1,0,1998,NA,NA,2067,1099,968,152,38,114,0.1,0.04,0.07,2336,132,379,881
229027,THE UNIVERSITY OF TEXAS AT SAN ANTONIO,1,0,1999,NA,NA,1665,882,783,105,32,73,0.08,0.04,0.06,1728,143,478,615
229027,THE UNIVERSITY OF TEXAS AT SAN ANTONIO,1,0,2000,NA,NA,1727,894,833,121,47,74,0.08,0.06,0.07,1920,175,496,710
229027,THE UNIVERSITY OF TEXAS AT SAN ANTONIO,1,0,2001,NA,NA,1910,977,933,137,60,77,0.07,0.06,0.07,2016,177,514,751
229027,THE UNIVERSITY OF TEXAS AT SAN ANTONIO,1,0,2002,NA,NA,3001,1619,1382,234,76,158,0.09,0.05,0.08,2112,213,433,1153
229027,THE UNIVERSITY OF TEXAS AT SAN ANTONIO,1,0,2003,NA,NA,4091,2070,2021,310,107,203,0.09,0.05,0.08,2208,220,512,1697
229027,THE UNIVERSITY OF TEXAS AT SAN ANTONIO,1,0,2004,NA,NA,4193,2129,2064,315,103,212,0.09,0.05,0.08,2976,240,740,1723
229027,The University of Texas at San Antonio,1,0,2005,NA,NA,4360,2240,2120,348,127,221,0.09,0.06,0.08,3174,285,548,1735
229027,The University of Texas at San Antonio,1,0,2006,NA,NA,4687,2389,2298,424,155,269,0.11,0.07,0.09,3414,311,563,2054
229027,The University of Texas at San Antonio,1,0,2007,NA,NA,4833,2309,2524,465,179,286,0.12,0.07,0.1,3624,336,582,2043
229027,The University of Texas at San Antonio,1,0,2008,NA,NA,4758,2432,2326,512,198,314,0.12,0.09,0.11,3840,378,586,1885
229027,The University of Texas at San Antonio,1,0,2009,NA,NA,4559,2281,2278,507,180,327,0.14,0.08,0.11,4100,422,665,1684
229027,The University of Texas at San Antonio,1,0,2010,NA,NA,4811,2243,2568,610,248,362,0.16,0.1,0.13,4362,461,848,1562
229115,TEXAS TECH UNIVERSITY,1,0,1991,NA,NA,2838,1439,1399,468,167,301,0.2,0.12,0.16,1498,247,799,2356
229115,TEXAS TECH UNIVERSITY,1,0,1992,NA,NA,2823,1418,1405,528,195,333,0.23,0.14,0.19,1489,217,747,2326
229115,TEXAS TECH UNIVERSITY,1,0,1993,NA,NA,3073,1525,1548,520,196,324,0.21,0.13,0.17,1550,232,731,2567
229115,TEXAS TECH UNIVERSITY,1,0,1995,NA,NA,3461,1764,1697,747,260,487,0.27,0.15,0.22,2200,261,773,2876
229115,TEXAS TECH UNIVERSITY,1,0,1996,NA,NA,3632,1860,1772,746,252,494,0.26,0.14,0.21,2496,283,787,3037
229115,TEXAS TECH UNIVERSITY,1,0,1997,NA,NA,3221,1625,1596,764,302,462,0.28,0.19,0.24,2747,296,817,2749
229115,TEXAS TECH UNIVERSITY,1,0,1998,NA,NA,3149,1581,1568,804,283,521,0.32,0.18,0.26,2971,322,827,2674
229115,TEXAS TECH UNIVERSITY,1,0,1999,NA,NA,3403,1725,1678,785,248,537,0.31,0.15,0.23,1140,355,831,2892
229115,TEXAS TECH UNIVERSITY,1,0,2000,NA,NA,3998,1982,2016,1005,359,646,0.32,0.18,0.25,2400,392,854,3346
229115,TEXAS TECH UNIVERSITY,1,0,2001,NA,NA,4075,1967,2108,1133,438,695,0.35000000000000003,0.21,0.28,2520,413,877,3450
229115,TEXAS TECH UNIVERSITY,1,0,2002,NA,NA,4283,2066,2217,1302,551,751,0.36,0.25,0.3,2640,449,950,3560
229115,TEXAS TECH UNIVERSITY,1,0,2003,NA,NA,4312,2039,2273,1372,547,825,0.4,0.24,0.32,2208,445,979,3597
229115,TEXAS TECH UNIVERSITY,1,0,2004,NA,NA,3833,1894,1939,1419,554,865,0.45,0.29,0.37,2976,450,1005,3137
229115,Texas Tech University,1,0,2005,NA,NA,3743,1829,1914,1323,530,793,0.43,0.28,0.35,3096,474,1046,3021
229115,Texas Tech University,1,0,2006,NA,NA,3862,1844,2018,1427,601,826,0.44,0.3,0.37,3240,520,1078,3076
229115,Texas Tech University,1,0,2007,NA,NA,4439,2065,2374,1455,600,855,0.41000000000000003,0.25,0.33,3448,536,1078,3430
229115,Texas Tech University,1,0,2008,NA,NA,4338,2056,2282,1413,560,853,0.41000000000000003,0.25,0.33,3448,574,1099,3251
229115,Texas Tech University,1,0,2009,NA,NA,4514,2185,2329,1582,641,941,0.43,0.28,0.35,3900,619,1148,3234
229115,Texas Tech University,1,0,2010,NA,NA,4759,2290,2469,1623,645,978,0.42,0.26,0.34,4296,641,1176,3198
229780,WAYLAND BAPTIST UNIVERSITY,1,0,1991,NA,NA,133,79,54,28,9,19,0.24,0.17,0.21,5464,12,59,95
229780,WAYLAND BAPTIST UNIVERSITY,1,0,1992,NA,NA,133,84,49,20,7,13,0.15,0.14,0.15,5626,14,60,100
229780,WAYLAND BAPTIST UNIVERSITY,1,0,1993,NA,NA,166,106,60,26,10,16,0.15,0.17,0.16,5626,14,66,105
229780,WAYLAND BAPTIST UNIVERSITY,1,0,1995,NA,NA,167,102,65,26,7,19,0.18,0.11,0.16,6110,18,70,100
229780,WAYLAND BAPTIST UNIVERSITY,1,0,1996,NA,NA,228,134,94,41,10,31,0.23,0.11,0.18,6395,20,76,159
229780,WAYLAND BAPTIST UNIVERSITY,1,0,1997,NA,NA,241,132,109,58,21,37,0.28,0.19,0.24,6674,17,82,185
229780,WAYLAND BAPTIST UNIVERSITY,1,0,1998,NA,NA,244,120,124,37,9,28,0.23,0.07,0.15,7108,18,87,169
229780,WAYLAND BAPTIST UNIVERSITY,1,0,1999,NA,NA,210,108,102,39,15,24,0.22,0.15,0.19,7050,19,86,105
229780,WAYLAND BAPTIST UNIVERSITY,1,0,2000,NA,NA,216,120,96,30,6,24,0.2,0.06,0.14,7500,22,89,156
229780,WAYLAND BAPTIST UNIVERSITY,1,0,2001,NA,NA,204,111,93,50,17,33,0.29,0.18,0.25,7800,25,92,62
229780,WAYLAND BAPTIST UNIVERSITY,1,0,2002,NA,NA,182,104,78,41,13,28,0.26,0.17,0.23,8100,29,93,79
229780,WAYLAND BAPTIST UNIVERSITY,1,0,2003,NA,NA,205,112,93,41,13,28,0.25,0.14,0.2,8100,31,104,105
229780,WAYLAND BAPTIST UNIVERSITY,1,0,2004,NA,NA,212,109,103,59,26,33,0.3,0.25,0.28,8850,35,107,131
229780,Wayland Baptist University,1,0,2005,NA,NA,222,124,98,44,11,33,0.26,0.11,0.2,9450,36,110,148
229780,Wayland Baptist University,1,0,2006,NA,NA,211,103,108,46,21,25,0.24,0.19,0.22,10200,38,109,149
229780,Wayland Baptist University,1,0,2007,NA,NA,247,129,118,53,20,33,0.25,0.17,0.21,10650,40,118,137
229780,Wayland Baptist University,1,0,2008,NA,NA,197,88,109,23,9,14,0.15,0.08,0.12,11400,44,130,115
229780,Wayland Baptist University,1,0,2009,NA,NA,214,103,111,38,11,27,0.26,0.1,0.18,9480,47,141,110
229780,Wayland Baptist University,1,0,2010,NA,NA,242,112,130,25,10,15,0.13,0.08,0.1,9960,50,142,106
229814,WEST TEXAS STATE UNIVERSITY,1,0,1991,NA,NA,767,434,333,76,16,60,0.13,0.05,0.1,1154,35,182,625
229814,WEST TEXAS STATE UNIVERSITY,1,0,1992,NA,NA,848,421,427,98,27,71,0.16,0.06,0.12,1353,38,182,714
229814,WEST TEXAS STATE UNIVERSITY,1,0,1993,NA,NA,986,472,514,93,25,68,0.14,0.05,0.09,1444,43,185,776
229814,WEST TEXAS A & M UNIVERSITY,1,0,1995,NA,NA,901,506,395,108,35,73,0.14,0.09,0.12,1645,46,202,749
229814,WEST TEXAS A & M UNIVERSITY,1,0,1996,NA,NA,849,411,438,167,69,98,0.23,0.16,0.2,1853,49,201,702
229814,WEST TEXAS A & M UNIVERSITY,1,0,1997,NA,NA,854,414,440,105,33,72,0.17,0.07,0.12,2068,51,199,709
229814,WEST TEXAS A & M UNIVERSITY,1,0,1998,NA,NA,884,465,419,140,42,98,0.21,0.1,0.16,2205,59,202,742
229814,WEST TEXAS A & M UNIVERSITY,1,0,1999,NA,NA,986,506,480,126,34,92,0.18,0.07,0.13,1755,61,203,797
229814,WEST TEXAS A & M UNIVERSITY,1,0,2000,NA,NA,867,471,396,121,40,81,0.17,0.1,0.14,1875,68,206,661
229814,WEST TEXAS A & M UNIVERSITY,1,0,2001,NA,NA,759,419,340,109,24,85,0.2,0.07,0.14,1668,73,209,594
229814,WEST TEXAS A & M UNIVERSITY,1,0,2002,NA,NA,798,425,373,138,38,100,0.23,0.1,0.17,1740,77,222,606
229814,WEST TEXAS A & M UNIVERSITY,1,0,2003,NA,NA,774,404,370,125,31,94,0.23,0.08,0.16,1956,80,218,595
229814,WEST TEXAS A & M UNIVERSITY,1,0,2004,NA,NA,790,424,366,151,42,109,0.25,0.11,0.19,2064,82,229,589
229814,West Texas A & M University,1,0,2005,NA,NA,768,409,359,171,66,105,0.25,0.18,0.22,2208,84,234,530
229814,West Texas A & M University,1,0,2006,NA,NA,920,489,431,223,73,150,0.3,0.17,0.24,2568,92,237,624
229814,West Texas A & M University,1,0,2007,NA,NA,923,480,443,227,79,148,0.3,0.18,0.25,3216,96,236,617
229814,West Texas A & M University,1,0,2008,NA,NA,1149,599,550,259,83,176,0.29,0.15,0.23,3636,114,250,792
229814,West Texas A & M University,1,0,2009,NA,NA,1193,603,590,260,78,182,0.3,0.13,0.22,4028,120,251,772
229814,West Texas A & M University,1,0,2010,NA,NA,1227,637,590,336,102,234,0.36,0.17,0.27,4070,120,262,764
230603,SOUTHERN UTAH UNIVERSITY,0,1,1991,1998,0,550,370,180,59,11,48,0.12,0.06,0.11,1419,29,128,523
230603,SOUTHERN UTAH UNIVERSITY,0,1,1992,1998,0,649,421,228,84,18,66,0.15,0.08,0.13,1497,32,135,617
230603,SOUTHERN UTAH UNIVERSITY,0,1,1993,1998,0,588,416,172,83,11,72,0.17,0.06,0.14,1599,36,147,569
230603,SOUTHERN UTAH UNIVERSITY,0,1,1995,1998,0,643,471,172,90,16,74,0.15,0.09,0.14,1779,43,183,620
230603,SOUTHERN UTAH UNIVERSITY,0,1,1996,1998,0,626,443,183,69,19,50,0.11,0.1,0.11,1800,46,172,595
230603,SOUTHERN UTAH UNIVERSITY,0,1,1997,1998,0,717,530,187,113,18,95,0.17,0.1,0.16,1854,49,187,681
230603,SOUTHERN UTAH UNIVERSITY,1,0,1998,1998,1,667,487,180,113,7,106,0.21,0.04,0.17,1909,52,200,631
230603,SOUTHERN UTAH UNIVERSITY,1,0,1999,1998,1,629,456,173,103,9,94,0.2,0.05,0.16,1524,59,205,598
230603,SOUTHERN UTAH UNIVERSITY,1,0,2000,1998,1,513,414,99,98,12,86,0.2,0.12,0.19,1612,62,209,468
230603,SOUTHERN UTAH UNIVERSITY,1,0,2001,1998,1,562,443,119,113,18,95,0.21,0.15,0.2,1732,66,213,509
230603,SOUTHERN UTAH UNIVERSITY,1,0,2002,1998,1,528,383,145,106,12,94,0.24,0.08,0.2,1888,69,205,478
230603,SOUTHERN UTAH UNIVERSITY,1,0,2003,1998,1,478,338,140,103,17,86,0.25,0.12,0.22,2332,70,205,429
230603,SOUTHERN UTAH UNIVERSITY,1,0,2004,1998,1,656,445,211,130,18,112,0.25,0.09,0.2,2588,72,213,581
230603,Southern Utah University,1,0,2005,1998,1,784,527,257,137,30,107,0.2,0.12,0.17,2834,75,211,666
230603,Southern Utah University,1,0,2006,1998,1,832,594,238,164,23,141,0.23,0.1,0.2,3060,77,218,713
230603,Southern Utah University,1,0,2007,1998,1,865,579,286,185,39,146,0.25,0.14,0.21,3274,86,222,724
230603,Southern Utah University,1,0,2008,1998,1,836,574,262,169,29,140,0.24,0.11,0.2,3502,93,229,733
230603,Southern Utah University,1,0,2009,1998,1,1101,742,359,193,42,151,0.2,0.12,0.18,3730,97,216,921
230603,Southern Utah University,1,0,2010,1998,1,1103,768,335,232,43,189,0.24,0.13,0.21,4196,99,231,928
230728,UTAH STATE UNIVERSITY,0,1,1991,1998,0,1359,857,502,1,1,0,0,0,0,1680,212,509,1210
230728,UTAH STATE UNIVERSITY,0,1,1992,1998,0,1237,847,390,186,31,155,0.18,0.08,0.15,1821,231,569,1088
230728,UTAH STATE UNIVERSITY,0,1,1993,1998,0,1321,850,471,212,42,170,0.2,0.09,0.16,1896,231,583,1162
230728,UTAH STATE UNIVERSITY,0,1,1995,1998,0,1175,803,372,251,43,208,0.25,0.12,0.21,1992,262,738,1091
230728,UTAH STATE UNIVERSITY,0,1,1996,1998,0,967,685,282,267,41,226,0.32,0.15,0.28,1971,271,716,882
230728,UTAH STATE UNIVERSITY,0,1,1997,1998,0,1465,1029,436,304,60,244,0.23,0.14,0.21,2174,281,654,1364
230728,UTAH STATE UNIVERSITY,1,0,1998,1998,1,1764,1229,535,328,43,285,0.23,0.08,0.19,2245,302,648,1589
230728,UTAH STATE UNIVERSITY,1,0,1999,1998,1,1521,1047,474,320,67,253,0.24,0.14,0.21,1871,316,640,1381
230728,UTAH STATE UNIVERSITY,1,0,2000,1998,1,1632,1116,516,357,76,281,0.25,0.15,0.22,1947,340,642,1418
230728,UTAH STATE UNIVERSITY,1,0,2001,1998,1,1892,1270,622,384,72,312,0.24,0.12,0.2,2123,364,645,1639
230728,UTAH STATE UNIVERSITY,1,0,2002,1998,1,1497,1010,487,423,81,342,0.33,0.17,0.28,2388,376,719,1359
230728,UTAH STATE UNIVERSITY,1,0,2003,1998,1,1829,1229,600,491,86,405,0.32,0.14,0.27,2615,392,705,1647
230728,UTAH STATE UNIVERSITY,1,0,2004,1998,1,1591,1048,543,433,70,363,0.34,0.13,0.27,2850,418,727,1448
230728,Utah State University,1,0,2005,1998,1,1618,1065,553,415,75,340,0.31,0.14,0.26,3128,388,727,1365
230728,Utah State University,1,0,2006,1998,1,2429,1574,855,498,102,396,0.25,0.12,0.21,3378,407,692,2064
230728,Utah State University,1,0,2007,1998,1,2654,1697,957,544,113,431,0.25,0.12,0.2,3615,423,714,2176
230728,Utah State University,1,0,2008,1998,1,2580,1646,934,484,83,401,0.24,0.09,0.19,3832,435,744,2110
230728,Utah State University,1,0,2009,1998,1,2664,1663,1001,508,100,408,0.24,0.1,0.19,4043,462,708,2176
230728,Utah State University,1,0,2010,1998,1,2941,1882,1059,548,113,435,0.23,0.11,0.19,4047,475,702,2439
230764,UNIVERSITY OF UTAH,0,1,1991,1998,0,1924,914,1010,268,107,161,0.17,0.11,0.14,1981,595,818,1664
230764,UNIVERSITY OF UTAH,0,1,1992,1998,0,2026,996,1030,304,119,185,0.18,0.12,0.15,2104,683,833,1728
230764,UNIVERSITY OF UTAH,0,1,1993,1998,0,1794,1004,790,202,59,143,0.14,0.07,0.11,2298,722,860,1447
230764,UNIVERSITY OF UTAH,0,1,1995,1998,0,1356,837,519,284,73,211,0.25,0.14,0.21,2508,813,920,1156
230764,UNIVERSITY OF UTAH,0,1,1996,1998,0,1800,1019,781,436,155,281,0.27,0.2,0.24,2514,864,913,1486
230764,UNIVERSITY OF UTAH,0,1,1997,1998,0,1962,1039,923,407,133,274,0.26,0.14,0.21,2601,944,967,1633
230764,UNIVERSITY OF UTAH,1,0,1998,1998,1,1702,991,711,363,116,247,0.24,0.16,0.21,2711,1018,927,1370
230764,UNIVERSITY OF UTAH,1,0,1999,1998,1,1921,921,1000,295,109,186,0.2,0.11,0.15,2278,1167,886,1526
230764,UNIVERSITY OF UTAH,1,0,2000,1998,1,2067,1029,1038,441,155,286,0.27,0.15,0.21,2371,1220,903,1686
230764,UNIVERSITY OF UTAH,1,0,2001,1998,1,1877,1038,839,390,135,255,0.24,0.16,0.21,2517,1292,920,1480
230764,UNIVERSITY OF UTAH,1,0,2002,1998,1,1962,1109,853,391,127,264,0.23,0.15,0.2,2742,1627,927,1610
230764,UNIVERSITY OF UTAH,1,0,2003,1998,1,1870,1073,797,405,129,276,0.25,0.16,0.22,3057,1657,928,1453
230764,UNIVERSITY OF UTAH,1,0,2004,1998,1,1997,1133,864,453,152,301,0.26,0.18,0.23,3364,1707,1162,1559
230764,University of Utah,1,0,2005,1998,1,1997,1106,891,415,138,277,0.25,0.15,0.21,3628,1826,1175,1572
230764,University of Utah,1,0,2006,1998,1,2037,1167,870,457,149,308,0.26,0.17,0.22,3972,1966,1214,1575
230764,University of Utah,1,0,2007,1998,1,1953,1082,871,469,170,299,0.27,0.2,0.24,4270,2123,1248,1488
230764,University of Utah,1,0,2008,1998,1,1908,1054,854,465,171,294,0.27,0.2,0.24,4525,2310,1275,1427
230764,University of Utah,1,0,2009,1998,1,2102,1177,925,597,205,392,0.33,0.22,0.28,4956,2485,1259,1583
230764,University of Utah,1,0,2010,1998,1,2269,1217,1052,663,237,426,0.35000000000000003,0.23,0.29,5426,2604,1287,1629
230782,WEBER STATE UNIVERSITY,0,1,1991,1998,0,1403,810,593,100,32,68,0.08,0.05,0.07,1458,79,428,1264
230782,WEBER STATE UNIVERSITY,0,1,1992,1998,0,1211,729,482,52,15,37,0.05,0.03,0.04,1542,85,438,1050
230782,WEBER STATE UNIVERSITY,0,1,1993,1998,0,1219,829,390,81,23,58,0.07,0.06,0.07,1638,91,459,1070
230782,WEBER STATE UNIVERSITY,0,1,1995,1998,0,1338,889,449,109,23,86,0.09,0.05,0.08,1854,92,441,1142
230782,WEBER STATE UNIVERSITY,0,1,1996,1998,0,1237,833,404,136,25,111,0.13,0.06,0.11,1863,98,427,1078
230782,WEBER STATE UNIVERSITY,0,1,1997,1998,0,1503,978,525,152,37,115,0.11,0.07,0.1,1935,99,417,1298
230782,WEBER STATE UNIVERSITY,1,0,1998,1998,1,1453,935,518,147,36,111,0.11,0.07,0.1,1986,106,391,854
230782,WEBER STATE UNIVERSITY,1,0,1999,1998,1,1619,1001,618,158,47,111,0.11,0.08,0.1,1606,107,430,1220
230782,WEBER STATE UNIVERSITY,1,0,2000,1998,1,1663,1000,663,135,39,96,0.09,0.06,0.08,1670,113,442,1214
230782,WEBER STATE UNIVERSITY,1,0,2001,1998,1,1509,897,612,47,18,29,0.03,0.03,0.03,1786,121,455,1136
230782,WEBER STATE UNIVERSITY,1,0,2002,1998,1,1675,1019,656,79,16,63,0.06,0.02,0.05,1946,130,450,1321
230782,WEBER STATE UNIVERSITY,1,0,2003,1998,1,1688,944,744,90,31,59,0.06,0.04,0.05,2130,131,450,1225
230782,WEBER STATE UNIVERSITY,1,0,2004,1998,1,1559,882,677,94,28,66,0.07,0.04,0.06,2344,141,452,749
230782,Weber State University,1,0,2005,1998,1,1626,879,747,68,23,45,0.05,0.03,0.04,2573,143,472,962
230782,Weber State University,1,0,2006,1998,1,1289,755,534,114,28,86,0.11,0.05,0.09,2793,148,485,792
230782,Weber State University,1,0,2007,1998,1,1364,783,581,110,27,83,0.1,0.05,0.08,2988,158,496,881
230782,Weber State University,1,0,2008,1998,1,1549,853,696,136,41,95,0.11,0.06,0.09,3153,167,499,1044
230782,Weber State University,1,0,2009,1998,1,1845,1011,834,140,43,97,0.09,0.05,0.08,3365,176,481,1243
230782,Weber State University,1,0,2010,1998,1,2041,1193,848,196,64,132,0.11,0.08,0.1,3559,180,463,1431
231059,SAINT MICHAEL'S COLLEGE,1,0,1991,NA,NA,485,253,232,329,145,184,0.72,0.62,0.68,11165,34,116,467
231059,SAINT MICHAEL'S COLLEGE,1,0,1992,NA,NA,414,211,203,277,121,156,0.73,0.6,0.67,11900,35,120,390
231059,SAINT MICHAELS COLLEGE,1,0,1993,NA,NA,454,238,216,291,128,163,0.68,0.59,0.64,12430,36,122,442
231059,SAINT MICHAELS COLLEGE,1,0,1995,NA,NA,529,301,228,383,160,223,0.74,0.7,0.72,13810,42,125,507
231059,SAINT MICHAELS COLLEGE,1,0,1996,NA,NA,486,284,202,335,138,197,0.6900000000000001,0.68,0.69,14640,45,138,461
231059,SAINT MICHAELS COLLEGE,1,0,1997,NA,NA,528,279,249,358,158,200,0.71,0.63,0.68,15744,40,133,509
231059,SAINT MICHAELS COLLEGE,1,0,1998,NA,NA,518,278,240,378,166,212,0.76,0.69,0.73,16310,43,132,503
231059,SAINT MICHAELS COLLEGE,1,0,1999,NA,NA,501,269,232,342,145,197,0.73,0.62,0.68,17500,44,140,481
231059,SAINT MICHAELS COLLEGE,1,0,2000,NA,NA,521,283,238,366,149,217,0.76,0.63,0.7,18615,46,140,500
231059,SAINT MICHAELS COLLEGE,1,0,2001,NA,NA,518,286,232,380,150,230,0.8,0.65,0.73,19500,50,141,486
231059,SAINT MICHAELS COLLEGE,1,0,2002,NA,NA,527,301,226,406,172,234,0.77,0.76,0.77,21010,49,144,498
231059,SAINT MICHAELS COLLEGE,1,0,2003,NA,NA,512,263,249,362,158,204,0.77,0.63,0.71,22220,55,147,481
231059,SAINT MICHAELS COLLEGE,1,0,2004,NA,NA,518,280,238,378,165,213,0.76,0.69,0.73,25325,56,136,497
231059,Saint Michaels College,1,0,2005,NA,NA,592,331,261,454,188,266,0.8,0.72,0.77,26550,59,141,562
231059,Saint Michaels College,1,0,2006,NA,NA,576,333,243,446,192,254,0.76,0.79,0.77,28280,63,147,546
231059,Saint Michaels College,1,0,2007,NA,NA,524,280,244,364,154,210,0.75,0.63,0.69,29695,67,143,493
231059,Saint Michaels College,1,0,2008,NA,NA,543,277,266,396,180,216,0.77,0.68,0.73,31675,69,141,516
231059,Saint Michael's College,1,0,2009,NA,NA,470,230,240,322,146,176,0.76,0.61,0.69,32940,76,141,431
231059,Saint Michael's College,1,0,2010,NA,NA,546,294,252,401,168,233,0.79,0.67,0.73,34555,75,138,490
231174,UNIVERSITY OF VERMONT,1,0,1991,NA,NA,1821,929,892,884,385,499,0.53,0.43,0.49,5312,222,560,1715
231174,UNIVERSITY OF VERMONT AND ST AGRICULTURAL COLLEGE,1,0,1992,NA,NA,1796,978,818,944,378,566,0.5700000000000001,0.46,0.53,6166,236,561,1721
231174,UNIVERSITY OF VERMONT AND STATE AGRICULTURAL COLL,1,0,1993,NA,NA,1706,955,751,828,319,509,0.53,0.42,0.49,6400,237,555,1612
231174,UNIVERSITY OF VERMONT AND STATE AGRICULTURAL COLL,1,0,1995,NA,NA,1853,1037,816,853,338,515,0.49,0.41,0.46,6909,256,539,1749
231174,UNIVERSITY OF VERMONT AND STATE AGRICULTURAL COLL,1,0,1996,NA,NA,1779,971,808,915,374,541,0.55,0.46,0.51,7726,260,545,1690
231174,UNIVERSITY OF VERMONT AND STATE AGRICULTURAL COLL,1,0,1997,NA,NA,1823,1005,818,959,381,578,0.5700000000000001,0.47,0.53,7550,274,531,1733
231174,UNIVERSITY OF VERMONT AND STATE AGRICULTURAL COLL,1,0,1998,NA,NA,1758,994,764,872,336,536,0.53,0.44,0.5,7888,283,535,1656
231174,UNIVERSITY OF VERMONT AND STATE AGRICULTURAL COLL,1,0,1999,NA,NA,1808,984,824,875,351,524,0.53,0.43,0.48,7464,302,554,1713
231174,UNIVERSITY OF VERMONT AND STATE AGRICULTURAL COLL,1,0,2000,NA,NA,1765,988,777,917,344,573,0.58,0.44,0.52,7692,328,541,1654
231174,UNIVERSITY OF VERMONT AND STATE AGRICULTURAL COLL,1,0,2001,NA,NA,1835,1052,783,1017,381,636,0.6,0.49,0.55,8040,323,528,1694
231174,UNIVERSITY OF VERMONT AND STATE AGRICULTURAL COLL,1,0,2002,NA,NA,1828,1005,823,1000,415,585,0.58,0.5,0.55,8320,345,549,1709
231174,UNIVERSITY OF VERMONT AND STATE AGRICULTURAL COLL,1,0,2003,NA,NA,1916,1089,827,1087,439,648,0.59,0.53,0.57,8696,379,538,1773
231174,UNIVERSITY OF VERMONT AND STATE AGRICULTURAL COLL,1,0,2004,NA,NA,1953,1079,874,1188,476,712,0.65,0.54,0.61,9088,406,551,1792
231174,University of Vermont,1,0,2005,NA,NA,2378,1287,1091,1367,568,799,0.62,0.52,0.57,9452,423,560,2193
231174,University of Vermont,1,0,2006,NA,NA,2175,1251,924,1417,551,866,0.6900000000000001,0.6,0.65,9832,453,566,2024
231174,University of Vermont,1,0,2007,NA,NA,2432,1346,1086,1577,650,927,0.68,0.6,0.65,10422,505,583,2259
231174,University of Vermont,1,0,2008,NA,NA,2453,1457,996,1611,617,994,0.68,0.62,0.66,11048,559,606,2233
231174,University of Vermont,1,0,2009,NA,NA,2607,1482,1125,1733,691,1042,0.7000000000000001,0.61,0.66,11712,577,599,2281
231174,University of Vermont,1,0,2010,NA,NA,2452,1425,1027,1523,576,947,0.66,0.56,0.62,12180,581,611,2145
231420,AVERETT COLLEGE,1,0,1991,NA,NA,106,67,39,7,2,5,0.07,0.05,0.07,8750,11,47,91
231420,AVERETT COLLEGE,1,0,1992,NA,NA,104,62,42,25,6,19,0.3,0.14,0.24,9090,12,47,76
231420,AVERETT COLLEGE,1,0,1993,NA,NA,168,101,67,56,17,39,0.38,0.25,0.33,9710,12,48,135
231420,AVERETT COLLEGE,1,0,1995,NA,NA,147,79,68,35,13,22,0.27,0.19,0.24,10800,15,52,118
231420,AVERETT COLLEGE,1,0,1996,NA,NA,149,81,68,42,20,22,0.27,0.29,0.28,11450,18,56,107
231420,AVERETT COLLEGE,1,0,1997,NA,NA,160,91,69,43,16,27,0.29,0.23,0.27,12100,15,60,115
231420,AVERETT COLLEGE,1,0,1998,NA,NA,145,78,67,31,18,13,0.16,0.27,0.21,12985,15,61,119
231420,AVERETT COLLEGE,1,0,1999,NA,NA,204,123,81,72,22,50,0.4,0.27,0.35,13145,16,59,161
231420,AVERETT COLLEGE,1,0,2000,NA,NA,192,64,128,44,17,27,0.42,0.13,0.23,13740,16,59,139
231420,AVERETT UNIVERSITY,1,0,2001,NA,NA,175,81,94,48,12,36,0.44,0.13,0.27,14490,19,60,129
231420,AVERETT UNIVERSITY,1,0,2002,NA,NA,187,90,97,59,20,39,0.43,0.21,0.32,15800,19,61,133
231420,AVERETT UNIVERSITY,1,0,2003,NA,NA,219,83,136,78,34,44,0.53,0.25,0.36,16600,21,65,144
231420,AVERETT UNIVERSITY,1,0,2004,NA,NA,191,68,123,53,25,28,0.41000000000000003,0.2,0.28,17430,21,68,127
231420,Averett University,1,0,2005,NA,NA,229,84,145,59,33,26,0.3,0.23,0.26,18040,21,65,158
231420,Averett University,1,0,2006,NA,NA,160,60,100,45,19,26,0.43,0.19,0.28,18762,21,63,117
231420,Averett University,1,0,2007,NA,NA,238,70,168,43,23,20,0.28,0.14,0.18,19512,16,54,131
231420,Averett University,1,0,2008,NA,NA,234,88,146,53,17,36,0.4,0.12,0.23,20300,16,52,111
231420,Averett University,1,0,2009,NA,NA,222,78,144,52,27,25,0.32,0.19,0.23,21112,18,52,115
231420,Averett University,1,0,2010,NA,NA,264,98,166,89,36,53,0.54,0.22,0.34,21956,19,54,137
231554,BLUEFIELD COLLEGE,1,0,1991,NA,NA,126,61,65,35,15,20,0.32,0.23,0.28,5400,3,26,117
231554,BLUEFIELD COLLEGE,1,0,1992,NA,NA,150,72,78,49,29,20,0.27,0.37,0.33,5940,5,33,131
231554,BLUEFIELD COLLEGE,1,0,1993,NA,NA,210,119,91,88,36,52,0.43,0.4,0.42,6500,6,34,196
231554,BLUEFIELD COLLEGE,1,0,1995,NA,NA,139,68,71,47,22,25,0.36,0.31,0.34,7770,7,40,135
231554,BLUEFIELD COLLEGE,1,0,1996,NA,NA,109,56,53,39,20,19,0.33,0.38,0.36,8200,9,36,103
231554,BLUEFIELD COLLEGE,1,0,1997,NA,NA,130,64,66,44,19,25,0.39,0.29,0.34,9100,6,32,119
231554,BLUEFIELD COLLEGE,1,0,1998,NA,NA,129,69,60,4,1,3,0.04,0.02,0.03,7030,7,32,119
231554,BLUEFIELD COLLEGE,1,0,1999,NA,NA,144,79,65,43,18,25,0.31,0.28,0.3,6900,9,30,129
231554,BLUEFIELD COLLEGE,1,0,2000,NA,NA,107,54,53,26,13,13,0.24,0.25,0.24,7900,8,32,94
231554,BLUEFIELD COLLEGE,1,0,2001,NA,NA,162,91,71,53,21,32,0.35000000000000003,0.3,0.33,8690,7,34,137
231554,BLUEFIELD COLLEGE,1,0,2002,NA,NA,131,62,69,36,17,19,0.3,0.25,0.27,9345,8,32,113
231554,BLUEFIELD COLLEGE,1,0,2003,NA,NA,83,50,33,27,10,17,0.34,0.3,0.33,9715,8,31,73
231554,BLUEFIELD COLLEGE,1,0,2004,NA,NA,135,82,53,38,14,24,0.29,0.26,0.28,10105,8,33,123
231554,Bluefield College,1,0,2005,NA,NA,103,57,46,32,15,17,0.29,0.33,0.31,10860,9,33,90
231554,Bluefield College,1,0,2006,NA,NA,106,59,47,19,5,14,0.23,0.11,0.18,11675,9,33,90
231554,Bluefield College,1,0,2007,NA,NA,89,49,40,34,10,24,0.48,0.25,0.38,12550,10,34,82
231554,Bluefield College,1,0,2008,NA,NA,80,47,33,29,8,21,0.44,0.24,0.36,15000,11,37,52
231554,Bluefield College,1,0,2009,NA,NA,115,64,51,36,11,25,0.39,0.22,0.31,17250,12,36,75
231554,Bluefield College,1,0,2010,NA,NA,112,58,54,28,8,20,0.34,0.15,0.25,17990,11,37,77
231624,COLLEGE OF WILLIAM AND MARY,1,0,1991,NA,NA,1222,609,613,920,413,507,0.8300000000000001,0.67,0.75,3730,109,448,1024
231624,COLLEGE OF WILLIAM AND MARY,1,0,1992,NA,NA,1202,680,522,954,386,568,0.8300000000000001,0.74,0.79,4046,112,447,978
231624,COLLEGE OF WILLIAM AND MARY,1,0,1993,NA,NA,1201,690,511,913,360,553,0.8,0.7,0.76,4414,116,470,994
231624,COLLEGE OF WILLIAM AND MARY,1,0,1995,NA,NA,1369,850,519,1086,378,708,0.8300000000000001,0.73,0.79,4738,131,492,1126
231624,COLLEGE OF WILLIAM AND MARY,1,0,1996,NA,NA,1328,789,539,1053,381,672,0.85,0.71,0.79,4906,134,502,1135
231624,COLLEGE OF WILLIAM AND MARY,1,0,1997,NA,NA,1327,802,525,1063,381,682,0.85,0.73,0.8,5032,145,506,1110
231624,COLLEGE OF WILLIAM AND MARY,1,0,1998,NA,NA,1290,701,589,1007,412,595,0.84,0.7,0.78,5178,152,516,1085
231624,COLLEGE OF WILLIAM AND MARY,1,0,1999,NA,NA,1298,736,562,1052,418,634,0.86,0.74,0.81,2302,163,514,1099
231624,COLLEGE OF WILLIAM AND MARY,1,0,2000,NA,NA,1347,782,565,1118,425,693,0.88,0.75,0.83,2302,180,529,1121
231624,COLLEGE OF WILLIAM AND MARY,1,0,2001,NA,NA,1358,793,565,1140,441,699,0.88,0.78,0.84,2302,187,544,1119
231624,COLLEGE OF WILLIAM AND MARY,1,0,2002,NA,NA,1314,721,593,1082,456,626,0.86,0.77,0.82,2510,205,532,1069
231624,COLLEGE OF WILLIAM AND MARY,1,0,2003,NA,NA,1319,736,583,1098,439,659,0.89,0.75,0.83,3760,188,535,860
231624,COLLEGE OF WILLIAM AND MARY,1,0,2004,NA,NA,1335,683,652,1097,494,603,0.88,0.76,0.82,4330,203,541,870
231624,College of William and Mary,1,0,2005,NA,NA,1339,714,625,1134,489,645,0.9,0.78,0.85,4730,216,587,954
231624,College of William and Mary,1,0,2006,NA,NA,1341,693,648,1107,497,610,0.88,0.77,0.83,5180,230,588,856
231624,College of William and Mary,1,0,2007,NA,NA,1341,729,612,1114,474,640,0.87,0.77,0.83,5549,230,602,760
231624,College of William and Mary,1,0,2008,NA,NA,1381,780,601,1146,462,684,0.87,0.77,0.83,6090,296,601,715
231624,College of William and Mary,1,0,2009,NA,NA,1384,728,656,1133,503,630,0.86,0.77,0.82,6388,294,613,712
231624,College of William and Mary,1,0,2010,NA,NA,1396,791,605,1180,483,697,0.88,0.8,0.85,7523,272,616,868
231712,CHRISTOPHER NEWPORT COLLEGE,1,0,1991,NA,NA,443,287,156,44,14,30,0.1,0.09,0.1,2285,21,137,355
231712,CHRISTOPHER NEWPORT UNIVERSITY,1,0,1992,NA,NA,478,300,178,44,10,34,0.11,0.06,0.09,2860,22,160,387
231712,CHRISTOPHER NEWPORT UNIVERSITY,1,0,1993,NA,NA,428,266,162,29,7,22,0.08,0.04,0.07,3196,24,166,345
231712,CHRISTOPHER NEWPORT UNIVERSITY,1,0,1995,NA,NA,534,320,214,59,18,41,0.12,0.08,0.11,3350,30,164,426
231712,CHRISTOPHER NEWPORT UNIVERSITY,1,0,1996,NA,NA,517,304,213,65,16,49,0.16,0.08,0.13,3326,31,166,393
231712,CHRISTOPHER NEWPORT UNIVERSITY,1,0,1997,NA,NA,665,398,267,88,29,59,0.14,0.11,0.13,3466,35,166,504
231712,CHRISTOPHER NEWPORT UNIVERSITY,1,0,1998,NA,NA,693,414,279,121,35,86,0.2,0.13,0.17,3474,39,172,569
231712,CHRISTOPHER NEWPORT UNIVERSITY,1,0,1999,NA,NA,808,485,323,148,44,104,0.21,0.14,0.18,1888,44,185,648
231712,CHRISTOPHER NEWPORT UNIVERSITY,1,0,2000,NA,NA,999,587,412,262,73,189,0.32,0.18,0.26,1888,47,184,827
231712,CHRISTOPHER NEWPORT UNIVERSITY,1,0,2001,NA,NA,1042,595,447,318,100,218,0.36,0.22,0.31,1888,52,184,883
231712,CHRISTOPHER NEWPORT UNIVERSITY,1,0,2002,NA,NA,1176,660,516,363,128,235,0.35000000000000003,0.25,0.31,2058,57,184,1041
231712,CHRISTOPHER NEWPORT UNIVERSITY,1,0,2003,NA,NA,1205,619,586,475,176,299,0.48,0.3,0.39,2814,64,167,1042
231712,CHRISTOPHER NEWPORT UNIVERSITY,1,0,2004,NA,NA,1174,638,536,498,151,347,0.54,0.28,0.42,3152,68,195,1003
231712,Christopher Newport University,1,0,2005,NA,NA,1245,667,578,578,203,375,0.56,0.35,0.46,3442,73,218,257
231712,Christopher Newport University,1,0,2006,NA,NA,1172,644,528,594,203,391,0.6,0.38,0.51,3784,91,226,976
231712,Christopher Newport University,1,0,2007,NA,NA,1241,706,535,618,200,418,0.59,0.37,0.5,4012,99,226,1017
231712,Christopher Newport University,1,0,2008,NA,NA,1134,640,494,624,207,417,0.65,0.42,0.55,4172,110,239,897
231712,Christopher Newport University,1,0,2009,NA,NA,1212,719,493,689,235,454,0.63,0.48,0.57,4380,108,236,962
231712,Christopher Newport University,1,0,2010,NA,NA,1150,673,477,723,250,473,0.7000000000000001,0.52,0.63,5280,105,243,890
232025,EMORY AND HENRY COLLEGE,1,0,1991,NA,NA,143,78,65,82,36,46,0.58,0.55,0.57,7270,11,54,138
232025,EMORY AND HENRY COLLEGE,1,0,1992,NA,NA,188,79,109,61,25,36,0.45,0.23,0.32,7820,12,53,175
232025,EMORY AND HENRY COLLEGE,1,0,1993,NA,NA,230,120,110,91,30,61,0.5,0.27,0.4,8546,12,54,211
232025,EMORY AND HENRY COLLEGE,1,0,1995,NA,NA,221,107,114,103,47,56,0.52,0.41,0.47,9990,16,57,200
232025,EMORY AND HENRY COLLEGE,1,0,1996,NA,NA,256,121,135,123,52,71,0.58,0.39,0.48,10938,18,58,235
232025,EMORY AND HENRY COLLEGE,1,0,1997,NA,NA,197,98,99,92,35,57,0.58,0.35,0.47,11572,13,62,190
232025,EMORY AND HENRY COLLEGE,1,0,1998,NA,NA,290,144,146,120,43,77,0.53,0.29,0.41,11978,16,64,263
232025,EMORY AND HENRY COLLEGE,1,0,1999,NA,NA,271,129,142,117,50,67,0.51,0.35,0.43,12596,15,66,243
232025,EMORY AND HENRY COLLEGE,1,0,2000,NA,NA,251,127,124,126,53,73,0.5700000000000001,0.43,0.5,12950,16,64,231
232025,EMORY AND HENRY COLLEGE,1,0,2001,NA,NA,267,130,137,113,48,65,0.5,0.35,0.42,13900,17,62,240
232025,EMORY AND HENRY COLLEGE,1,0,2002,NA,NA,235,130,105,118,48,70,0.53,0.46,0.5,14600,18,64,220
232025,EMORY AND HENRY COLLEGE,1,0,2003,NA,NA,223,106,117,96,43,53,0.5,0.37,0.43,15700,19,68,205
232025,EMORY AND HENRY COLLEGE,1,0,2004,NA,NA,260,142,118,125,48,77,0.54,0.41,0.48,16490,18,67,234
232025,Emory and Henry College,1,0,2005,NA,NA,338,155,183,177,80,97,0.62,0.44,0.52,19530,19,68,304
232025,Emory and Henry College,1,0,2006,NA,NA,267,115,152,84,36,48,0.41000000000000003,0.24,0.31,20860,21,74,227
232025,Emory and Henry College,1,0,2007,NA,NA,240,103,137,80,37,43,0.41000000000000003,0.27,0.33,22320,22,74,201
232025,Emory and Henry College,1,0,2008,NA,NA,241,123,118,87,31,56,0.45,0.26,0.36,23860,24,76,193
232025,Emory and Henry College,1,0,2009,NA,NA,283,115,168,108,52,56,0.48,0.31,0.38,24880,25,73,217
232025,Emory and Henry College,1,0,2010,NA,NA,248,124,124,84,34,50,0.4,0.27,0.34,26000,25,74,193
232043,EASTERN MENNONITE COLLEGE AND SEMINARY,1,0,1991,NA,NA,201,129,72,95,29,66,0.51,0.4,0.47,7900,13,48,182
232043,EASTERN MENNONITE COLLEGE AND SEMINARY,1,0,1992,NA,NA,205,117,88,87,31,56,0.47000000000000003,0.35,0.42,8600,15,62,181
232043,EASTERN MENNONITE COLLEGE AND SEMINARY,1,0,1993,NA,NA,229,130,99,108,42,66,0.5,0.42,0.47,9100,15,69,205
232043,EASTERN MENNONITE UNIVERSITY,1,0,1995,NA,NA,206,144,62,96,27,69,0.47000000000000003,0.44,0.47,10400,18,67,179
232043,EASTERN MENNONITE UNIVERSITY,1,0,1996,NA,NA,228,143,85,90,26,64,0.44,0.31,0.39,11130,18,67,203
232043,EASTERN MENNONITE UNIVERSITY,1,0,1997,NA,NA,242,138,104,109,44,65,0.47000000000000003,0.42,0.45,12000,18,68,208
232043,EASTERN MENNONITE UNIVERSITY,1,0,1998,NA,NA,229,130,99,107,43,64,0.49,0.43,0.47,12600,17,67,206
232043,EASTERN MENNONITE UNIVERSITY,1,0,1999,NA,NA,218,131,87,111,36,75,0.5700000000000001,0.41,0.51,13434,19,80,179
232043,EASTERN MENNONITE UNIVERSITY,1,0,2000,NA,NA,220,137,83,106,35,71,0.51,0.42,0.48,14110,21,88,185
232043,EASTERN MENNONITE UNIVERSITY,1,0,2001,NA,NA,208,124,84,115,44,71,0.5700000000000001,0.52,0.55,15254,22,97,171
232043,EASTERN MENNONITE UNIVERSITY,1,0,2002,NA,NA,208,120,88,113,46,67,0.55,0.52,0.54,16324,24,108,181
232043,EASTERN MENNONITE UNIVERSITY,1,0,2003,NA,NA,195,121,74,94,32,62,0.51,0.43,0.48,17304,25,107,159
232043,EASTERN MENNONITE UNIVERSITY,1,0,2004,NA,NA,207,134,73,91,33,58,0.43,0.45,0.44,18174,26,112,151
232043,Eastern Mennonite University,1,0,2005,NA,NA,202,123,79,116,40,76,0.61,0.51,0.57,19500,26,101,159
232043,Eastern Mennonite University,1,0,2006,NA,NA,205,119,86,93,31,62,0.52,0.36,0.45,20612,27,95,156
232043,Eastern Mennonite University,1,0,2007,NA,NA,203,121,82,100,34,66,0.54,0.41,0.49,21860,27,100,162
232043,Eastern Mennonite University,1,0,2008,NA,NA,183,103,80,90,35,55,0.53,0.44,0.49,23180,28,100,146
232043,Eastern Mennonite University,1,0,2009,NA,NA,218,135,83,110,40,70,0.51,0.48,0.5,24120,29,97,168
232043,Eastern Mennonite University,1,0,2010,NA,NA,206,122,84,96,32,64,0.52,0.38,0.47,25060,30,100,148
232089,FERRUM COLLEGE,1,0,1991,NA,NA,339,122,217,58,29,29,0.23,0.13,0.17,7400,15,74,292
232089,FERRUM COLLEGE,1,0,1992,NA,NA,337,130,207,78,46,32,0.24,0.22,0.23,8120,17,72,283
232089,FERRUM COLLEGE,1,0,1993,NA,NA,332,131,201,68,29,39,0.29,0.14,0.2,8800,18,69,282
232089,FERRUM COLLEGE,1,0,1995,NA,NA,297,109,188,66,28,38,0.34,0.15,0.22,9950,18,72,243
232089,FERRUM COLLEGE,1,0,1996,NA,NA,309,111,198,59,24,35,0.31,0.12,0.19,10200,18,71,250
232089,FERRUM COLLEGE,1,0,1997,NA,NA,240,102,138,72,35,37,0.36,0.25,0.3,10750,14,71,181
232089,FERRUM COLLEGE,1,0,1998,NA,NA,305,128,177,60,29,31,0.24,0.16,0.2,10750,14,67,233
232089,FERRUM COLLEGE,1,0,1999,NA,NA,309,104,205,56,26,30,0.28,0.13,0.18,10990,16,64,225
232089,FERRUM COLLEGE,1,0,2000,NA,NA,281,102,179,47,23,24,0.23,0.13,0.17,11900,16,64,181
232089,FERRUM COLLEGE,1,0,2001,NA,NA,269,104,165,51,20,31,0.29,0.12,0.19,12950,17,65,189
232089,FERRUM COLLEGE,1,0,2002,NA,NA,288,97,191,69,32,37,0.38,0.17,0.24,14390,17,63,187
232089,FERRUM COLLEGE,1,0,2003,NA,NA,301,106,195,71,37,34,0.32,0.19,0.24,15640,17,63,187
232089,FERRUM COLLEGE,1,0,2004,NA,NA,287,114,173,53,21,32,0.28,0.12,0.18,16840,17,59,167
232089,Ferrum College,1,0,2005,NA,NA,330,110,220,53,18,35,0.31,0.08,0.16,17990,17,62,202
232089,Ferrum College,1,0,2006,NA,NA,417,156,261,126,65,61,0.39,0.25,0.3,19490,19,64,235
232089,Ferrum College,1,0,2007,NA,NA,525,228,297,103,42,61,0.26,0.14,0.2,20885,22,70,295
232089,Ferrum College,1,0,2008,NA,NA,581,253,328,80,26,54,0.21,0.08,0.14,22500,25,69,306
232089,Ferrum College,1,0,2009,NA,NA,531,262,269,106,45,61,0.23,0.17,0.2,23520,26,69,245
232089,Ferrum College,1,0,2010,NA,NA,565,243,322,106,49,57,0.23,0.15,0.19,24900,29,71,275
232186,GEORGE MASON UNIVERSITY,1,0,1991,NA,NA,1678,927,751,348,106,242,0.26,0.14,0.21,2988,155,643,1096
232186,GEORGE MASON UNIVERSITY,1,0,1992,NA,NA,1732,981,751,467,146,321,0.32,0.19,0.27,3336,161,630,1148
232186,GEORGE MASON UNIVERSITY,1,0,1993,NA,NA,1670,934,736,442,140,302,0.32,0.19,0.26,3888,169,660,1115
232186,GEORGE MASON UNIVERSITY,1,0,1995,NA,NA,1852,1065,787,486,145,341,0.32,0.18,0.26,4212,205,689,1136
232186,GEORGE MASON UNIVERSITY,1,0,1996,NA,NA,1875,1040,835,480,150,330,0.31,0.18,0.26,4248,214,711,1187
232186,GEORGE MASON UNIVERSITY,1,0,1997,NA,NA,1930,1072,858,437,140,297,0.27,0.16,0.23,4296,234,748,1194
232186,GEORGE MASON UNIVERSITY,1,0,1998,NA,NA,2022,1112,910,540,164,376,0.33,0.18,0.27,4344,244,759,1258
232186,GEORGE MASON UNIVERSITY,1,0,1999,NA,NA,2030,1129,901,534,161,373,0.33,0.18,0.26,2376,264,765,1248
232186,GEORGE MASON UNIVERSITY,1,0,2000,NA,NA,2097,1132,965,650,194,456,0.4,0.2,0.31,2376,293,806,1363
232186,GEORGE MASON UNIVERSITY,1,0,2001,NA,NA,2068,1136,932,631,191,440,0.38,0.2,0.31,2376,321,848,1293
232186,GEORGE MASON UNIVERSITY,1,0,2002,NA,NA,2161,1180,981,770,254,516,0.43,0.26,0.36,2976,318,915,1429
232186,GEORGE MASON UNIVERSITY,1,0,2003,NA,NA,2191,1166,1025,847,284,563,0.48,0.28,0.39,3630,337,962,1452
232186,GEORGE MASON UNIVERSITY,1,0,2004,NA,NA,2210,1203,1007,869,311,558,0.46,0.31,0.39,3942,360,974,1125
232186,George Mason University,1,0,2005,NA,NA,2454,1339,1115,999,348,651,0.48,0.31,0.41,4260,392,997,1284
232186,George Mason University,1,0,2006,NA,NA,2390,1335,1055,992,355,637,0.47000000000000003,0.34,0.42,4752,434,1055,1276
232186,George Mason University,1,0,2007,NA,NA,2174,1222,952,942,316,626,0.51,0.33,0.43,5035,487,1104,1010
232186,George Mason University,1,0,2008,NA,NA,2476,1328,1148,1099,406,693,0.52,0.35,0.44,5526,541,1134,1252
232186,George Mason University,1,0,2009,NA,NA,2627,1367,1260,1198,446,752,0.55,0.35,0.46,5840,562,1138,1334
232186,George Mason University,1,0,2010,NA,NA,2577,1324,1253,1198,462,736,0.55,0.37,0.46,6320,588,1144,1439
232265,HAMPTON UNIVERSITY,1,0,1991,NA,NA,1188,718,470,445,112,333,0.46,0.24,0.37,6550,63,306,5
232265,HAMPTON UNIVERSITY,1,0,1992,NA,NA,1139,675,464,364,80,284,0.42,0.17,0.32,7006,67,302,8
232265,HAMPTON UNIVERSITY,1,0,1993,NA,NA,1427,879,548,410,85,325,0.36,0.16,0.29,7356,68,302,6
232265,HAMPTON UNIVERSITY,1,0,1995,NA,NA,1272,780,492,418,98,320,0.41000000000000003,0.2,0.33,8362,86,295,3
232265,HAMPTON UNIVERSITY,1,0,1996,NA,NA,917,591,326,358,70,288,0.48,0.21,0.39,8948,90,288,4
232265,HAMPTON UNIVERSITY,1,0,1997,NA,NA,1218,765,453,459,119,340,0.44,0.26,0.38,9596,77,297,8
232265,HAMPTON UNIVERSITY,1,0,1998,NA,NA,1153,715,438,461,105,356,0.49,0.24,0.4,10076,82,293,10
232265,HAMPTON UNIVERSITY,1,0,1999,NA,NA,1190,728,462,422,102,320,0.43,0.22,0.35,9490,92,303,30
232265,HAMPTON UNIVERSITY,1,0,2000,NA,NA,828,527,301,327,79,248,0.47000000000000003,0.26,0.39,9968,98,303,18
232265,HAMPTON UNIVERSITY,1,0,2001,NA,NA,1189,748,441,450,106,344,0.45,0.24,0.38,10464,99,304,15
232265,HAMPTON UNIVERSITY,1,0,2002,NA,NA,1017,644,373,384,90,294,0.45,0.24,0.38,10990,108,282,11
232265,HAMPTON UNIVERSITY,1,0,2003,NA,NA,1379,873,506,506,131,375,0.42,0.26,0.37,11540,110,311,17
232265,HAMPTON UNIVERSITY,1,0,2004,NA,NA,1345,863,482,514,131,383,0.44,0.27,0.38,12116,148,322,13
232265,Hampton University,1,0,2005,NA,NA,1099,701,398,445,114,331,0.47000000000000003,0.29,0.4,12722,153,305,6
232265,Hampton University,1,0,2006,NA,NA,1098,700,398,447,119,328,0.46,0.3,0.41,13358,148,399,7
232265,Hampton University,1,0,2007,NA,NA,1179,757,422,585,163,422,0.55,0.39,0.5,14026,140,353,10
232265,Hampton University,1,0,2008,NA,NA,1190,792,398,489,120,369,0.46,0.3,0.41,14728,137,371,10
232265,Hampton University,1,0,2009,NA,NA,1017,632,385,135,135,0,0,0.35,0.13,15464,148,347,9
232265,Hampton University,1,0,2010,NA,NA,978,605,373,351,87,264,0.43,0.23,0.36,16238,141,371,16
232423,JAMES MADISON UNIVERSITY,1,0,1991,NA,NA,2121,1223,898,1105,381,724,0.59,0.42,0.52,3298,106,482,1805
232423,JAMES MADISON UNIVERSITY,1,0,1992,NA,NA,2038,1171,867,1075,361,714,0.6,0.42,0.53,3576,113,496,1731
232423,JAMES MADISON UNIVERSITY,1,0,1993,NA,NA,2079,1170,909,1239,453,786,0.67,0.5,0.6,3798,115,508,1788
232423,JAMES MADISON UNIVERSITY,1,0,1995,NA,NA,2537,1484,1053,1548,523,1025,0.6900000000000001,0.5,0.61,4014,134,528,2181
232423,JAMES MADISON UNIVERSITY,1,0,1996,NA,NA,3258,1878,1380,1958,704,1254,0.66,0.51,0.6,4104,141,559,2890
232423,JAMES MADISON UNIVERSITY,1,0,1997,NA,NA,3059,1791,1268,1855,643,1212,0.67,0.51,0.61,4148,165,581,2634
232423,JAMES MADISON UNIVERSITY,1,0,1998,NA,NA,2971,1788,1183,1830,546,1284,0.71,0.46,0.62,4256,173,617,2623
232423,JAMES MADISON UNIVERSITY,1,0,1999,NA,NA,3040,1855,1185,1887,610,1277,0.68,0.51,0.62,1550,199,640,2692
232423,JAMES MADISON UNIVERSITY,1,0,2000,NA,NA,3223,1981,1242,2089,684,1405,0.7000000000000001,0.55,0.65,1550,202,639,2766
232423,JAMES MADISON UNIVERSITY,1,0,2001,NA,NA,3244,2004,1240,2103,696,1407,0.7000000000000001,0.56,0.65,1550,223,638,2734
232423,JAMES MADISON UNIVERSITY,1,0,2002,NA,NA,3283,2116,1167,2220,690,1530,0.72,0.59,0.68,1690,216,704,2804
232423,JAMES MADISON UNIVERSITY,1,0,2003,NA,NA,3386,2167,1219,2220,697,1523,0.7000000000000001,0.57,0.66,2382,224,721,2931
232423,JAMES MADISON UNIVERSITY,1,0,2004,NA,NA,3281,2112,1169,2216,690,1526,0.72,0.59,0.68,2752,237,749,2785
232423,James Madison University,1,0,2005,NA,NA,3796,2421,1375,2465,803,1662,0.68,0.58,0.65,2998,258,795,2883
232423,James Madison University,1,0,2006,NA,NA,3745,2431,1314,2357,713,1644,0.67,0.54,0.63,3228,283,831,2998
232423,James Madison University,1,0,2007,NA,NA,3864,2401,1463,2520,829,1691,0.7000000000000001,0.57,0.65,3420,311,854,3193
232423,James Madison University,1,0,2008,NA,NA,3956,2425,1531,2577,876,1701,0.7000000000000001,0.57,0.65,3556,339,897,3162
232423,James Madison University,1,0,2009,NA,NA,3948,2488,1460,2625,823,1802,0.72,0.56,0.66,3734,357,906,3216
232423,James Madison University,1,0,2010,NA,NA,3995,2482,1513,2599,838,1761,0.7000000000000001,0.55,0.65,4182,370,906,3185
232557,LIBERTY UNIVERSITY,1,0,1991,NA,NA,849,451,398,146,53,93,0.2,0.13,0.17,5850,80,223,737
232557,LIBERTY UNIVERSITY,1,0,1992,NA,NA,766,369,397,156,81,75,0.2,0.2,0.2,6150,67,196,660
232557,LIBERTY UNIVERSITY,1,0,1993,NA,NA,1407,691,716,204,81,123,0.17,0.11,0.14,6600,65,168,1168
232557,LIBERTY UNIVERSITY,1,0,1995,NA,NA,1165,600,565,224,70,154,0.25,0.12,0.19,7350,98,159,992
232557,LIBERTY UNIVERSITY,1,0,1996,NA,NA,1253,635,618,253,91,162,0.25,0.15,0.2,7680,73,163,1032
232557,LIBERTY UNIVERSITY,1,0,1997,NA,NA,995,531,464,279,101,178,0.33,0.22,0.28,8050,50,173,799
232557,LIBERTY UNIVERSITY,1,0,1998,NA,NA,1020,479,541,327,126,201,0.41000000000000003,0.23,0.32,8500,59,175,910
232557,LIBERTY UNIVERSITY,1,0,1999,NA,NA,1074,557,517,268,103,165,0.29,0.2,0.25,8550,48,176,841
232557,LIBERTY UNIVERSITY,1,0,2000,NA,NA,1216,657,559,431,167,264,0.4,0.3,0.35,8550,48,174,997
232557,LIBERTY UNIVERSITY,1,0,2001,NA,NA,1129,602,527,381,146,235,0.39,0.28,0.34,9000,51,172,963
232557,LIBERTY UNIVERSITY,1,0,2002,NA,NA,1530,812,718,393,154,239,0.29,0.21,0.26,9840,56,181,1177
232557,LIBERTY UNIVERSITY,1,0,2003,NA,NA,1811,1024,787,506,190,316,0.3,0.24,0.28,11520,67,218,1358
232557,LIBERTY UNIVERSITY,1,0,2004,NA,NA,2173,1178,995,647,251,396,0.33,0.25,0.3,12600,83,272,1644
232557,Liberty University,1,0,2005,NA,NA,1915,982,933,488,204,284,0.28,0.22,0.25,13700,108,305,1373
232557,Liberty University,1,0,2006,NA,NA,2028,1022,1006,489,209,280,0.27,0.21,0.24,14400,141,354,1365
232557,Liberty University,1,0,2007,NA,NA,2715,1474,1241,715,278,437,0.29,0.22,0.26,14850,183,340,1820
232557,Liberty University,1,0,2008,NA,NA,3063,1663,1400,857,314,543,0.32,0.22,0.28,15444,197,350,1873
232557,Liberty University,1,0,2009,NA,NA,3871,2113,1758,1154,439,715,0.33,0.25,0.3,15992,226,379,2201
232557,Liberty University,1,0,2010,NA,NA,3438,1874,1564,1005,410,595,0.31,0.26,0.29,16792,272,390,2026
232566,LONGWOOD COLLEGE,1,0,1991,NA,NA,634,465,169,223,43,180,0.38,0.25,0.35,3190,32,148,568
232566,LONGWOOD COLLEGE,1,0,1992,NA,NA,687,473,214,268,50,218,0.46,0.23,0.39,3664,33,148,608
232566,LONGWOOD COLLEGE,1,0,1993,NA,NA,724,509,215,275,40,235,0.46,0.19,0.38,4106,36,150,647
232566,LONGWOOD COLLEGE,1,0,1995,NA,NA,671,445,226,283,57,226,0.5,0.25,0.42,4370,41,157,599
232566,LONGWOOD COLLEGE,1,0,1996,NA,NA,657,447,210,242,53,189,0.42,0.25,0.37,4370,41,158,559
232566,LONGWOOD COLLEGE,1,0,1997,NA,NA,728,513,215,303,67,236,0.46,0.31,0.42,4416,43,158,637
232566,LONGWOOD COLLEGE,1,0,1998,NA,NA,812,539,273,362,91,271,0.5,0.33,0.45,4528,45,158,709
232566,LONGWOOD COLLEGE,1,0,1999,NA,NA,815,534,281,391,101,290,0.54,0.36,0.48,2020,48,162,708
232566,LONGWOOD COLLEGE,1,0,2000,NA,NA,895,611,284,412,105,307,0.5,0.37,0.46,1995,53,166,771
232566,LONGWOOD COLLEGE,1,0,2001,NA,NA,891,611,280,410,103,307,0.5,0.37,0.46,1970,56,171,776
232566,LONGWOOD UNIVERSITY,1,0,2002,NA,NA,860,593,267,410,101,309,0.52,0.38,0.48,2148,59,171,770
232566,LONGWOOD UNIVERSITY,1,0,2003,NA,NA,872,576,296,340,91,249,0.43,0.31,0.39,3046,55,182,763
232566,LONGWOOD UNIVERSITY,1,0,2004,NA,NA,972,631,341,386,111,275,0.43,0.33,0.4,3320,58,194,872
232566,Longwood University,1,0,2005,NA,NA,938,632,306,379,88,291,0.46,0.29,0.4,3586,65,201,809
232566,Longwood University,1,0,2006,NA,NA,985,627,358,411,111,300,0.47000000000000003,0.31,0.42,3960,74,203,872
232566,Longwood University,1,0,2007,NA,NA,984,650,334,412,107,305,0.46,0.32,0.42,4249,87,208,848
232566,Longwood University,1,0,2008,NA,NA,1043,700,343,467,104,363,0.51,0.3,0.45,4509,98,211,889
232566,Longwood University,1,0,2009,NA,NA,934,631,303,414,96,318,0.5,0.32,0.44,4680,111,207,754
232566,Longwood University,1,0,2010,NA,NA,970,667,303,454,93,361,0.54,0.31,0.47,5370,98,214,801
232609,LYNCHBURG COLLEGE,1,0,1991,NA,NA,327,200,127,142,47,95,0.47000000000000003,0.37,0.43,10300,29,141,286
232609,LYNCHBURG COLLEGE,1,0,1992,NA,NA,416,248,168,177,52,125,0.5,0.31,0.43,10900,29,131,357
232609,LYNCHBURG COLLEGE,1,0,1993,NA,NA,361,221,140,120,36,84,0.38,0.26,0.33,11600,30,125,316
232609,LYNCHBURG COLLEGE,1,0,1995,NA,NA,262,181,81,142,42,100,0.55,0.52,0.54,14080,29,116,230
232609,LYNCHBURG COLLEGE,1,0,1996,NA,NA,287,169,118,151,51,100,0.59,0.43,0.53,14720,28,104,235
232609,LYNCHBURG COLLEGE,1,0,1997,NA,NA,477,275,202,220,72,148,0.53,0.36,0.46,15490,24,106,407
232609,LYNCHBURG COLLEGE,1,0,1998,NA,NA,433,267,166,218,65,153,0.5700000000000001,0.39,0.5,16290,26,104,377
232609,LYNCHBURG COLLEGE,1,0,1999,NA,NA,473,277,196,222,73,149,0.53,0.37,0.47,17120,28,108,426
232609,LYNCHBURG COLLEGE,1,0,2000,NA,NA,438,252,186,188,70,118,0.46,0.38,0.43,17980,30,108,373
232609,LYNCHBURG COLLEGE,1,0,2001,NA,NA,475,278,197,219,67,152,0.54,0.34,0.46,18880,32,109,424
232609,LYNCHBURG COLLEGE,1,0,2002,NA,NA,438,246,192,220,72,148,0.6,0.38,0.5,20040,33,106,371
232609,LYNCHBURG COLLEGE,1,0,2003,NA,NA,589,342,247,316,116,200,0.58,0.47,0.54,21270,33,135,479
232609,LYNCHBURG COLLEGE,1,0,2004,NA,NA,568,328,240,275,87,188,0.5700000000000001,0.36,0.48,22640,36,136,459
232609,Lynchburg College,1,0,2005,NA,NA,553,321,232,246,84,162,0.5,0.36,0.44,23700,41,149,378
232609,Lynchburg College,1,0,2006,NA,NA,552,305,247,259,88,171,0.56,0.36,0.47,24860,45,157,333
232609,Lynchburg College,1,0,2007,NA,NA,598,324,274,274,95,179,0.55,0.35,0.46,26360,49,158,407
232609,Lynchburg College,1,0,2008,NA,NA,593,336,257,252,85,167,0.49,0.33,0.42,27160,51,161,480
232609,Lynchburg College,1,0,2009,NA,NA,592,348,244,278,91,187,0.53,0.37,0.47,27980,53,163,481
232609,Lynchburg College,1,0,2010,NA,NA,571,328,243,275,89,186,0.56,0.37,0.48,28960,55,171,455
232681,MARY WASHINGTON COLLEGE,1,0,1991,NA,NA,712,496,216,458,123,335,0.67,0.57,0.64,2618,33,162,620
232681,MARY WASHINGTON COLLEGE,1,0,1992,NA,NA,698,474,224,448,132,316,0.66,0.59,0.64,2896,33,160,623
232681,MARY WASHINGTON COLLEGE,1,0,1993,NA,NA,750,477,273,486,161,325,0.68,0.59,0.65,3066,35,157,662
232681,MARY WASHINGTON COLLEGE,1,0,1995,NA,NA,758,497,261,443,138,305,0.61,0.53,0.58,3300,40,174,654
232681,MARY WASHINGTON COLLEGE,1,0,1996,NA,NA,729,504,225,450,112,338,0.67,0.5,0.62,3318,40,170,655
232681,MARY WASHINGTON COLLEGE,1,0,1997,NA,NA,808,547,261,479,129,350,0.63,0.49,0.59,3556,44,177,731
232681,MARY WASHINGTON COLLEGE,1,0,1998,NA,NA,812,557,255,530,156,374,0.67,0.61,0.65,3674,45,179,741
232681,MARY WASHINGTON COLLEGE,1,0,1999,NA,NA,834,619,215,583,142,441,0.71,0.66,0.7,1550,48,184,753
232681,MARY WASHINGTON COLLEGE,1,0,2000,NA,NA,873,609,264,622,175,447,0.73,0.66,0.71,1550,56,193,779
232681,MARY WASHINGTON COLLEGE,1,0,2001,NA,NA,840,574,266,570,158,412,0.71,0.59,0.68,1550,58,203,742
232681,MARY WASHINGTON COLLEGE,1,0,2002,NA,NA,862,618,244,607,164,443,0.71,0.67,0.7,1690,57,206,760
232681,MARY WASHINGTON COLLEGE,1,0,2003,NA,NA,879,572,307,590,181,409,0.71,0.59,0.67,2344,59,209,791
232681,UNIVERSITY OF MARY WASHINGTON,1,0,2004,NA,NA,869,569,300,590,183,407,0.71,0.61,0.68,2544,62,214,779
232681,University of Mary Washington,1,0,2005,NA,NA,877,581,296,552,159,393,0.67,0.54,0.63,2806,66,231,644
232681,University of Mary Washington,1,0,2006,NA,NA,909,614,295,625,180,445,0.72,0.61,0.69,3072,72,242,619
232681,University of Mary Washington,1,0,2007,NA,NA,951,649,302,626,175,451,0.6900000000000001,0.58,0.66,3256,80,246,600
232681,University of Mary Washington,1,0,2008,NA,NA,848,553,295,539,160,379,0.68,0.54,0.64,3386,87,246,586
232681,University of Mary Washington,1,0,2009,NA,NA,925,600,325,543,156,387,0.64,0.48,0.59,3554,99,242,521
232681,University of Mary Washington,1,0,2010,NA,NA,950,612,338,586,179,407,0.66,0.53,0.62,3984,89,239,503
232706,MARYMOUNT UNIVERSITY,1,0,1991,NA,NA,211,159,52,81,21,60,0.37,0.4,0.38,9707,26,92,151
232706,MARYMOUNT UNIVERSITY,1,0,1992,NA,NA,212,165,47,77,19,58,0.35000000000000003,0.4,0.36,10192,29,114,155
232706,MARYMOUNT UNIVERSITY,1,0,1993,NA,NA,175,130,45,66,10,56,0.43,0.22,0.38,10804,33,112,128
232706,MARYMOUNT UNIVERSITY,1,0,1995,NA,NA,167,122,45,82,22,60,0.49,0.49,0.49,11900,37,111,114
232706,MARYMOUNT UNIVERSITY,1,0,1996,NA,NA,212,145,67,102,27,75,0.51,0.4,0.48,12400,40,108,136
232706,MARYMOUNT UNIVERSITY,1,0,1997,NA,NA,261,190,71,111,28,83,0.43,0.39,0.43,12770,34,108,186
232706,MARYMOUNT UNIVERSITY,1,0,1998,NA,NA,262,177,85,100,24,76,0.42,0.28,0.38,13300,37,115,164
232706,MARYMOUNT UNIVERSITY,1,0,1999,NA,NA,302,220,82,116,26,90,0.4,0.32,0.38,13750,36,118,185
232706,MARYMOUNT UNIVERSITY,1,0,2000,NA,NA,309,230,79,120,21,99,0.43,0.27,0.39,14300,38,120,166
232706,MARYMOUNT UNIVERSITY,1,0,2001,NA,NA,354,241,113,123,29,94,0.39,0.26,0.35,14850,40,122,187
232706,MARYMOUNT UNIVERSITY,1,0,2002,NA,NA,361,261,100,128,25,103,0.39,0.25,0.35,15600,41,128,170
232706,MARYMOUNT UNIVERSITY,1,0,2003,NA,NA,379,290,89,158,30,128,0.44,0.34,0.42,16300,43,128,193
232706,MARYMOUNT UNIVERSITY,1,0,2004,NA,NA,414,310,104,180,45,135,0.43,0.43,0.43,16952,45,129,222
232706,Marymount University,1,0,2005,NA,NA,422,310,112,152,34,118,0.38,0.3,0.36,17970,47,134,208
232706,Marymount University,1,0,2006,NA,NA,365,268,97,136,28,108,0.4,0.29,0.37,19048,51,143,173
232706,Marymount University,1,0,2007,NA,NA,396,288,108,176,35,141,0.48,0.32,0.44,20190,54,138,198
232706,Marymount University,1,0,2008,NA,NA,404,294,110,141,25,116,0.39,0.23,0.35,21300,56,138,173
232706,Marymount University,1,0,2009,NA,NA,383,274,109,131,31,100,0.36,0.28,0.34,22370,57,141,161
232706,Marymount University,1,0,2010,NA,NA,415,295,120,151,36,115,0.38,0.3,0.36,23160,59,144,153
232937,NORFOLK STATE UNIVERSITY,1,0,1991,NA,NA,1543,920,623,95,24,71,0.07,0.04,0.06,2330,62,308,33
232937,NORFOLK STATE UNIVERSITY,1,0,1992,NA,NA,1492,893,599,76,24,52,0.05,0.04,0.05,2530,66,275,47
232937,NORFOLK STATE UNIVERSITY,1,0,1993,NA,NA,1324,759,565,70,24,46,0.06,0.04,0.05,2710,70,297,27
232937,NORFOLK STATE UNIVERSITY,1,0,1995,NA,NA,1257,706,551,91,24,67,0.09,0.04,0.07,2865,75,294,33
232937,NORFOLK STATE UNIVERSITY,1,0,1996,NA,NA,1329,809,520,124,34,90,0.11,0.07,0.09,2865,79,317,34
232937,NORFOLK STATE UNIVERSITY,1,0,1997,NA,NA,1132,700,432,104,30,74,0.1,0.07,0.09,3000,83,320,23
232937,NORFOLK STATE UNIVERSITY,1,0,1998,NA,NA,1092,680,412,95,26,69,0.1,0.06,0.09,3335,80,337,22
232937,NORFOLK STATE UNIVERSITY,1,0,1999,NA,NA,1111,687,424,118,27,91,0.13,0.06,0.11,1350,85,326,28
232937,NORFOLK STATE UNIVERSITY,1,0,2000,NA,NA,1262,808,454,141,52,89,0.11,0.11,0.11,1326,95,314,17
232937,NORFOLK STATE UNIVERSITY,1,0,2001,NA,NA,1067,655,412,113,25,88,0.13,0.06,0.11,1530,101,302,22
232937,NORFOLK STATE UNIVERSITY,1,0,2002,NA,NA,1091,634,457,133,35,98,0.15,0.08,0.12,1658,104,314,21
232937,NORFOLK STATE UNIVERSITY,1,0,2003,NA,NA,1080,593,487,123,41,82,0.13,0.08,0.11,1920,104,299,29
232937,NORFOLK STATE UNIVERSITY,1,0,2004,NA,NA,970,580,390,103,20,83,0.14,0.05,0.11,2220,110,285,32
232937,Norfolk State University,1,0,2005,NA,NA,957,551,406,138,39,99,0.17,0.1,0.14,2370,120,280,21
232937,Norfolk State University,1,0,2006,NA,NA,1023,638,385,130,34,96,0.15,0.09,0.13,2580,122,277,23
232937,Norfolk State University,1,0,2007,NA,NA,938,571,367,179,46,133,0.23,0.13,0.19,2700,127,272,18
232937,Norfolk State University,1,0,2008,NA,NA,1143,657,486,182,53,129,0.19,0.11,0.16,2781,132,272,24
232937,Norfolk State University,1,0,2009,NA,NA,1160,654,506,183,63,120,0.18,0.12,0.16,2952,133,270,32
232937,Norfolk State University,1,0,2010,NA,NA,902,528,374,185,67,118,0.22,0.18,0.21,3159,136,269,30
232982,OLD DOMINION UNIVERSITY,1,0,1991,NA,NA,1363,685,678,161,48,113,0.16,0.07,0.12,2848,118,621,1017
232982,OLD DOMINION UNIVERSITY,1,0,1992,NA,NA,1491,764,727,158,50,108,0.14,0.07,0.11,2828,125,601,1080
232982,OLD DOMINION UNIVERSITY,1,0,1993,NA,NA,1173,580,593,137,39,98,0.16,0.07,0.12,3098,137,640,825
232982,OLD DOMINION UNIVERSITY,1,0,1995,NA,NA,1514,827,687,149,30,119,0.14,0.04,0.1,3288,141,625,978
232982,OLD DOMINION UNIVERSITY,1,0,1996,NA,NA,1478,803,675,210,60,150,0.18,0.09,0.14,3312,152,623,926
232982,OLD DOMINION UNIVERSITY,1,0,1997,NA,NA,1464,791,673,207,54,153,0.19,0.08,0.14,3428,161,592,896
232982,OLD DOMINION UNIVERSITY,1,0,1998,NA,NA,1561,904,657,324,82,242,0.26,0.12,0.21,3476,176,582,930
232982,OLD DOMINION UNIVERSITY,1,0,1999,NA,NA,1500,833,667,327,103,224,0.26,0.15,0.22,2184,182,599,875
232982,OLD DOMINION UNIVERSITY,1,0,2000,NA,NA,1407,798,609,321,93,228,0.28,0.15,0.23,1747,202,597,798
232982,OLD DOMINION UNIVERSITY,1,0,2001,NA,NA,1502,821,681,340,116,224,0.27,0.17,0.23,1747,208,596,856
232982,OLD DOMINION UNIVERSITY,1,0,2002,NA,NA,1701,902,799,373,139,234,0.25,0.17,0.22,1891,205,575,958
232982,OLD DOMINION UNIVERSITY,1,0,2003,NA,NA,2001,1139,862,457,136,321,0.28,0.16,0.23,2364,195,566,1159
232982,OLD DOMINION UNIVERSITY,1,0,2004,NA,NA,1917,1053,864,474,136,338,0.32,0.16,0.25,2569,204,605,1093
232982,Old Dominion University,1,0,2005,NA,NA,2054,1160,894,474,145,329,0.28,0.16,0.23,2785,219,620,459
232982,Old Dominion University,1,0,2006,NA,NA,2059,1108,951,507,159,348,0.31,0.17,0.25,3051,250,663,555
232982,Old Dominion University,1,0,2007,NA,NA,2513,1327,1186,581,200,381,0.28,0.17,0.23,3219,284,686,1420
232982,Old Dominion University,1,0,2008,NA,NA,2757,1381,1376,652,233,419,0.3,0.17,0.24,3348,309,697,1567
232982,Old Dominion University,1,0,2009,NA,NA,2691,1346,1345,698,263,435,0.32,0.2,0.26,3516,325,696,1533
232982,Old Dominion University,1,0,2010,NA,NA,2579,1280,1299,666,252,414,0.32,0.19,0.26,3763,337,723,1360
233277,RADFORD UNIVERSITY,1,0,1991,NA,NA,1857,1122,735,365,88,277,0.24,0.12,0.2,2430,75,396,1706
233277,RADFORD UNIVERSITY,1,0,1992,NA,NA,1807,1128,679,445,99,346,0.3,0.15,0.25,2746,76,396,1651
233277,RADFORD UNIVERSITY,1,0,1993,NA,NA,1736,1088,648,460,128,332,0.3,0.2,0.26,2924,79,394,1580
233277,RADFORD UNIVERSITY,1,0,1995,NA,NA,1381,833,548,425,121,304,0.36,0.22,0.31,3114,84,395,1252
233277,RADFORD UNIVERSITY,1,0,1996,NA,NA,1419,867,552,476,141,335,0.38,0.26,0.34,3146,80,361,1274
233277,RADFORD UNIVERSITY,1,0,1997,NA,NA,1619,1048,571,551,145,406,0.38,0.25,0.34,3180,81,352,1443
233277,RADFORD UNIVERSITY,1,0,1998,NA,NA,1518,1011,507,569,154,415,0.41000000000000003,0.3,0.37,3238,88,352,1356
233277,RADFORD UNIVERSITY,1,0,1999,NA,NA,1655,1075,580,610,164,446,0.41000000000000003,0.28,0.37,1629,93,356,1462
233277,RADFORD UNIVERSITY,1,0,2000,NA,NA,1753,1081,672,610,191,419,0.38,0.28,0.35,1629,98,357,1563
233277,RADFORD UNIVERSITY,1,0,2001,NA,NA,1875,1155,720,674,200,474,0.41000000000000003,0.28,0.36,1629,107,358,1679
233277,RADFORD UNIVERSITY,1,0,2002,NA,NA,1813,1109,704,754,244,510,0.45,0.35,0.42,1774,97,355,1590
233277,RADFORD UNIVERSITY,1,0,2003,NA,NA,1800,1097,703,719,214,505,0.46,0.3,0.4,2476,101,340,1614
233277,RADFORD UNIVERSITY,1,0,2004,NA,NA,1828,1135,693,708,209,499,0.43,0.3,0.39,2974,103,356,1604
233277,Radford University,1,0,2005,NA,NA,1890,1101,789,725,254,471,0.42,0.32,0.38,3235,113,377,1647
233277,Radford University,1,0,2006,NA,NA,1730,1045,685,730,252,478,0.45,0.37,0.42,3720,126,383,1507
233277,Radford University,1,0,2007,NA,NA,1840,1055,785,758,273,485,0.45,0.35,0.41,4026,136,397,1611
233277,Radford University,1,0,2008,NA,NA,1871,1119,752,809,261,548,0.48,0.35,0.43,4187,147,400,1573
233277,Radford University,1,0,2009,NA,NA,1444,838,606,637,217,420,0.5,0.36,0.44,4396,149,387,1249
233277,Radford University,1,0,2010,NA,NA,1836,1068,768,783,259,524,0.49,0.34,0.43,5012,153,393,1557
233374,UNIVERSITY OF RICHMOND,1,0,1991,NA,NA,805,409,396,623,294,329,0.8,0.74,0.77,11695,67,208,753
233374,UNIVERSITY OF RICHMOND,1,0,1992,NA,NA,749,361,388,576,294,282,0.78,0.76,0.77,12620,76,212,689
233374,UNIVERSITY OF RICHMOND,1,0,1993,NA,NA,728,383,345,559,251,308,0.8,0.73,0.77,13540,78,222,664
233374,UNIVERSITY OF RICHMOND,1,0,1995,NA,NA,762,398,364,581,251,330,0.8200000000000001,0.69,0.76,15500,87,221,671
233374,UNIVERSITY OF RICHMOND,1,0,1996,NA,NA,793,399,394,610,284,326,0.81,0.72,0.77,16570,83,226,698
233374,UNIVERSITY OF RICHMOND,1,0,1997,NA,NA,750,367,383,548,258,290,0.79,0.67,0.73,17570,92,225,660
233374,UNIVERSITY OF RICHMOND,1,0,1998,NA,NA,739,358,381,576,281,295,0.8200000000000001,0.74,0.78,18595,87,226,633
233374,UNIVERSITY OF RICHMOND,1,0,1999,NA,NA,854,465,389,647,273,374,0.8,0.7,0.76,19340,107,224,773
233374,UNIVERSITY OF RICHMOND,1,0,2000,NA,NA,723,366,357,574,278,296,0.8,0.78,0.79,20140,116,235,632
233374,UNIVERSITY OF RICHMOND,1,0,2001,NA,NA,790,430,360,640,277,363,0.84,0.77,0.81,21700,121,247,696
233374,UNIVERSITY OF RICHMOND,1,0,2002,NA,NA,775,422,353,634,279,355,0.84,0.79,0.82,22995,128,292,668
233374,UNIVERSITY OF RICHMOND,1,0,2003,NA,NA,835,440,395,688,313,375,0.85,0.79,0.82,24170,133,283,730
233374,UNIVERSITY OF RICHMOND,1,0,2004,NA,NA,763,391,372,620,298,322,0.8200000000000001,0.8,0.81,26520,139,299,640
233374,University of Richmond,1,0,2005,NA,NA,775,401,374,593,268,325,0.81,0.72,0.77,29250,150,334,577
233374,University of Richmond,1,0,2006,NA,NA,757,387,370,585,267,318,0.8200000000000001,0.72,0.77,32870,159,336,540
233374,University of Richmond,1,0,2007,NA,NA,801,427,374,653,295,358,0.8300000000000001,0.79,0.82,35718,169,344,605
233374,University of Richmond,1,0,2008,NA,NA,737,412,325,591,255,336,0.81,0.78,0.8,38850,186,343,485
233374,University of Richmond,1,0,2009,NA,NA,918,546,372,758,293,465,0.85,0.79,0.83,40010,201,374,505
233374,University of Richmond,1,0,2010,NA,NA,816,452,364,685,286,399,0.88,0.79,0.84,41610,212,371,506
233426,ROANOKE COLLEGE,1,0,1991,NA,NA,421,267,154,188,58,130,0.48,0.38,0.45,11250,24,91,403
233426,ROANOKE COLLEGE,1,0,1992,NA,NA,422,259,163,222,65,157,0.6,0.4,0.53,12000,27,91,395
233426,ROANOKE COLLEGE,1,0,1993,NA,NA,438,275,163,242,67,175,0.63,0.41,0.55,12625,28,92,415
233426,ROANOKE COLLEGE,1,0,1995,NA,NA,431,247,184,223,77,146,0.59,0.42,0.52,14100,31,94,405
233426,ROANOKE COLLEGE,1,0,1996,NA,NA,437,278,159,263,84,179,0.64,0.53,0.6,14750,33,94,408
233426,ROANOKE COLLEGE,1,0,1997,NA,NA,438,248,190,225,70,155,0.62,0.37,0.51,15380,26,92,407
233426,ROANOKE COLLEGE,1,0,1998,NA,NA,426,272,154,222,68,154,0.56,0.44,0.52,16035,27,93,400
233426,ROANOKE COLLEGE,1,0,1999,NA,NA,450,274,176,257,88,169,0.61,0.5,0.57,16655,29,98,428
233426,ROANOKE COLLEGE,1,0,2000,NA,NA,444,274,170,259,80,179,0.65,0.47,0.58,17320,30,97,403
233426,ROANOKE COLLEGE,1,0,2001,NA,NA,498,311,187,283,96,187,0.6,0.51,0.57,18186,32,96,452
233426,ROANOKE COLLEGE,1,0,2002,NA,NA,460,274,186,256,95,161,0.58,0.51,0.56,19186,35,105,417
233426,ROANOKE COLLEGE,1,0,2003,NA,NA,519,282,237,301,130,171,0.6,0.55,0.58,20355,36,132,477
233426,ROANOKE COLLEGE,1,0,2004,NA,NA,483,288,195,314,114,200,0.6900000000000001,0.58,0.65,21504,39,139,434
233426,Roanoke College,1,0,2005,NA,NA,534,310,224,316,120,196,0.63,0.54,0.59,22848,41,133,464
233426,Roanoke College,1,0,2006,NA,NA,503,296,207,285,104,181,0.61,0.5,0.57,24048,43,146,433
233426,Roanoke College,1,0,2007,NA,NA,565,335,230,327,115,212,0.63,0.5,0.58,25550,46,157,471
233426,Roanoke College,1,0,2008,NA,NA,529,284,245,302,115,187,0.65,0.47,0.57,27210,52,151,458
233426,Roanoke College,1,0,2009,NA,NA,560,325,235,327,123,204,0.62,0.52,0.58,28734,52,164,480
233426,Roanoke College,1,0,2010,NA,NA,564,323,241,321,115,206,0.63,0.48,0.57,30314,57,164,503
233541,SHENANDOAH UNIVERSITY,1,0,1991,NA,NA,180,104,76,35,10,25,0.24,0.13,0.19,8100,12,75,153
233541,SHENANDOAH UNIVERSITY,1,0,1992,NA,NA,221,141,80,46,16,30,0.21,0.2,0.21,8750,14,81,186
233541,SHENANDOAH UNIVERSITY,1,0,1993,NA,NA,185,88,97,47,17,30,0.34,0.18,0.25,9800,17,89,164
233541,SHENANDOAH UNIVERSITY,1,0,1995,NA,NA,212,118,94,53,16,37,0.31,0.17,0.25,11470,24,113,179
233541,SHENANDOAH UNIVERSITY,1,0,1996,NA,NA,251,149,102,59,14,45,0.3,0.14,0.24,13700,27,114,214
233541,SHENANDOAH UNIVERSITY,1,0,1997,NA,NA,257,159,98,61,17,44,0.27,0.17,0.24,14400,25,128,223
233541,SHENANDOAH UNIVERSITY,1,0,1998,NA,NA,288,178,110,80,19,61,0.34,0.17,0.28,15080,25,142,251
233541,SHENANDOAH UNIVERSITY,1,0,1999,NA,NA,292,163,129,87,36,51,0.31,0.28,0.3,15700,32,147,249
233541,SHENANDOAH UNIVERSITY,1,0,2000,NA,NA,377,187,190,105,35,70,0.37,0.18,0.28,16300,36,153,303
233541,SHENANDOAH UNIVERSITY,1,0,2001,NA,NA,308,158,150,106,40,66,0.41000000000000003,0.27,0.34,17000,38,159,268
233541,SHENANDOAH UNIVERSITY,1,0,2002,NA,NA,323,163,160,115,42,73,0.44,0.26,0.36,17510,42,167,267
233541,SHENANDOAH UNIVERSITY,1,0,2003,NA,NA,328,185,143,106,34,72,0.38,0.24,0.32,18310,45,175,317
233541,SHENANDOAH UNIVERSITY,1,0,2004,NA,NA,325,160,165,98,39,59,0.36,0.24,0.3,19090,46,175,301
233541,Shenandoah University,1,0,2005,NA,NA,369,211,158,123,44,79,0.37,0.28,0.33,19900,50,181,158
233541,Shenandoah University,1,0,2006,NA,NA,304,157,147,75,29,46,0.29,0.2,0.25,21090,53,191,50
233541,Shenandoah University,1,0,2007,NA,NA,397,205,192,135,49,86,0.41000000000000003,0.26,0.34,22040,56,196,287
233541,Shenandoah University,1,0,2008,NA,NA,399,200,199,145,52,93,0.46,0.26,0.36,22740,61,211,292
233541,Shenandoah University,1,0,2009,NA,NA,443,235,208,155,46,109,0.46,0.22,0.35,23850,66,215,320
233541,Shenandoah University,1,0,2010,NA,NA,414,228,186,164,57,107,0.46,0.31,0.4,24780,68,222,297
233897,UNIVERSITY OF VIRGINIA CLINCH VALLEY COLLEGE,1,0,1991,NA,NA,326,155,171,52,16,36,0.23,0.09,0.16,2300,11,52,303
233897,UNIVERSITY OF VIRGINIA CLINCH VALLEY COLLEGE,1,0,1992,NA,NA,232,110,122,41,14,27,0.24,0.11,0.18,2650,13,57,219
233897,UNIVERSITY OF VIRGINIA-CLINCH VALLEY COLLEGE,1,0,1993,NA,NA,253,110,143,53,22,31,0.28,0.15,0.21,2988,14,58,229
233897,UNIVERSITY OF VIRGINIA-CLINCH VALLEY COLLEGE,1,0,1995,NA,NA,269,141,128,67,27,40,0.28,0.21,0.25,3200,14,57,255
233897,UNIVERSITY OF VIRGINIA-CLINCH VALLEY COLLEGE,1,0,1996,NA,NA,247,132,115,69,31,38,0.28,0.27,0.28,3258,14,56,234
233897,UNIVERSITY OF VIRGINIA-CLINCH VALLEY COLLEGE,1,0,1997,NA,NA,303,155,148,80,28,52,0.33,0.19,0.26,3348,15,59,279
233897,UNIVERSITY OF VIRGINIA-CLINCH VALLEY COLLEGE,1,0,1998,NA,NA,297,146,151,57,18,39,0.26,0.12,0.19,3520,11,63,268
233897,UNIVERSITY OF VIRGINIA'S COLLEGE AT WISE,1,0,1999,NA,NA,299,151,148,76,36,40,0.26,0.24,0.25,1930,19,69,274
233897,UNIVERSITY OF VIRGINIA'S COLLEGE AT WISE,1,0,2000,NA,NA,277,137,140,74,22,52,0.37,0.16,0.27,1930,20,69,252
233897,UNIVERSITY OF VIRGINIA'S COLLEGE AT WISE,1,0,2001,NA,NA,325,154,171,80,36,44,0.28,0.21,0.25,1885,22,69,280
233897,UNIVERSITY OF VIRGINIA'S COLLEGE AT WISE,1,0,2002,NA,NA,345,181,164,100,34,66,0.36,0.21,0.29,2055,24,67,315
233897,THE UNIVERSITY OF VIRGINIA'S COLLEGE AT WISE,1,0,2003,NA,NA,349,177,172,109,39,70,0.39,0.23,0.31,2630,24,76,296
233897,THE UNIVERSITY OF VIRGINIA'S COLLEGE AT WISE,1,0,2004,NA,NA,373,180,193,130,61,69,0.38,0.32,0.35,2788,26,74,336
233897,The University of Virginia's College at Wise,1,0,2005,NA,NA,366,186,180,94,27,67,0.36,0.15,0.26,2984,28,89,314
233897,The University of Virginia's College at Wise,1,0,2006,NA,NA,401,187,214,98,45,53,0.28,0.21,0.24,3252,30,91,349
233897,The University of Virginia's College at Wise,1,0,2007,NA,NA,401,184,217,97,41,56,0.3,0.19,0.24,3422,34,95,332
233897,The University of Virginia's College at Wise,1,0,2008,NA,NA,427,194,233,98,42,56,0.28,0.18,0.23,3482,43,94,350
233897,The University of Virginia's College at Wise,1,0,2009,NA,NA,397,172,225,87,40,47,0.27,0.18,0.22,3586,37,93,314
233897,The University of Virginia's College at Wise,1,0,2010,NA,NA,399,197,202,92,33,59,0.29,0.16,0.23,3910,40,91,323
233921,VIRGINIA POLYTECHNIC INSTITUTE AND STATE UNIV,1,0,1991,NA,NA,4407,1878,2529,1566,697,869,0.46,0.28,0.36,3304,449,1468,3760
233921,VIRGINIA POLYTECHNIC INSTITUTE AND STATE UNIV,1,0,1992,NA,NA,3851,1639,2212,1386,603,783,0.47000000000000003,0.27,0.36,3538,465,1452,3259
233921,VIRGINIA POLYTECHNIC INSTITUTE AND STATE UNIV,1,0,1993,NA,NA,4270,1776,2494,1459,620,839,0.47000000000000003,0.25,0.34,3812,471,1485,3631
233921,VIRGINIA POLYTECHNIC INSTITUTE AND STATE UNIV,1,0,1995,NA,NA,4687,2050,2637,1819,745,1074,0.52,0.28,0.39,4087,516,1424,4074
233921,VIRGINIA POLYTECHNIC INSTITUTE AND STATE UNIV,1,0,1996,NA,NA,5057,2061,2996,2120,970,1150,0.55,0.32,0.42,4131,503,1410,4377
233921,VIRGINIA POLYTECHNIC INSTITUTE AND STATE UNIV,1,0,1997,NA,NA,4522,1818,2704,1903,869,1034,0.56,0.32,0.42,4147,558,1414,3910
233921,VIRGINIA POLYTECHNIC INSTITUTE AND STATE UNIV,1,0,1998,NA,NA,4638,1941,2697,1999,855,1144,0.58,0.32,0.43,4305,585,1209,3978
233921,VIRGINIA POLYTECHNIC INSTITUTE AND STATE UNIV,1,0,1999,NA,NA,4653,1957,2696,2177,996,1181,0.6,0.37,0.47,2792,628,1253,4020
233921,VIRGINIA POLYTECHNIC INSTITUTE AND STATE UNIV,1,0,2000,NA,NA,4586,2024,2562,2339,1047,1292,0.63,0.41,0.51,2792,670,1274,3878
233921,VIRGINIA POLYTECHNIC INSTITUTE AND STATE UNIV,1,0,2001,NA,NA,5020,2063,2957,2511,1228,1283,0.62,0.42,0.5,2792,710,1295,3868
233921,VIRGINIA POLYTECHNIC INSTITUTE AND STATE UNIV,1,0,2002,NA,NA,4714,2002,2712,2437,1151,1286,0.64,0.42,0.52,3044,706,1301,3579
233921,VIRGINIA POLYTECHNIC INSTITUTE AND STATE UNIV,1,0,2003,NA,NA,4923,2092,2831,2588,1213,1375,0.65,0.43,0.53,4190,703,1251,3635
233921,VIRGINIA POLYTECHNIC INSTITUTE AND STATE UNIV,1,0,2004,NA,NA,4923,2042,2881,2599,1252,1347,0.65,0.43,0.53,4513,707,1265,3613
233921,Virginia Polytechnic Institute and State University,1,0,2005,NA,NA,5026,2190,2836,2797,1296,1501,0.68,0.46,0.56,4959,750,1304,3697
233921,Virginia Polytechnic Institute and State University,1,0,2006,NA,NA,5078,2273,2805,2953,1367,1586,0.6900000000000001,0.49,0.58,5450,826,1340,3423
233921,Virginia Polytechnic Institute and State University,1,0,2007,NA,NA,5112,2264,2848,3063,1430,1633,0.72,0.5,0.6,5772,896,1371,3852
233921,Virginia Polytechnic Institute and State University,1,0,2008,NA,NA,5449,2449,3000,3306,1509,1797,0.73,0.5,0.61,6332,957,1369,4219
233921,Virginia Polytechnic Institute and State University,1,0,2009,NA,NA,5036,2266,2770,3075,1446,1629,0.71,0.52,0.61,6639,983,1364,3885
233921,Virginia Polytechnic Institute and State University,1,0,2010,NA,NA,5193,2158,3035,3130,1587,1543,0.71,0.52,0.6,7309,982,1306,4007
234030,VIRGINIA COMMONWEALTH UNIVERSITY,1,0,1991,NA,NA,1318,799,519,216,65,151,0.18,0.13,0.16,3069,607,780,896
234030,VIRGINIA COMMONWEALTH UNIVERSITY,1,0,1992,NA,NA,1460,877,583,270,92,178,0.2,0.16,0.18,3529,650,768,994
234030,VIRGINIA COMMONWEALTH UNIVERSITY,1,0,1993,NA,NA,1466,874,592,281,80,201,0.23,0.14,0.19,3747,670,784,1001
234030,VIRGINIA COMMONWEALTH UNIVERSITY,1,0,1995,NA,NA,1655,963,692,320,104,216,0.22,0.15,0.19,4030,726,778,1001
234030,VIRGINIA COMMONWEALTH UNIVERSITY,1,0,1996,NA,NA,1875,1146,729,352,103,249,0.21,0.14,0.19,4071,745,734,1102
234030,VIRGINIA COMMONWEALTH UNIVERSITY,1,0,1997,NA,NA,2175,1301,874,337,106,231,0.17,0.12,0.15,4111,812,770,1313
234030,VIRGINIA COMMONWEALTH UNIVERSITY,1,0,1998,NA,NA,2141,1257,884,364,117,247,0.19,0.13,0.17,4182,444,800,1359
234030,VIRGINIA COMMONWEALTH UNIVERSITY,1,0,1999,NA,NA,2408,1427,981,499,164,335,0.23,0.17,0.21,2492,473,813,1476
234030,VIRGINIA COMMONWEALTH UNIVERSITY,1,0,2000,NA,NA,2670,1608,1062,522,161,361,0.22,0.15,0.2,2492,491,819,1684
234030,VIRGINIA COMMONWEALTH UNIVERSITY,1,0,2001,NA,NA,2675,1563,1112,547,170,377,0.24,0.15,0.2,2492,509,826,1682
234030,VIRGINIA COMMONWEALTH UNIVERSITY,1,0,2002,NA,NA,3014,1810,1204,711,237,474,0.26,0.2,0.24,2716,510,807,1893
234030,VIRGINIA COMMONWEALTH UNIVERSITY,1,0,2003,NA,NA,3230,1912,1318,779,218,561,0.29,0.17,0.24,3600,499,809,2006
234030,VIRGINIA COMMONWEALTH UNIVERSITY,1,0,2004,NA,NA,3271,1960,1311,749,220,529,0.26,0.17,0.23,3780,518,834,2051
234030,Virginia Commonwealth University,1,0,2005,NA,NA,3432,2052,1380,904,306,598,0.29,0.22,0.26,4012,579,868,1937
234030,Virginia Commonwealth University,1,0,2006,NA,NA,3445,1986,1459,1018,346,672,0.33,0.24,0.3,4270,656,899,1811
234030,Virginia Commonwealth University,1,0,2007,NA,NA,3802,2159,1643,1129,405,724,0.33,0.25,0.3,4525,706,1085,1942
234030,Virginia Commonwealth University,1,0,2008,NA,NA,3640,2128,1512,1227,429,798,0.37,0.28,0.34,4992,747,1119,1858
234030,Virginia Commonwealth University,1,0,2009,NA,NA,3588,2094,1494,1318,475,843,0.4,0.32,0.37,5253,794,1096,1814
234030,Virginia Commonwealth University,1,0,2010,NA,NA,3533,2086,1447,1256,445,811,0.38,0.31,0.36,6953,787,1106,1809
234085,VIRGINIA MILITARY INSTITUTE,1,0,1991,NA,NA,351,0,351,127,127,0,NA,0.36,0.36,4325,29,91,289
234085,VIRGINIA MILITARY INSTITUTE,1,0,1992,NA,NA,349,0,349,174,174,0,NA,0.5,0.5,4640,28,94,296
234085,VIRGINIA MILITARY INSTITUTE,1,0,1993,NA,NA,278,0,278,131,131,0,NA,0.47,0.47,4940,28,94,226
234085,VIRGINIA MILITARY INSTITUTE,1,0,1995,NA,NA,335,0,335,182,182,0,NA,0.54,0.54,5820,31,100,283
234085,VIRGINIA MILITARY INSTITUTE,1,0,1996,NA,NA,339,0,339,170,170,0,NA,0.5,0.5,6050,32,101,306
234085,VIRGINIA MILITARY INSTITUTE,1,0,1997,NA,NA,394,20,374,201,188,13,0.65,0.5,0.51,6380,34,103,322
234085,VIRGINIA MILITARY INSTITUTE,1,0,1998,NA,NA,375,23,352,180,174,6,0.26,0.49,0.48,6490,37,95,322
234085,VIRGINIA MILITARY INSTITUTE,1,0,1999,NA,NA,369,24,345,194,180,14,0.58,0.52,0.53,2924,40,98,304
234085,VIRGINIA MILITARY INSTITUTE,1,0,2000,NA,NA,349,22,327,204,189,15,0.68,0.58,0.58,2924,44,101,310
234085,VIRGINIA MILITARY INSTITUTE,1,0,2001,NA,NA,372,17,355,205,196,9,0.52,0.55,0.55,2924,47,104,310
234085,VIRGINIA MILITARY INSTITUTE,1,0,2002,NA,NA,356,24,332,209,197,12,0.5,0.59,0.59,3124,43,102,310
234085,VIRGINIA MILITARY INSTITUTE,1,0,2003,NA,NA,384,36,348,246,223,23,0.63,0.64,0.64,3856,46,106,330
234085,VIRGINIA MILITARY INSTITUTE,1,0,2004,NA,NA,363,24,339,216,205,11,0.45,0.6,0.6,4050,49,111,315
234085,Virginia Military Institute,1,0,2005,NA,NA,363,40,323,209,187,22,0.55,0.58,0.58,4382,52,111,307
234085,Virginia Military Institute,1,0,2006,NA,NA,387,34,353,216,200,16,0.47000000000000003,0.57,0.56,4776,56,115,330
234085,Virginia Military Institute,1,0,2007,NA,NA,410,36,374,240,221,19,0.52,0.59,0.59,5062,60,116,334
234085,Virginia Military Institute,1,0,2008,NA,NA,391,33,358,210,192,18,0.54,0.54,0.54,5262,100,120,314
234085,Virginia Military Institute,1,0,2009,NA,NA,429,42,387,261,237,24,0.5700000000000001,0.61,0.61,5500,69,121,360
234085,Virginia Military Institute,1,0,2010,NA,NA,440,51,389,64,27,37,0.72,0.07,0.15,6024,69,117,384
234155,VIRGINIA STATE UNIVERSITY,1,0,1991,NA,NA,1161,692,469,107,12,95,0.13,0.03,0.09,2668,53,194,11
234155,VIRGINIA STATE UNIVERSITY,1,0,1992,NA,NA,911,496,415,46,11,35,0.07,0.03,0.05,2913,47,188,13
234155,VIRGINIA STATE UNIVERSITY,1,0,1993,NA,NA,695,409,286,88,33,55,0.13,0.12,0.13,3050,48,191,12
234155,VIRGINIA STATE UNIVERSITY,1,0,1995,NA,NA,734,431,303,131,35,96,0.22,0.12,0.18,3256,55,171,10
234155,VIRGINIA STATE UNIVERSITY,1,0,1996,NA,NA,782,465,317,186,47,139,0.29,0.15,0.24,3291,53,165,6
234155,VIRGINIA STATE UNIVERSITY,1,0,1997,NA,NA,865,493,372,170,48,122,0.24,0.13,0.2,3307,58,168,11
234155,VIRGINIA STATE UNIVERSITY,1,0,1998,NA,NA,871,526,345,192,48,144,0.27,0.14,0.22,3439,60,170,11
234155,VIRGINIA STATE UNIVERSITY,1,0,1999,NA,NA,937,543,394,185,48,137,0.25,0.12,0.2,1588,62,176,3
234155,VIRGINIA STATE UNIVERSITY,1,0,2000,NA,NA,885,498,387,187,45,142,0.28,0.12,0.21,1588,71,178,7
234155,VIRGINIA STATE UNIVERSITY,1,0,2001,NA,NA,1085,618,467,252,61,191,0.3,0.13,0.23,1588,84,180,9
234155,VIRGINIA STATE UNIVERSITY,1,0,2002,NA,NA,1129,650,479,237,60,177,0.27,0.13,0.21,1780,77,207,9
234155,VIRGINIA STATE UNIVERSITY,1,0,2003,NA,NA,959,563,396,240,62,178,0.31,0.16,0.25,2412,80,207,7
234155,VIRGINIA STATE UNIVERSITY,1,0,2004,NA,NA,1025,656,369,250,54,196,0.29,0.15,0.24,2150,80,214,7
234155,Virginia State University,1,0,2005,NA,NA,1176,775,401,234,48,186,0.24,0.12,0.2,2317,89,223,11
234155,Virginia State University,1,0,2006,NA,NA,869,540,329,209,54,155,0.28,0.16,0.24,3007,95,238,5
234155,Virginia State University,1,0,2007,NA,NA,1185,796,389,259,58,201,0.25,0.15,0.22,3186,108,263,9
234155,Virginia State University,1,0,2008,NA,NA,1323,832,491,302,64,238,0.28,0.13,0.23,3313,112,254,22
234155,Virginia State University,1,0,2009,NA,NA,1225,806,419,353,93,260,0.32,0.22,0.29,3584,122,247,14
234155,Virginia State University,1,0,2010,NA,NA,1282,802,480,307,64,243,0.3,0.13,0.24,3886,125,247,16
234164,VIRGINIA UNION UNIVERSITY,1,0,1991,NA,NA,382,196,186,53,9,44,0.22,0.05,0.14,6153,14,78,0
234164,VIRGINIA UNION UNIVERSITY,1,0,1992,NA,NA,449,238,211,45,12,33,0.13,0.06,0.1,6557,16,76,0
234164,VIRGINIA UNION UNIVERSITY,1,0,1993,NA,NA,435,240,195,49,15,34,0.14,0.08,0.11,7061,17,78,0
234164,VIRGINIA UNION UNIVERSITY,1,0,1995,NA,NA,441,234,207,2,0,2,0,0,0,8219,20,74,1
234164,VIRGINIA UNION UNIVERSITY,1,0,1996,NA,NA,380,211,169,75,16,59,0.27,0.09,0.2,8590,20,83,5
234164,VIRGINIA UNION UNIVERSITY,1,0,1997,NA,NA,304,155,149,3,1,2,0.01,0.01,0.01,8980,17,81,1
234164,VIRGINIA UNION UNIVERSITY,1,0,1998,NA,NA,313,191,122,61,15,46,0.24,0.12,0.19,9110,17,92,0
234164,VIRGINIA UNION UNIVERSITY,1,0,1999,NA,NA,268,167,101,50,8,42,0.25,0.08,0.19,8780,19,90,0
234164,VIRGINIA UNION UNIVERSITY,1,0,2000,NA,NA,456,265,191,69,16,53,0.2,0.08,0.15,8780,20,83,3
234164,VIRGINIA UNION UNIVERSITY,1,0,2001,NA,NA,534,316,218,68,12,56,0.17,0.06,0.13,9640,21,76,3
234164,VIRGINIA UNION UNIVERSITY,1,0,2002,NA,NA,437,259,178,74,14,60,0.23,0.08,0.17,16082,24,84,3
234164,VIRGINIA UNION UNIVERSITY,1,0,2003,NA,NA,512,318,194,99,16,83,0.26,0.08,0.19,10460,24,84,5
234164,VIRGINIA UNION UNIVERSITY,1,0,2004,NA,NA,431,247,184,78,17,61,0.24,0.09,0.18,11090,25,74,4
234164,Virginia Union University,1,0,2005,NA,NA,356,197,159,57,14,43,0.21,0.09,0.16,11600,24,74,4
234164,Virginia Union University,1,0,2006,NA,NA,325,160,165,58,13,45,0.28,0.08,0.18,11948,23,85,1
234164,Virginia Union University,1,0,2007,NA,NA,375,209,166,81,17,64,0.3,0.1,0.22,12188,23,74,2
234164,Virginia Union University,1,0,2008,NA,NA,345,170,175,48,20,28,0.16,0.11,0.14,12432,25,62,0
234164,Virginia Union University,1,0,2009,NA,NA,554,303,251,99,34,65,0.21,0.14,0.18,12680,25,87,0
234164,Virginia Union University,1,0,2010,NA,NA,460,260,200,76,26,50,0.19,0.13,0.17,13314,29,88,0
235097,EASTERN WASHINGTON UNIVERSITY,0,1,1991,Inf,0,730,421,309,114,40,74,0.17,0.13,0.16,1698,78,358,611
235097,EASTERN WASHINGTON UNIVERSITY,0,1,1992,Inf,0,753,480,273,124,38,86,0.17,0.14,0.16,1785,82,363,615
235097,EASTERN WASHINGTON UNIVERSITY,0,1,1993,Inf,0,725,424,301,131,45,86,0.2,0.15,0.18,2091,88,348,581
235097,EASTERN WASHINGTON UNIVERSITY,0,1,1995,Inf,0,687,464,223,109,18,91,0.19,0.08,0.16,2463,90,389,546
235097,EASTERN WASHINGTON UNIVERSITY,0,1,1996,Inf,0,639,399,240,114,29,85,0.21,0.12,0.18,2445,93,381,506
235097,EASTERN WASHINGTON UNIVERSITY,0,1,1997,Inf,0,624,367,257,86,21,65,0.17,0.08,0.14,2520,93,349,512
235097,EASTERN WASHINGTON UNIVERSITY,0,1,1998,Inf,0,816,486,330,148,34,114,0.23,0.1,0.18,2622,95,348,637
235097,EASTERN WASHINGTON UNIVERSITY,0,1,1999,Inf,0,1072,652,420,164,45,119,0.18,0.11,0.15,2700,100,346,851
235097,EASTERN WASHINGTON UNIVERSITY,0,1,2000,Inf,0,1085,642,443,227,64,163,0.25,0.14,0.21,2790,110,349,876
235097,EASTERN WASHINGTON UNIVERSITY,0,1,2001,Inf,0,1179,694,485,256,98,158,0.22,0.2,0.22,2964,119,352,939
235097,EASTERN WASHINGTON UNIVERSITY,0,1,2002,Inf,0,1265,768,497,274,84,190,0.24,0.17,0.22,3357,121,356,1003
235097,EASTERN WASHINGTON UNIVERSITY,0,1,2003,Inf,0,1374,843,531,295,81,214,0.25,0.15,0.21,3582,136,371,948
235097,EASTERN WASHINGTON UNIVERSITY,0,1,2004,Inf,0,1403,813,590,297,102,195,0.23,0.17,0.21,3822,136,396,999
235097,Eastern Washington University,0,1,2005,Inf,0,1610,992,618,340,120,220,0.22,0.19,0.21,4044,144,411,1124
235097,Eastern Washington University,0,1,2006,Inf,0,1412,855,557,280,84,196,0.22,0.15,0.2,4278,154,424,941
235097,Eastern Washington University,0,1,2007,Inf,0,1313,770,543,243,81,162,0.21,0.15,0.19,4805,168,427,897
235097,Eastern Washington University,0,1,2008,Inf,0,1488,859,629,295,110,185,0.21,0.17,0.2,4701,185,427,1019
235097,Eastern Washington University,0,1,2009,Inf,0,1459,848,611,298,98,200,0.23,0.16,0.2,5340,188,410,940
235097,Eastern Washington University,0,1,2010,Inf,0,1524,887,637,324,109,215,0.24,0.17,0.21,6063,181,410,1035
235167,EVERGREEN STATE COLLEGE,0,1,1991,Inf,0,445,263,182,173,59,114,0.43,0.32,0.39,1758,38,160,348
235167,EVERGREEN STATE COLLEGE,0,1,1992,Inf,0,399,239,160,116,39,77,0.32,0.24,0.29,1785,38,157,313
235167,EVERGREEN STATE COLLEGE,0,1,1993,Inf,0,435,253,182,158,63,95,0.37,0.35,0.36,1971,42,154,335
235167,EVERGREEN STATE COLLEGE,0,1,1995,Inf,0,536,318,218,224,88,136,0.42,0.4,0.42,2442,44,154,396
235167,EVERGREEN STATE COLLEGE,0,1,1996,Inf,0,530,308,222,200,74,126,0.4,0.33,0.38,2544,44,151,407
235167,EVERGREEN STATE COLLEGE,0,1,1997,Inf,0,494,271,223,186,71,115,0.42,0.32,0.38,2573,47,153,340
235167,EVERGREEN STATE COLLEGE,0,1,1998,Inf,0,475,280,195,185,65,120,0.42,0.33,0.39,2637,49,156,348
235167,EVERGREEN STATE COLLEGE,0,1,1999,Inf,0,456,256,200,190,69,121,0.47000000000000003,0.34,0.42,2757,52,165,323
235167,EVERGREEN STATE COLLEGE,0,1,2000,Inf,0,468,254,214,208,81,127,0.5,0.38,0.44,2856,57,162,333
235167,EVERGREEN STATE COLLEGE,0,1,2001,Inf,0,460,236,224,206,93,113,0.47000000000000003,0.42,0.45,3024,63,159,347
235167,EVERGREEN STATE COLLEGE,0,1,2002,Inf,0,486,236,250,250,133,117,0.49,0.53,0.51,3441,80,161,361
235167,EVERGREEN STATE COLLEGE,0,1,2003,Inf,0,454,246,208,193,98,95,0.38,0.47,0.43,3651,74,157,308
235167,EVERGREEN STATE COLLEGE,0,1,2004,Inf,0,479,250,229,185,87,98,0.39,0.38,0.39,3900,100,160,333
235167,The Evergreen State College,0,1,2005,Inf,0,590,296,294,243,114,129,0.43,0.39,0.41,4128,81,158,429
235167,The Evergreen State College,0,1,2006,Inf,0,577,300,277,227,103,124,0.41000000000000003,0.37,0.39,4371,86,158,414
235167,The Evergreen State College,0,1,2007,Inf,0,677,347,330,288,138,150,0.43,0.42,0.43,4590,87,158,488
235167,The Evergreen State College,0,1,2008,Inf,0,658,321,337,302,146,156,0.48,0.43,0.46,4797,90,164,498
235167,The Evergreen State College,0,1,2009,Inf,0,576,284,292,234,112,122,0.42,0.38,0.41,5412,93,169,408
235167,The Evergreen State College,0,1,2010,Inf,0,612,332,280,265,118,147,0.44,0.42,0.43,6108,94,169,431
236230,PACIFIC LUTHERAN UNIVERSITY,1,0,1991,NA,NA,489,291,198,215,63,152,0.52,0.32,0.44,11075,49,225,432
236230,PACIFIC LUTHERAN UNIVERSITY,1,0,1992,NA,NA,500,295,205,214,69,145,0.49,0.34,0.43,11968,50,225,441
236230,PACIFIC LUTHERAN UNIVERSITY,1,0,1993,NA,NA,499,269,230,228,90,138,0.51,0.39,0.46,12672,53,229,437
236230,PACIFIC LUTHERAN UNIVERSITY,1,0,1995,NA,NA,667,394,273,264,81,183,0.46,0.3,0.4,13856,59,229,571
236230,PACIFIC LUTHERAN UNIVERSITY,1,0,1996,NA,NA,610,359,251,284,97,187,0.52,0.39,0.47,14560,59,232,523
236230,PACIFIC LUTHERAN UNIVERSITY,1,0,1997,NA,NA,660,394,266,303,87,216,0.54,0.33,0.46,15316,50,231,551
236230,PACIFIC LUTHERAN UNIVERSITY,1,0,1998,NA,NA,652,414,238,272,77,195,0.47000000000000003,0.32,0.42,15680,52,229,541
236230,PACIFIC LUTHERAN UNIVERSITY,1,0,1999,NA,NA,562,370,192,241,77,164,0.44,0.4,0.43,16224,57,234,455
236230,PACIFIC LUTHERAN UNIVERSITY,1,0,2000,NA,NA,580,355,225,293,94,199,0.56,0.42,0.51,16800,59,230,495
236230,PACIFIC LUTHERAN UNIVERSITY,1,0,2001,NA,NA,578,348,230,287,89,198,0.56,0.39,0.5,17728,63,226,483
236230,PACIFIC LUTHERAN UNIVERSITY,1,0,2002,NA,NA,625,400,225,325,98,227,0.56,0.44,0.52,18500,67,214,508
236230,PACIFIC LUTHERAN UNIVERSITY,1,0,2003,NA,NA,693,426,267,361,118,243,0.5700000000000001,0.44,0.52,19610,68,228,556
236230,PACIFIC LUTHERAN UNIVERSITY,1,0,2004,NA,NA,697,462,235,327,96,231,0.5,0.41,0.47,20790,71,237,540
236230,Pacific Lutheran University,1,0,2005,NA,NA,687,432,255,340,106,234,0.54,0.42,0.49,22040,76,202,550
236230,Pacific Lutheran University,1,0,2006,NA,NA,668,418,250,401,142,259,0.61,0.57,0.6,23450,83,220,517
236230,Pacific Lutheran University,1,0,2007,NA,NA,714,453,261,394,134,260,0.5700000000000001,0.51,0.55,25088,85,235,533
236230,Pacific Lutheran University,1,0,2008,NA,NA,712,444,268,372,115,257,0.5700000000000001,0.43,0.52,26800,91,211,553
236230,Pacific Lutheran University,1,0,2009,NA,NA,712,436,276,373,123,250,0.5700000000000001,0.45,0.52,28100,94,206,557
236230,Pacific Lutheran University,1,0,2010,NA,NA,687,415,272,398,141,257,0.61,0.52,0.58,29200,94,209,512
236328,UNIVERSITY OF PUGET SOUND,1,0,1991,NA,NA,696,395,301,401,162,239,0.6,0.54,0.58,12690,61,173,531
236328,UNIVERSITY OF PUGET SOUND,1,0,1992,NA,NA,725,446,279,433,166,267,0.59,0.59,0.6,13780,67,173,557
236328,UNIVERSITY OF PUGET SOUND,1,0,1993,NA,NA,687,402,285,402,159,243,0.6,0.56,0.59,15220,71,175,518
236328,UNIVERSITY OF PUGET SOUND,1,0,1995,NA,NA,656,374,282,404,162,242,0.64,0.57,0.62,17310,68,178,494
236328,UNIVERSITY OF PUGET SOUND,1,0,1996,NA,NA,740,445,295,459,171,288,0.64,0.58,0.62,18030,75,177,525
236328,UNIVERSITY OF PUGET SOUND,1,0,1997,NA,NA,642,390,252,430,155,275,0.7000000000000001,0.62,0.67,18940,57,178,492
236328,UNIVERSITY OF PUGET SOUND,1,0,1998,NA,NA,680,417,263,446,151,295,0.7000000000000001,0.57,0.66,19795,58,181,525
236328,UNIVERSITY OF PUGET SOUND,1,0,1999,NA,NA,682,413,269,443,170,273,0.66,0.63,0.65,20450,60,211,528
236328,UNIVERSITY OF PUGET SOUND,1,0,2000,NA,NA,647,408,239,442,155,287,0.7000000000000001,0.65,0.68,21270,63,215,474
236328,UNIVERSITY OF PUGET SOUND,1,0,2001,NA,NA,702,423,279,477,182,295,0.6900000000000001,0.65,0.68,22350,66,220,562
236328,UNIVERSITY OF PUGET SOUND,1,0,2002,NA,NA,666,399,267,459,173,286,0.71,0.65,0.69,23780,69,218,531
236328,UNIVERSITY OF PUGET SOUND,1,0,2003,NA,NA,639,358,281,438,164,274,0.76,0.58,0.69,25190,65,235,483
236328,UNIVERSITY OF PUGET SOUND,1,0,2004,NA,NA,671,390,281,471,190,281,0.72,0.68,0.7,26700,77,232,513
236328,University of Puget Sound,1,0,2005,NA,NA,669,385,284,446,180,266,0.6900000000000001,0.63,0.67,28270,79,237,497
236328,University of Puget Sound,1,0,2006,NA,NA,677,406,271,464,173,291,0.71,0.64,0.69,29870,82,238,522
236328,University of Puget Sound,1,0,2007,NA,NA,641,393,248,437,157,280,0.71,0.63,0.68,31700,87,238,473
236328,University of Puget Sound,1,0,2008,NA,NA,676,377,299,459,187,272,0.72,0.63,0.68,33780,94,236,540
236328,University of Puget Sound,1,0,2009,NA,NA,719,419,300,517,198,319,0.76,0.66,0.72,35440,99,230,547
236328,University of Puget Sound,1,0,2010,NA,NA,625,355,270,436,168,268,0.75,0.62,0.7,37030,100,233,495
236577,SEATTLE PACIFIC UNIVERSITY,0,1,1991,Inf,0,370,253,117,95,27,68,0.26,0.23,0.26,10581,41,141,311
236577,SEATTLE PACIFIC UNIVERSITY,0,1,1992,Inf,0,380,253,127,103,24,79,0.31,0.19,0.27,11301,42,144,316
236577,SEATTLE PACIFIC UNIVERSITY,0,1,1993,Inf,0,395,263,132,117,42,75,0.28,0.32,0.3,11979,45,144,346
236577,SEATTLE PACIFIC UNIVERSITY,0,1,1995,Inf,0,397,254,143,138,58,80,0.31,0.41,0.35,13479,51,138,340
236577,SEATTLE PACIFIC UNIVERSITY,0,1,1996,Inf,0,465,323,142,173,52,121,0.37,0.37,0.37,13680,53,140,421
236577,SEATTLE PACIFIC UNIVERSITY,0,1,1997,Inf,0,584,392,192,233,63,170,0.43,0.33,0.4,14130,43,138,496
236577,SEATTLE PACIFIC UNIVERSITY,0,1,1998,Inf,0,582,376,206,232,75,157,0.41000000000000003,0.36,0.4,14541,43,145,506
236577,SEATTLE PACIFIC UNIVERSITY,0,1,1999,Inf,0,567,392,175,272,79,193,0.49,0.45,0.48,14924,46,152,490
236577,SEATTLE PACIFIC UNIVERSITY,0,1,2000,Inf,0,612,413,199,293,90,203,0.49,0.45,0.48,15381,50,162,532
236577,SEATTLE PACIFIC UNIVERSITY,0,1,2001,Inf,0,645,433,212,327,95,232,0.53,0.45,0.51,16335,55,173,565
236577,SEATTLE PACIFIC UNIVERSITY,0,1,2002,Inf,0,601,412,189,302,94,208,0.5,0.5,0.5,17592,59,168,519
236577,SEATTLE PACIFIC UNIVERSITY,0,1,2003,Inf,0,683,485,198,410,105,305,0.62,0.53,0.6,18822,65,169,599
236577,SEATTLE PACIFIC UNIVERSITY,0,1,2004,Inf,0,633,414,219,341,115,226,0.54,0.53,0.54,20139,69,177,497
236577,Seattle Pacific University,0,1,2005,Inf,0,710,490,220,425,123,302,0.61,0.56,0.6,21447,71,178,596
236577,Seattle Pacific University,0,1,2006,Inf,0,622,413,209,350,111,239,0.5700000000000001,0.53,0.56,23055,74,183,514
236577,Seattle Pacific University,0,1,2007,Inf,0,716,499,217,390,110,280,0.56,0.51,0.54,24783,77,187,548
236577,Seattle Pacific University,0,1,2008,Inf,0,712,492,220,431,122,309,0.62,0.55,0.61,26457,87,190,563
236577,Seattle Pacific University,0,1,2009,Inf,0,682,489,193,361,93,268,0.54,0.48,0.53,27450,85,195,484
236577,Seattle Pacific University,0,1,2010,Inf,0,726,501,225,405,120,285,0.56,0.53,0.56,28602,87,201,549
236595,SEATTLE UNIVERSITY,0,1,1991,Inf,0,390,229,161,133,51,82,0.35000000000000003,0.32,0.34,10710,52,186,218
236595,SEATTLE UNIVERSITY,0,1,1992,Inf,0,439,236,203,161,74,87,0.36,0.36,0.37,11520,61,211,231
236595,SEATTLE UNIVERSITY,0,1,1993,Inf,0,489,276,213,165,61,104,0.37,0.29,0.34,12150,67,237,309
236595,SEATTLE UNIVERSITY,0,1,1995,Inf,0,426,245,181,165,56,109,0.44,0.31,0.39,13635,89,293,235
236595,SEATTLE UNIVERSITY,0,1,1996,Inf,0,576,358,218,245,78,167,0.46,0.36,0.43,14265,93,288,319
236595,SEATTLE UNIVERSITY,0,1,1997,Inf,0,499,288,211,220,78,142,0.49,0.37,0.44,14805,79,288,278
236595,SEATTLE UNIVERSITY,0,1,1998,Inf,0,626,369,257,287,114,173,0.46,0.44,0.46,15255,82,303,335
236595,SEATTLE UNIVERSITY,0,1,1999,Inf,0,578,351,227,256,92,164,0.46,0.41,0.44,16110,85,311,300
236595,SEATTLE UNIVERSITY,0,1,2000,Inf,0,664,428,236,338,104,234,0.54,0.44,0.51,17010,90,321,353
236595,SEATTLE UNIVERSITY,0,1,2001,Inf,0,643,412,231,321,101,220,0.53,0.44,0.5,17865,98,331,358
236595,SEATTLE UNIVERSITY,0,1,2002,Inf,0,633,387,246,324,110,214,0.55,0.45,0.51,18885,108,312,341
236595,SEATTLE UNIVERSITY,0,1,2003,Inf,0,619,418,201,323,75,248,0.59,0.37,0.52,20070,115,312,330
236595,SEATTLE UNIVERSITY,0,1,2004,Inf,0,719,447,272,407,138,269,0.6,0.51,0.57,21285,126,354,404
236595,Seattle University,0,1,2005,Inf,0,739,454,285,422,156,266,0.58,0.55,0.57,22905,134,355,425
236595,Seattle University,0,1,2006,Inf,0,731,463,268,455,165,290,0.62,0.62,0.62,24615,146,360,394
236595,Seattle University,0,1,2007,Inf,0,736,479,257,432,127,305,0.63,0.49,0.59,26325,157,406,399
236595,Seattle University,0,1,2008,Inf,0,881,557,324,530,170,360,0.64,0.52,0.6,28260,166,413,522
236595,Seattle University,0,1,2009,Inf,0,730,459,271,468,156,312,0.67,0.58,0.64,29340,173,393,375
236595,Seattle University,0,1,2010,Inf,0,1037,660,377,667,232,435,0.65,0.62,0.64,30825,175,423,566
236896,WALLA WALLA COLLEGE,0,1,1991,Inf,0,282,132,150,55,26,29,0.21,0.17,0.2,9089,22,107,231
236896,WALLA WALLA COLLEGE,0,1,1992,Inf,0,267,126,141,58,27,31,0.24,0.19,0.22,9666,24,112,205
236896,WALLA WALLA COLLEGE,0,1,1993,Inf,0,263,138,125,70,29,41,0.29,0.23,0.27,10200,25,117,219
236896,WALLA WALLA COLLEGE,0,1,1995,Inf,0,288,145,143,57,22,35,0.24,0.15,0.2,12140,26,121,262
236896,WALLA WALLA COLLEGE,0,1,1996,Inf,0,292,144,148,40,18,22,0.15,0.12,0.14,12033,30,125,263
236896,WALLA WALLA COLLEGE,0,1,1997,Inf,0,283,142,141,62,29,33,0.23,0.21,0.22,12588,31,135,244
236896,WALLA WALLA COLLEGE,0,1,1998,Inf,0,305,165,140,60,27,33,0.2,0.19,0.2,13854,27,135,274
236896,WALLA WALLA COLLEGE,0,1,1999,Inf,0,323,158,165,64,28,36,0.22,0.17,0.2,14601,27,128,275
236896,WALLA WALLA COLLEGE,0,1,2000,Inf,0,338,160,178,62,25,37,0.23,0.14,0.18,15303,30,132,289
236896,WALLA WALLA COLLEGE,0,1,2001,Inf,0,285,149,136,63,26,37,0.24,0.19,0.22,16107,32,137,248
236896,WALLA WALLA COLLEGE,0,1,2002,Inf,0,336,172,164,61,29,32,0.18,0.18,0.18,16134,33,133,282
236896,WALLA WALLA COLLEGE,0,1,2003,Inf,0,326,157,169,66,31,35,0.22,0.18,0.2,16860,35,135,265
236896,WALLA WALLA COLLEGE,0,1,2004,Inf,0,352,173,179,83,33,50,0.28,0.18,0.24,17655,39,140,279
236896,Walla Walla College,0,1,2005,Inf,0,292,132,160,62,34,28,0.21,0.21,0.21,18696,38,138,229
236896,Walla Walla College,0,1,2006,Inf,0,323,164,159,62,28,34,0.2,0.18,0.19,19725,40,133,238
236896,Walla Walla University,0,1,2007,Inf,0,344,162,182,58,25,33,0.2,0.14,0.17,20910,42,126,263
236896,Walla Walla University,0,1,2008,Inf,0,310,158,152,63,24,39,0.24,0.16,0.2,21726,43,127,224
236896,Walla Walla University,0,1,2009,Inf,0,316,157,159,59,20,39,0.24,0.13,0.19,22575,44,118,241
236896,Walla Walla University,0,1,2010,Inf,0,305,151,154,72,35,37,0.24,0.23,0.24,23229,43,119,243
236939,WASHINGTON STATE UNIVERSITY,1,0,1991,NA,NA,1852,982,870,470,171,299,0.3,0.2,0.25,2178,347,973,1544
236939,WASHINGTON STATE UNIVERSITY,1,0,1992,NA,NA,2027,1019,1008,527,212,315,0.3,0.21,0.26,2254,360,962,1703
236939,WASHINGTON STATE UNIVERSITY,1,0,1993,NA,NA,2431,1234,1197,644,235,409,0.33,0.2,0.26,2532,374,965,2000
236939,WASHINGTON STATE UNIVERSITY,1,0,1995,NA,NA,2512,1217,1295,734,315,419,0.34,0.24,0.29,3022,408,983,2022
236939,WASHINGTON STATE UNIVERSITY,1,0,1996,NA,NA,2272,1169,1103,694,263,431,0.36,0.24,0.31,3142,438,1004,1828
236939,WASHINGTON STATE UNIVERSITY,1,0,1997,NA,NA,2276,1191,1085,657,235,422,0.35000000000000003,0.22,0.29,3266,454,1000,1791
236939,WASHINGTON STATE UNIVERSITY,1,0,1998,NA,NA,2934,1526,1408,888,335,553,0.36,0.24,0.3,3396,467,1006,2353
236939,WASHINGTON STATE UNIVERSITY,1,0,1999,NA,NA,2456,1276,1180,791,306,485,0.38,0.26,0.32,3233,472,980,2042
236939,WASHINGTON STATE UNIVERSITY,1,0,2000,NA,NA,2440,1257,1183,794,277,517,0.41000000000000003,0.23,0.33,3351,497,985,1982
236939,WASHINGTON STATE UNIVERSITY,1,0,2001,NA,NA,2575,1369,1206,852,314,538,0.39,0.26,0.33,3574,542,991,2044
236939,WASHINGTON STATE UNIVERSITY,1,0,2002,NA,NA,2771,1469,1302,1018,372,646,0.43,0.29,0.37,4145,606,1013,2139
236939,WASHINGTON STATE UNIVERSITY,1,0,2003,NA,NA,2997,1613,1384,1204,417,787,0.48,0.3,0.4,4435,615,1018,2355
236939,WASHINGTON STATE UNIVERSITY,1,0,2004,NA,NA,3089,1622,1467,1251,495,756,0.46,0.34,0.4,4745,642,1016,2398
236939,Washington State University,1,0,2005,NA,NA,2855,1418,1437,1072,413,659,0.46,0.29,0.38,5077,679,1028,2301
236939,Washington State University,1,0,2006,NA,NA,2676,1349,1327,1040,417,623,0.46,0.31,0.39,5432,714,1049,2108
236939,Washington State University,1,0,2007,NA,NA,3184,1588,1596,1275,508,767,0.48,0.32,0.4,5812,744,1118,2468
236939,Washington State University,1,0,2008,NA,NA,3391,1744,1647,1408,536,872,0.5,0.33,0.42,6218,831,1215,2610
236939,Washington State University,1,0,2009,NA,NA,3627,1888,1739,1366,549,817,0.43,0.32,0.38,7088,841,1166,2665
236939,Washington State University,1,0,2010,NA,NA,3241,1634,1607,1327,525,802,0.49,0.33,0.41,8080,845,1182,2276
236948,UNIVERSITY OF WASHINGTON,0,1,1991,Inf,0,3484,1788,1696,1287,482,805,0.45,0.28,0.37,2178,1065,1890,2295
236948,UNIVERSITY OF WASHINGTON,0,1,1992,Inf,0,3509,1769,1740,1315,517,798,0.45,0.3,0.37,2253,1135,1883,2282
236948,UNIVERSITY OF WASHINGTON,0,1,1993,Inf,0,3206,1576,1630,1217,515,702,0.44,0.32,0.38,2532,1259,1906,2084
236948,UNIVERSITY OF WASHINGTON,0,1,1995,Inf,0,3500,1783,1717,1405,562,843,0.47000000000000003,0.33,0.4,3019,1408,1855,2182
236948,UNIVERSITY OF WASHINGTON,0,1,1996,Inf,0,3789,1964,1825,1613,648,965,0.49,0.36,0.43,3250,1458,1858,2227
236948,UNIVERSITY OF WASHINGTON,0,1,1997,Inf,0,4346,2270,2076,1734,667,1067,0.47000000000000003,0.32,0.4,3366,1528,1861,2438
236948,UNIVERSITY OF WASHINGTON,0,1,1998,Inf,0,4038,2076,1962,1716,718,998,0.48,0.37,0.42,3495,1626,1900,2172
236948,UNIVERSITY OF WASHINGTON-SEATTLE CAMPUS,0,1,1999,Inf,0,4319,2279,2040,1977,790,1187,0.52,0.39,0.46,3251,1825,1930,2303
236948,UNIVERSITY OF WASHINGTON-SEATTLE CAMPUS,0,1,2000,Inf,0,4765,2495,2270,2271,926,1345,0.53,0.41,0.48,3638,1956,2684,2632
236948,UNIVERSITY OF WASHINGTON-SEATTLE CAMPUS,0,1,2001,Inf,0,5288,2737,2551,2555,1099,1456,0.53,0.43,0.48,3593,2151,3438,2693
236948,UNIVERSITY OF WASHINGTON-SEATTLE CAMPUS,0,1,2002,Inf,0,4776,2561,2215,2450,1039,1411,0.55,0.47,0.51,4167,2276,2009,2615
236948,UNIVERSITY OF WASHINGTON-SEATTLE CAMPUS,0,1,2003,Inf,0,4948,2654,2294,2665,1106,1559,0.58,0.48,0.54,4458,2420,1768,2652
236948,UNIVERSITY OF WASHINGTON-SEATTLE CAMPUS,0,1,2004,Inf,0,4867,2639,2228,2625,1075,1550,0.58,0.48,0.54,4770,2560,1787,2614
236948,University of Washington-Seattle Campus,0,1,2005,Inf,0,4892,2622,2270,2883,1209,1674,0.63,0.53,0.59,5103,2730,1947,2641
236948,University of Washington-Seattle Campus,0,1,2006,Inf,0,5284,2800,2484,2939,1245,1694,0.6,0.5,0.56,5460,2889,1978,2845
236948,University of Washington-Seattle Campus,0,1,2007,Inf,0,5163,2771,2392,2968,1213,1755,0.63,0.51,0.57,5842,3045,1852,2697
236948,University of Washington-Seattle Campus,0,1,2008,Inf,0,5377,2896,2481,3296,1351,1945,0.67,0.54,0.61,6250,3242,1881,2762
236948,University of Washington-Seattle Campus,0,1,2009,Inf,0,5119,2795,2324,3227,1338,1889,0.67,0.58,0.63,7125,3473,1839,2400
236948,University of Washington-Seattle Campus,0,1,2010,Inf,0,5460,2917,2543,3525,1504,2021,0.6900000000000001,0.59,0.65,8122,3535,1880,2506
237011,WESTERN WASHINGTON UNIVERSITY,0,1,1991,Inf,0,1547,921,626,288,86,202,0.21,0.14,0.19,1698,94,410,1332
237011,WESTERN WASHINGTON UNIVERSITY,0,1,1992,Inf,0,1455,883,572,341,98,243,0.27,0.17,0.23,1785,103,408,1208
237011,WESTERN WASHINGTON UNIVERSITY,0,1,1993,Inf,0,1542,941,601,365,91,274,0.29,0.15,0.24,2120,110,385,1231
237011,WESTERN WASHINGTON UNIVERSITY,0,1,1995,Inf,0,1745,1105,640,457,120,337,0.3,0.19,0.26,2523,114,397,1379
237011,WESTERN WASHINGTON UNIVERSITY,0,1,1996,Inf,0,2026,1177,849,507,176,331,0.28,0.21,0.25,2613,119,414,1596
237011,WESTERN WASHINGTON UNIVERSITY,0,1,1997,Inf,0,2068,1266,802,601,176,425,0.33,0.22,0.29,2526,127,433,1606
237011,WESTERN WASHINGTON UNIVERSITY,0,1,1998,Inf,0,2104,1221,883,623,202,421,0.34,0.23,0.3,2622,136,433,1629
237011,WESTERN WASHINGTON UNIVERSITY,0,1,1999,Inf,0,2074,1264,810,623,172,451,0.35000000000000003,0.21,0.3,2737,140,443,1749
237011,WESTERN WASHINGTON UNIVERSITY,0,1,2000,Inf,0,2351,1427,924,692,212,480,0.33,0.23,0.29,2832,149,445,2013
237011,WESTERN WASHINGTON UNIVERSITY,0,1,2001,Inf,0,2205,1284,921,641,207,434,0.33,0.22,0.29,3015,161,448,1755
237011,WESTERN WASHINGTON UNIVERSITY,0,1,2002,Inf,0,2213,1290,923,761,225,536,0.41000000000000003,0.24,0.34,3408,165,455,1768
237011,WESTERN WASHINGTON UNIVERSITY,0,1,2003,Inf,0,2194,1266,928,778,233,545,0.43,0.25,0.35,3639,183,453,1789
237011,WESTERN WASHINGTON UNIVERSITY,0,1,2004,Inf,0,2425,1405,1020,876,287,589,0.41000000000000003,0.28,0.36,3885,179,457,1922
237011,Western Washington University,0,1,2005,Inf,0,2365,1364,1001,943,302,641,0.46,0.3,0.4,4113,191,489,1856
237011,Western Washington University,0,1,2006,Inf,0,2425,1397,1028,850,293,557,0.39,0.29,0.35,4356,202,485,1902
237011,Western Washington University,0,1,2007,Inf,0,2572,1484,1088,970,324,646,0.43,0.3,0.38,4568,218,520,1949
237011,Western Washington University,0,1,2008,Inf,0,2667,1560,1107,1057,328,729,0.46,0.3,0.4,4788,230,522,2018
237011,Western Washington University,0,1,2009,Inf,0,2670,1521,1149,1062,369,693,0.45,0.32,0.4,5397,236,513,2015
237011,Western Washington University,0,1,2010,Inf,0,2722,1614,1108,1077,345,732,0.45,0.31,0.4,6081,241,504,2061
237057,WHITMAN COLLEGE,1,0,1991,NA,NA,319,167,152,201,82,119,0.71,0.54,0.63,13110,26,104,269
237057,WHITMAN COLLEGE,1,0,1992,NA,NA,336,167,169,218,104,114,0.68,0.62,0.65,14360,26,99,285
237057,WHITMAN COLLEGE,1,0,1993,NA,NA,341,196,145,249,102,147,0.75,0.7,0.73,15650,30,93,289
237057,WHITMAN COLLEGE,1,0,1995,NA,NA,369,189,180,247,119,128,0.67,0.66,0.67,17630,39,100,306
237057,WHITMAN COLLEGE,1,0,1996,NA,NA,355,207,148,274,111,163,0.78,0.75,0.77,18650,39,98,295
237057,WHITMAN COLLEGE,1,0,1997,NA,NA,370,223,147,277,97,180,0.8,0.66,0.75,19580,30,102,321
237057,WHITMAN COLLEGE,1,0,1998,NA,NA,386,204,182,286,132,154,0.75,0.73,0.74,20120,32,105,337
237057,WHITMAN COLLEGE,1,0,1999,NA,NA,361,209,152,294,120,174,0.8300000000000001,0.79,0.81,20720,34,107,313
237057,WHITMAN COLLEGE,1,0,2000,NA,NA,349,220,129,278,99,179,0.81,0.77,0.8,21550,36,111,291
237057,WHITMAN COLLEGE,1,0,2001,NA,NA,362,195,167,288,126,162,0.8300000000000001,0.75,0.8,22600,37,115,273
237057,WHITMAN COLLEGE,1,0,2002,NA,NA,379,230,149,322,126,196,0.85,0.85,0.85,24070,40,129,274
237057,WHITMAN COLLEGE,1,0,2003,NA,NA,362,182,180,294,144,150,0.8200000000000001,0.8,0.81,25400,44,136,236
237057,WHITMAN COLLEGE,1,0,2004,NA,NA,385,222,163,308,124,184,0.8200000000000001,0.76,0.8,26870,47,124,259
237057,Whitman College,1,0,2005,NA,NA,360,180,180,288,140,148,0.8200000000000001,0.78,0.8,28400,49,140,231
237057,Whitman College,1,0,2006,NA,NA,367,219,148,294,109,185,0.84,0.74,0.8,30530,51,150,241
237057,Whitman College,1,0,2007,NA,NA,400,239,161,319,124,195,0.81,0.77,0.8,32670,54,144,269
237057,Whitman College,1,0,2008,NA,NA,401,230,171,328,130,198,0.86,0.76,0.82,34880,57,152,276
237057,Whitman College,1,0,2009,NA,NA,395,238,157,314,117,197,0.8200000000000001,0.75,0.79,36620,63,140,275
237057,Whitman College,1,0,2010,NA,NA,415,237,178,345,141,204,0.86,0.79,0.83,38450,61,149,283
237066,WHITWORTH COLLEGE,1,0,1991,NA,NA,240,141,99,94,29,65,0.46,0.29,0.39,10300,19,70,203
237066,WHITWORTH COLLEGE,1,0,1992,NA,NA,266,151,115,113,44,69,0.45,0.38,0.42,11029,19,80,218
237066,WHITWORTH COLLEGE,1,0,1993,NA,NA,361,206,155,160,59,101,0.49,0.38,0.44,11965,19,93,305
237066,WHITWORTH COLLEGE,1,0,1995,NA,NA,395,229,166,198,73,125,0.54,0.44,0.5,13410,28,87,331
237066,WHITWORTH COLLEGE,1,0,1996,NA,NA,315,193,122,177,56,121,0.62,0.46,0.56,14100,31,89,252
237066,WHITWORTH COLLEGE,1,0,1997,NA,NA,398,212,186,226,103,123,0.58,0.55,0.57,14750,25,84,345
237066,WHITWORTH COLLEGE,1,0,1998,NA,NA,373,224,149,197,74,123,0.54,0.5,0.53,15370,26,82,313
237066,WHITWORTH COLLEGE,1,0,1999,NA,NA,406,266,140,233,74,159,0.59,0.53,0.57,15970,29,83,358
237066,WHITWORTH COLLEGE,1,0,2000,NA,NA,402,234,168,242,86,156,0.66,0.51,0.6,16700,30,93,354
237066,WHITWORTH COLLEGE,1,0,2001,NA,NA,427,265,162,251,88,163,0.61,0.54,0.59,17800,32,104,396
237066,WHITWORTH COLLEGE,1,0,2002,NA,NA,433,232,201,261,107,154,0.66,0.53,0.6,18550,35,112,373
237066,WHITWORTH COLLEGE,1,0,2003,NA,NA,438,259,179,267,105,162,0.62,0.59,0.61,19810,37,119,364
237066,WHITWORTH COLLEGE,1,0,2004,NA,NA,469,266,203,308,127,181,0.68,0.63,0.66,20980,40,119,406
237066,Whitworth College,1,0,2005,NA,NA,451,266,185,304,125,179,0.67,0.68,0.67,22400,42,120,383
237066,Whitworth College,1,0,2006,NA,NA,469,285,184,303,115,188,0.65,0.62,0.65,23850,45,124,408
237066,Whitworth University,1,0,2007,NA,NA,532,293,239,347,141,206,0.7000000000000001,0.59,0.65,25382,49,127,456
237066,Whitworth University,1,0,2008,NA,NA,545,289,256,354,149,205,0.7000000000000001,0.58,0.65,27100,53,133,458
237066,Whitworth University,1,0,2009,NA,NA,555,324,231,354,145,209,0.64,0.63,0.64,28320,58,140,457
237066,Whitworth University,1,0,2010,NA,NA,683,403,280,430,161,269,0.66,0.58,0.63,29890,60,162,542
237215,BLUEFIELD STATE COLLEGE,1,0,1991,NA,NA,305,163,142,9,2,7,0.04,0.01,0.03,1454,11,92,280
237215,BLUEFIELD STATE COLLEGE,1,0,1992,NA,NA,371,192,179,9,4,5,0.02,0.02,0.02,1729,12,93,336
237215,BLUEFIELD STATE COLLEGE,1,0,1993,NA,NA,358,215,143,10,5,5,0.02,0.03,0.03,1832,13,91,312
237215,BLUEFIELD STATE COLLEGE,1,0,1995,NA,NA,416,243,173,8,5,3,0.01,0.03,0.02,1916,12,84,387
237215,BLUEFIELD STATE COLLEGE,1,0,1996,NA,NA,384,207,177,4,1,3,0.01,0.01,0.01,2000,15,77,368
237215,BLUEFIELD STATE COLLEGE,1,0,1997,NA,NA,423,237,186,6,0,6,0.02,0,0.01,2044,17,77,391
237215,BLUEFIELD STATE COLLEGE,1,0,1998,NA,NA,426,215,211,7,4,3,0.01,0.02,0.02,2110,17,79,382
237215,BLUEFIELD STATE COLLEGE,1,0,1999,NA,NA,370,225,145,8,3,5,0.02,0.02,0.02,1140,19,80,342
237215,BLUEFIELD STATE COLLEGE,1,0,2000,NA,NA,443,254,189,30,14,16,0.06,0.07,0.07,2288,20,80,401
237215,BLUEFIELD STATE COLLEGE,1,0,2001,NA,NA,380,233,147,3,1,2,0,0.01,0.01,2288,22,80,343
237215,BLUEFIELD STATE COLLEGE,1,0,2002,NA,NA,499,265,234,2,2,0,0,0.01,0,2598,20,85,454
237215,BLUEFIELD STATE COLLEGE,1,0,2003,NA,NA,273,155,118,15,7,8,0.05,0.06,0.05,2806,22,94,251
237215,BLUEFIELD STATE COLLEGE,1,0,2004,NA,NA,244,138,106,14,8,6,0.04,0.08,0.06,3114,26,99,211
237215,Bluefield State College,1,0,2005,NA,NA,246,133,113,5,3,2,0.01,0.03,0.02,3410,20,75,219
237215,Bluefield State College,1,0,2006,NA,NA,253,134,119,28,19,9,0.06,0.16,0.11,3648,20,75,211
237215,Bluefield State College,1,0,2007,NA,NA,296,167,129,18,11,7,0.04,0.09,0.06,3984,20,77,252
237215,Bluefield State College,1,0,2008,NA,NA,270,156,114,33,15,18,0.11,0.13,0.12,4272,22,74,235
237215,Bluefield State College,1,0,2009,NA,NA,304,177,127,28,18,10,0.05,0.14,0.09,4596,23,78,253
237215,Bluefield State College,1,0,2010,NA,NA,289,181,108,22,13,9,0.04,0.12,0.08,4596,23,76,254
237330,CONCORD COLLEGE,1,0,1991,NA,NA,401,229,172,87,32,55,0.24,0.19,0.22,1602,16,88,376
237330,CONCORD COLLEGE,1,0,1992,NA,NA,393,233,160,50,9,41,0.17,0.06,0.13,1736,18,91,364
237330,CONCORD COLLEGE,1,0,1993,NA,NA,487,284,203,71,25,46,0.16,0.12,0.15,1936,19,94,452
237330,CONCORD COLLEGE,1,0,1995,NA,NA,542,282,260,148,62,86,0.3,0.24,0.27,2150,19,94,494
237330,CONCORD COLLEGE,1,0,1996,NA,NA,582,301,281,107,34,73,0.24,0.12,0.18,2218,19,93,519
237330,CONCORD COLLEGE,1,0,1997,NA,NA,726,390,336,121,49,72,0.18,0.15,0.17,2310,21,100,662
237330,CONCORD COLLEGE,1,0,1998,NA,NA,545,293,252,74,30,44,0.15,0.12,0.14,2388,25,96,500
237330,CONCORD COLLEGE,1,0,1999,NA,NA,612,317,295,92,37,55,0.17,0.13,0.15,250,26,91,560
237330,CONCORD COLLEGE,1,0,2000,NA,NA,694,381,313,87,26,61,0.16,0.08,0.13,250,29,95,642
237330,CONCORD COLLEGE,1,0,2001,NA,NA,646,343,303,199,74,125,0.36,0.24,0.31,250,31,100,594
237330,CONCORD COLLEGE,1,0,2002,NA,NA,587,273,314,74,34,40,0.14,0.11,0.13,250,29,97,534
237330,CONCORD COLLEGE,1,0,2003,NA,NA,508,286,222,98,29,69,0.24,0.13,0.19,250,30,95,463
237330,CONCORD UNIVERSITY,1,0,2004,NA,NA,488,262,226,75,30,45,0.17,0.13,0.15,250,29,98,443
237330,Concord University,1,0,2005,NA,NA,639,352,287,104,35,69,0.19,0.12,0.16,250,30,94,582
237330,Concord University,1,0,2006,NA,NA,593,306,287,102,37,65,0.21,0.13,0.17,250,31,95,517
237330,Concord University,1,0,2007,NA,NA,618,335,283,115,49,66,0.19,0.17,0.19,250,31,101,554
237330,Concord University,1,0,2008,NA,NA,706,380,326,128,38,90,0.23,0.12,0.18,250,33,106,631
237330,Concord University,1,0,2009,NA,NA,607,348,259,121,44,77,0.22,0.17,0.2,4974,37,108,540
237330,Concord University,1,0,2010,NA,NA,568,288,280,105,37,68,0.23,0.13,0.18,4974,40,108,490
237358,DAVIS AND ELKINS COLLEGE,1,0,1991,NA,NA,141,80,61,13,4,9,0.11,0.07,0.09,7600,11,55,123
237358,DAVIS AND ELKINS COLLEGE,1,0,1992,NA,NA,201,108,93,49,22,27,0.25,0.24,0.24,8050,12,55,186
237358,DAVIS AND ELKINS COLLEGE,1,0,1993,NA,NA,167,100,67,24,10,14,0.14,0.15,0.14,8980,13,55,160
237358,DAVIS AND ELKINS COLLEGE,1,0,1995,NA,NA,180,101,79,35,13,22,0.21,0.16,0.19,10330,13,50,171
237358,DAVIS AND ELKINS COLLEGE,1,0,1996,NA,NA,120,66,54,27,16,11,0.16,0.3,0.22,10580,13,58,107
237358,DAVIS AND ELKINS COLLEGE,1,0,1997,NA,NA,95,54,41,6,3,3,0.05,0.07,0.06,11000,17,56,88
237358,DAVIS AND ELKINS COLLEGE,1,0,1998,NA,NA,152,87,65,66,29,37,0.42,0.45,0.43,11500,18,54,139
237358,DAVIS AND ELKINS COLLEGE,1,0,1999,NA,NA,129,72,57,34,15,19,0.26,0.26,0.26,12080,17,47,115
237358,DAVIS AND ELKINS COLLEGE,1,0,2000,NA,NA,133,76,57,39,18,21,0.27,0.32,0.29,12624,18,46,116
237358,DAVIS AND ELKINS COLLEGE,1,0,2001,NA,NA,123,71,52,31,13,18,0.25,0.25,0.25,13224,18,45,105
237358,DAVIS AND ELKINS COLLEGE,1,0,2002,NA,NA,122,68,54,29,18,11,0.16,0.33,0.24,13700,17,46,103
237358,DAVIS AND ELKINS COLLEGE,1,0,2003,NA,NA,104,60,44,27,8,19,0.31,0.18,0.26,14248,17,45,84
237358,DAVIS AND ELKINS COLLEGE,1,0,2004,NA,NA,142,77,65,57,26,31,0.4,0.4,0.4,15246,17,45,118
237358,Davis & Elkins College,1,0,2005,NA,NA,109,67,42,25,5,20,0.29,0.12,0.23,16312,14,44,93
237358,Davis & Elkins College,1,0,2006,NA,NA,119,65,54,30,14,16,0.24,0.26,0.25,17210,15,45,89
237358,Davis & Elkins College,1,0,2007,NA,NA,120,70,50,21,9,12,0.17,0.18,0.17,18226,15,44,87
237358,Davis & Elkins College,1,0,2008,NA,NA,129,68,61,35,19,16,0.23,0.31,0.27,19320,14,37,90
237358,Davis & Elkins College,1,0,2009,NA,NA,234,139,95,60,23,37,0.26,0.24,0.26,19170,14,39,163
237358,Davis & Elkins College,1,0,2010,NA,NA,253,149,104,64,29,35,0.23,0.28,0.25,20800,15,45,161
237367,FAIRMONT STATE COLLEGE,1,0,1991,NA,NA,1034,567,467,83,35,48,0.08,0.07,0.08,1424,27,170,898
237367,FAIRMONT STATE COLLEGE,1,0,1992,NA,NA,1107,578,529,66,18,48,0.08,0.03,0.06,1686,30,175,926
237367,FAIRMONT STATE COLLEGE,1,0,1993,NA,NA,1053,553,500,93,29,64,0.11,0.06,0.09,1800,33,182,1000
237367,FAIRMONT STATE COLLEGE,1,0,1995,NA,NA,1123,618,505,96,36,60,0.09,0.07,0.09,1858,36,190,999
237367,FAIRMONT STATE COLLEGE,1,0,1996,NA,NA,1049,570,479,119,43,76,0.13,0.09,0.11,1918,37,191,994
237367,FAIRMONT STATE COLLEGE,1,0,1997,NA,NA,540,300,240,115,45,70,0.23,0.19,0.21,2040,38,194,514
237367,FAIRMONT STATE COLLEGE,1,0,1998,NA,NA,555,311,244,93,27,66,0.21,0.11,0.17,2106,41,194,522
237367,FAIRMONT STATE COLLEGE,1,0,1999,NA,NA,534,286,248,77,28,49,0.17,0.11,0.14,2284,44,196,472
237367,FAIRMONT STATE COLLEGE,1,0,2000,NA,NA,589,333,256,87,25,62,0.18,0.1,0.15,2316,48,198,534
237367,FAIRMONT STATE COLLEGE,1,0,2001,NA,NA,568,320,248,62,18,44,0.13,0.07,0.11,2408,54,200,514
237367,FAIRMONT STATE COLLEGE,1,0,2002,NA,NA,682,377,305,80,30,50,0.13,0.1,0.12,1200,62,204,625
237367,FAIRMONT STATE COLLEGE,1,0,2003,NA,NA,631,317,314,85,31,54,0.17,0.1,0.13,3130,54,157,563
237367,FAIRMONT STATE UNIVERSITY,1,0,2004,NA,NA,602,321,281,90,27,63,0.19,0.1,0.15,3640,59,159,557
237367,Fairmont State University,1,0,2005,NA,NA,653,367,286,97,35,62,0.16,0.12,0.15,4218,45,163,606
237367,Fairmont State University,1,0,2006,NA,NA,642,345,297,84,35,49,0.14,0.12,0.13,4522,70,232,602
237367,Fairmont State University,1,0,2007,NA,NA,632,331,301,87,37,50,0.15,0.12,0.14,4814,74,236,581
237367,Fairmont State University,1,0,2008,NA,NA,755,370,385,116,52,64,0.17,0.14,0.15,5024,76,233,657
237367,Fairmont State University,1,0,2009,NA,NA,795,412,383,118,58,60,0.14,0.15,0.15,5172,79,171,712
237367,Fairmont State University,1,0,2010,NA,NA,766,393,373,103,49,54,0.13,0.13,0.13,5172,68,162,675
237792,SHEPHERD COLLEGE,1,0,1991,NA,NA,395,208,187,46,16,30,0.14,0.09,0.12,1894,18,111,373
237792,SHEPHERD COLLEGE,1,0,1992,NA,NA,490,270,220,3,0,3,0.01,0,0.01,1954,19,114,464
237792,SHEPHERD COLLEGE,1,0,1993,NA,NA,557,310,247,59,17,42,0.13,0.07,0.11,2040,20,117,521
237792,SHEPHERD COLLEGE,1,0,1995,NA,NA,598,333,265,74,20,54,0.16,0.08,0.12,2064,24,120,563
237792,SHEPHERD COLLEGE,1,0,1996,NA,NA,617,363,254,97,24,73,0.2,0.09,0.16,2160,25,119,571
237792,SHEPHERD COLLEGE,1,0,1997,NA,NA,643,341,302,111,43,68,0.19,0.14,0.17,2228,27,124,581
237792,SHEPHERD COLLEGE,1,0,1998,NA,NA,610,356,254,93,23,70,0.19,0.09,0.15,2298,27,115,559
237792,SHEPHERD COLLEGE,1,0,1999,NA,NA,674,367,307,91,25,66,0.17,0.08,0.14,250,29,112,626
237792,SHEPHERD COLLEGE,1,0,2000,NA,NA,669,378,291,101,32,69,0.18,0.11,0.15,250,32,115,612
237792,SHEPHERD COLLEGE,1,0,2001,NA,NA,647,333,314,71,27,44,0.13,0.09,0.11,250,35,118,584
237792,SHEPHERD COLLEGE,1,0,2002,NA,NA,705,378,327,92,24,68,0.17,0.07,0.13,250,40,120,632
237792,SHEPHERD COLLEGE,1,0,2003,NA,NA,768,440,328,134,48,86,0.19,0.15,0.17,250,40,124,695
237792,SHEPHERD UNIVERSITY,1,0,2004,NA,NA,774,427,347,119,44,75,0.17,0.13,0.15,250,39,126,709
237792,Shepherd University,1,0,2005,NA,NA,657,352,305,134,52,82,0.23,0.17,0.2,350,37,112,593
237792,Shepherd University,1,0,2006,NA,NA,688,395,293,135,40,95,0.24,0.14,0.2,350,43,116,618
237792,Shepherd University,1,0,2007,NA,NA,691,366,325,124,48,76,0.2,0.15,0.18,350,44,116,599
237792,Shepherd University,1,0,2008,NA,NA,698,395,303,137,42,95,0.24,0.14,0.2,350,50,119,562
237792,Shepherd University,1,0,2009,NA,NA,786,437,349,169,63,106,0.24,0.18,0.22,350,53,124,486
237792,Shepherd University,1,0,2010,NA,NA,759,436,323,191,59,132,0.3,0.18,0.25,350,56,125,649
237899,WEST VIRGINIA STATE COLLEGE,1,0,1991,NA,NA,475,227,248,15,7,8,0.03,0.03,0.03,1578,21,138,375
237899,WEST VIRGINIA STATE COLLEGE,1,0,1992,NA,NA,400,188,212,17,7,10,0.05,0.03,0.04,1712,22,140,299
237899,WEST VIRGINIA STATE COLLEGE,1,0,1993,NA,NA,634,308,326,21,8,13,0.04,0.02,0.03,1894,24,138,511
237899,WEST VIRGINIA STATE COLLEGE,1,0,1995,NA,NA,572,292,280,28,13,15,0.05,0.05,0.05,2050,24,140,474
237899,WEST VIRGINIA STATE COLLEGE,1,0,1996,NA,NA,529,254,275,28,10,18,0.07,0.04,0.05,2116,27,137,418
237899,WEST VIRGINIA STATE COLLEGE,1,0,1997,NA,NA,581,288,293,33,13,20,0.06,0.04,0.06,2184,30,131,442
237899,WEST VIRGINIA STATE COLLEGE,1,0,1998,NA,NA,551,282,269,31,13,18,0.06,0.05,0.06,2254,31,133,436
237899,WEST VIRGINIA STATE COLLEGE,1,0,1999,NA,NA,555,260,295,31,13,18,0.06,0.04,0.06,2386,33,140,437
237899,WEST VIRGINIA STATE COLLEGE,1,0,2000,NA,NA,542,277,265,19,6,13,0.04,0.02,0.04,2464,37,135,397
237899,WEST VIRGINIA STATE COLLEGE,1,0,2001,NA,NA,379,193,186,16,5,11,0.05,0.03,0.04,2562,52,131,276
237899,WEST VIRGINIA STATE COLLEGE,1,0,2002,NA,NA,351,178,173,28,8,20,0.11,0.05,0.08,2610,54,150,271
237899,WEST VIRGINIA STATE COLLEGE,1,0,2003,NA,NA,333,187,146,20,6,14,0.07,0.04,0.06,2609,44,161,252
237899,WEST VIRGINIA STATE UNIVERSITY,1,0,2004,NA,NA,331,175,156,18,8,10,0.05,0.05,0.05,3222,48,116,249
237899,West Virginia State University,1,0,2005,NA,NA,306,152,154,21,11,10,0.06,0.07,0.07,3528,47,120,227
237899,West Virginia State University,1,0,2006,NA,NA,341,170,171,24,8,16,0.09,0.05,0.07,3776,54,124,231
237899,West Virginia State University,1,0,2007,NA,NA,364,170,194,14,5,9,0.05,0.03,0.04,4136,57,129,214
237899,West Virginia State University,1,0,2008,NA,NA,302,147,155,16,5,11,0.07,0.03,0.05,4346,60,125,176
237899,West Virginia State University,1,0,2009,NA,NA,246,120,126,28,9,19,0.15,0.07,0.11,4524,49,121,163
237899,West Virginia State University,1,0,2010,NA,NA,270,128,142,26,9,17,0.13,0.06,0.1,4544,54,120,198
237932,WEST LIBERTY STATE COLLEGE,1,0,1991,NA,NA,437,227,210,75,25,50,0.22,0.12,0.17,1500,16,131,415
237932,WEST LIBERTY STATE COLLEGE,1,0,1992,NA,NA,488,263,225,104,29,75,0.28,0.13,0.21,1590,18,130,462
237932,WEST LIBERTY STATE COLLEGE,1,0,1993,NA,NA,474,238,236,85,32,53,0.22,0.14,0.18,1800,19,130,459
237932,WEST LIBERTY STATE COLLEGE,1,0,1995,NA,NA,509,273,236,108,27,81,0.29,0.11,0.21,1960,20,126,486
237932,WEST LIBERTY STATE COLLEGE,1,0,1996,NA,NA,464,250,214,77,20,57,0.22,0.09,0.17,2020,21,125,438
237932,WEST LIBERTY STATE COLLEGE,1,0,1997,NA,NA,491,257,234,77,21,56,0.21,0.09,0.16,2120,27,120,469
237932,WEST LIBERTY STATE COLLEGE,1,0,1998,NA,NA,498,268,230,96,35,61,0.22,0.15,0.19,2190,21,115,478
237932,WEST LIBERTY STATE COLLEGE,1,0,1999,NA,NA,494,245,249,96,31,65,0.26,0.12,0.19,2320,25,108,474
237932,WEST LIBERTY STATE COLLEGE,1,0,2000,NA,NA,513,275,238,91,29,62,0.22,0.12,0.18,2420,26,110,486
237932,WEST LIBERTY STATE COLLEGE,1,0,2001,NA,NA,521,298,223,99,40,59,0.19,0.18,0.19,2516,27,112,502
237932,WEST LIBERTY STATE COLLEGE,1,0,2002,NA,NA,445,253,192,107,23,84,0.33,0.12,0.24,2748,31,111,424
237932,WEST LIBERTY STATE COLLEGE,1,0,2003,NA,NA,453,248,205,69,16,53,0.21,0.08,0.15,3138,27,114,423
237932,WEST LIBERTY STATE COLLEGE,1,0,2004,NA,NA,459,238,221,92,35,57,0.23,0.16,0.2,3380,25,100,432
237932,West Liberty State College,1,0,2005,NA,NA,416,234,182,94,25,69,0.29,0.14,0.23,3686,25,100,390
237932,West Liberty State College,1,0,2006,NA,NA,476,269,207,84,28,56,0.2,0.14,0.18,3946,25,97,432
237932,West Liberty State College,1,0,2007,NA,NA,499,264,235,110,27,83,0.31,0.11,0.22,4172,27,99,460
237932,West Liberty State College,1,0,2008,NA,NA,550,299,251,96,30,66,0.22,0.12,0.17,4464,29,101,509
237932,West Liberty University,1,0,2009,NA,NA,569,340,229,130,33,97,0.28,0.14,0.23,4880,31,111,531
237932,West Liberty University,1,0,2010,NA,NA,526,285,241,103,31,72,0.25,0.13,0.2,4880,36,117,473
237969,WEST VIRGINIA WESLEYAN COLLEGE,1,0,1991,NA,NA,363,195,168,155,44,111,0.56,0.26,0.43,11830,22,78,321
237969,WEST VIRGINIA WESLEYAN COLLEGE,1,0,1992,NA,NA,467,223,244,173,72,101,0.45,0.3,0.37,12605,25,73,416
237969,WEST VIRGINIA WESLEYAN COLLEGE,1,0,1993,NA,NA,475,235,240,172,64,108,0.45,0.27,0.36,13400,27,74,424
237969,WEST VIRGINIA WESLEYAN COLLEGE,1,0,1995,NA,NA,453,240,213,200,77,123,0.51,0.36,0.44,14750,31,76,406
237969,WEST VIRGINIA WESLEYAN COLLEGE,1,0,1996,NA,NA,377,204,173,161,57,104,0.5,0.33,0.43,14975,34,75,330
237969,WEST VIRGINIA WESLEYAN COLLEGE,1,0,1997,NA,NA,480,260,220,201,72,129,0.49,0.33,0.42,15275,24,72,395
237969,WEST VIRGINIA WESLEYAN COLLEGE,1,0,1998,NA,NA,472,247,225,204,74,130,0.52,0.33,0.43,15750,24,80,423
237969,WEST VIRGINIA WESLEYAN COLLEGE,1,0,1999,NA,NA,472,261,211,211,89,122,0.46,0.42,0.45,16300,26,81,424
237969,WEST VIRGINIA WESLEYAN COLLEGE,1,0,2000,NA,NA,415,232,183,169,56,113,0.48,0.31,0.41,16800,27,82,376
237969,WEST VIRGINIA WESLEYAN COLLEGE,1,0,2001,NA,NA,400,202,198,175,65,110,0.54,0.33,0.44,17300,30,84,358
237969,WEST VIRGINIA WESLEYAN COLLEGE,1,0,2002,NA,NA,500,283,217,224,83,141,0.49,0.38,0.45,17900,26,88,450
237969,WEST VIRGINIA WESLEYAN COLLEGE,1,0,2003,NA,NA,457,257,200,197,64,133,0.51,0.32,0.43,18450,26,88,355
237969,WEST VIRGINIA WESLEYAN COLLEGE,1,0,2004,NA,NA,348,181,167,148,59,89,0.49,0.35,0.43,19450,26,85,262
237969,West Virginia Wesleyan College,1,0,2005,NA,NA,307,161,146,129,38,91,0.56,0.26,0.42,20250,25,80,251
237969,West Virginia Wesleyan College,1,0,2006,NA,NA,291,167,124,117,39,78,0.46,0.31,0.4,20250,24,72,161
237969,West Virginia Wesleyan College,1,0,2007,NA,NA,401,203,198,174,71,103,0.5,0.36,0.43,20980,24,71,288
237969,West Virginia Wesleyan College,1,0,2008,NA,NA,382,208,174,168,63,105,0.5,0.36,0.44,21030,24,76,279
237969,West Virginia Wesleyan College,1,0,2009,NA,NA,399,197,202,151,61,90,0.45,0.3,0.38,22030,25,75,312
237969,West Virginia Wesleyan College,1,0,2010,NA,NA,371,196,175,141,43,98,0.5,0.25,0.38,23130,25,78,302
238032,WEST VIRGINIA UNIVERSITY,1,0,1991,NA,NA,3307,1550,1757,796,325,471,0.3,0.18,0.24,1850,298,903,3090
238032,WEST VIRGINIA UNIVERSITY,1,0,1992,NA,NA,2978,1444,1534,766,296,470,0.32,0.19,0.26,1928,331,908,2736
238032,WEST VIRGINIA UNIVERSITY,1,0,1993,NA,NA,2806,1370,1436,658,252,406,0.29,0.18,0.23,2026,334,895,2622
238032,WEST VIRGINIA UNIVERSITY,1,0,1995,NA,NA,2938,1457,1481,783,324,459,0.31,0.22,0.27,2192,368,863,2731
238032,WEST VIRGINIA UNIVERSITY,1,0,1996,NA,NA,3065,1499,1566,817,335,482,0.32,0.21,0.27,2262,393,846,2850
238032,WEST VIRGINIA UNIVERSITY,1,0,1997,NA,NA,3079,1431,1648,794,344,450,0.31,0.21,0.26,2336,396,806,2829
238032,WEST VIRGINIA UNIVERSITY,1,0,1998,NA,NA,3335,1571,1764,818,348,470,0.29,0.2,0.25,2662,398,804,3070
238032,WEST VIRGINIA UNIVERSITY,1,0,1999,NA,NA,3523,1641,1882,885,363,522,0.31,0.19,0.25,1332,435,797,3199
238032,WEST VIRGINIA UNIVERSITY,1,0,2000,NA,NA,3480,1679,1801,889,346,543,0.32,0.19,0.26,1332,452,803,3193
238032,WEST VIRGINIA UNIVERSITY,1,0,2001,NA,NA,3593,1743,1850,928,381,547,0.31,0.21,0.26,1332,482,810,3263
238032,WEST VIRGINIA UNIVERSITY,1,0,2002,NA,NA,3917,1841,2076,1161,473,688,0.37,0.23,0.3,3240,503,796,3573
238032,WEST VIRGINIA UNIVERSITY,1,0,2003,NA,NA,4366,2104,2262,1387,583,804,0.38,0.26,0.32,3548,553,778,4070
238032,WEST VIRGINIA UNIVERSITY,1,0,2004,NA,NA,4308,2032,2276,1416,571,845,0.41000000000000003,0.25,0.33,3938,549,776,3961
238032,West Virginia University,1,0,2005,NA,NA,4524,2126,2398,1457,639,818,0.38,0.27,0.32,4164,583,785,4129
238032,West Virginia University,1,0,2006,NA,NA,4777,2151,2626,1596,746,850,0.39,0.28,0.33,4476,652,813,4354
238032,West Virginia University,1,0,2007,NA,NA,4664,2156,2508,1561,696,865,0.4,0.28,0.33,4722,690,802,4187
238032,West Virginia University,1,0,2008,NA,NA,5083,2300,2783,1656,766,890,0.38,0.28,0.33,5100,776,876,4548
238032,West Virginia University,1,0,2009,NA,NA,4555,2098,2457,1501,661,840,0.4,0.27,0.33,5304,834,968,4058
238032,West Virginia University,1,0,2010,NA,NA,5006,2290,2716,1619,755,864,0.37,0.28,0.32,5406,899,980,4312
238333,BELOIT COLLEGE,1,0,1991,NA,NA,261,147,114,135,50,85,0.5700000000000001,0.44,0.52,13050,23,83,231
238333,BELOIT COLLEGE,1,0,1992,NA,NA,306,159,147,171,68,103,0.64,0.46,0.56,14250,25,83,259
238333,BELOIT COLLEGE,1,0,1993,NA,NA,284,161,123,158,61,97,0.6,0.5,0.56,15430,27,80,234
238333,BELOIT COLLEGE,1,0,1995,NA,NA,291,163,128,187,74,113,0.6900000000000001,0.58,0.64,17544,32,83,242
238333,BELOIT COLLEGE,1,0,1996,NA,NA,284,147,137,175,76,99,0.67,0.55,0.62,18230,33,80,224
238333,BELOIT COLLEGE,1,0,1997,NA,NA,339,194,145,204,73,131,0.67,0.5,0.6,19050,27,88,275
238333,BELOIT COLLEGE,1,0,1998,NA,NA,302,180,122,166,58,108,0.6,0.48,0.55,19770,27,86,245
238333,BELOIT COLLEGE,1,0,1999,NA,NA,303,173,130,196,75,121,0.6900000000000001,0.58,0.65,20220,28,97,244
238333,BELOIT COLLEGE,1,0,2000,NA,NA,306,177,129,168,79,89,0.5,0.61,0.55,21330,30,98,255
238333,BELOIT COLLEGE,1,0,2001,NA,NA,311,189,122,234,86,148,0.78,0.7,0.75,22184,32,99,262
238333,BELOIT COLLEGE,1,0,2002,NA,NA,303,191,112,210,75,135,0.7000000000000001,0.67,0.69,23016,33,99,266
238333,BELOIT COLLEGE,1,0,2003,NA,NA,346,217,129,251,88,163,0.75,0.68,0.73,24166,35,103,307
238333,BELOIT COLLEGE,1,0,2004,NA,NA,323,176,147,218,97,121,0.68,0.66,0.67,25516,34,103,285
238333,Beloit College,1,0,2005,NA,NA,326,198,128,216,71,145,0.73,0.55,0.66,26664,37,103,277
238333,Beloit College,1,0,2006,NA,NA,347,207,140,243,94,149,0.71,0.67,0.7,28130,39,109,284
238333,Beloit College,1,0,2007,NA,NA,325,183,142,229,99,130,0.71,0.7,0.7,29678,40,127,248
238333,Beloit College,1,0,2008,NA,NA,337,182,155,240,104,136,0.74,0.67,0.71,31310,45,123,222
238333,Beloit College,1,0,2009,NA,NA,332,199,133,233,90,143,0.71,0.68,0.7,33188,48,123,242
238333,Beloit College,1,0,2010,NA,NA,333,191,142,212,89,123,0.64,0.63,0.64,34808,46,127,237
238430,CARDINAL STRITCH COLLEGE,1,0,1991,NA,NA,125,89,36,24,7,17,0.19,0.19,0.19,6960,14,51,98
238430,CARDINAL STRITCH COLLEGE,1,0,1992,NA,NA,199,133,66,20,10,10,0.07,0.15,0.1,7360,15,59,158
238430,CARDINAL STRITCH COLLEGE,1,0,1993,NA,NA,481,327,154,39,12,27,0.08,0.08,0.08,7720,17,69,375
238430,CARDINAL STRITCH COLLEGE,1,0,1995,NA,NA,139,93,46,20,3,17,0.18,0.07,0.14,8320,19,68,114
238430,CARDINAL STRITCH COLLEGE,1,0,1996,NA,NA,253,174,79,40,16,24,0.13,0.2,0.16,8960,19,80,197
238430,CARDINAL STRITCH UNIVERSITY,1,0,1997,NA,NA,226,149,77,55,19,36,0.24,0.25,0.24,10080,21,72,164
238430,CARDINAL STRITCH UNIVERSITY,1,0,1998,NA,NA,224,140,84,71,28,43,0.3,0.33,0.32,10496,23,62,159
238430,CARDINAL STRITCH UNIVERSITY,1,0,1999,NA,NA,203,132,71,28,10,18,0.13,0.14,0.14,11000,21,78,152
238430,CARDINAL STRITCH UNIVERSITY,1,0,2000,NA,NA,207,122,85,129,53,76,0.62,0.62,0.62,11680,24,88,155
238430,CARDINAL STRITCH UNIVERSITY,1,0,2001,NA,NA,296,215,81,78,29,49,0.22,0.36,0.26,12480,29,98,197
238430,CARDINAL STRITCH UNIVERSITY,1,0,2002,NA,NA,197,155,42,55,12,43,0.27,0.29,0.28,13280,33,88,137
238430,CARDINAL STRITCH UNIVERSITY,1,0,2003,NA,NA,205,136,69,28,11,17,0.12,0.16,0.14,14240,37,97,135
238430,CARDINAL STRITCH UNIVERSITY,1,0,2004,NA,NA,157,120,37,63,8,55,0.45,0.22,0.4,15360,39,97,103
238430,Cardinal Stritch University,1,0,2005,NA,NA,182,139,43,19,4,15,0.1,0.09,0.1,16130,39,93,120
238430,Cardinal Stritch University,1,0,2006,NA,NA,245,168,77,19,6,13,0.07,0.08,0.08,17600,41,98,125
238430,Cardinal Stritch University,1,0,2007,NA,NA,173,115,58,25,6,19,0.16,0.1,0.14,18624,44,98,87
238430,Cardinal Stritch University,1,0,2008,NA,NA,258,177,81,39,14,25,0.14,0.17,0.15,20000,49,95,162
238430,Cardinal Stritch University,1,0,2009,NA,NA,209,119,90,19,4,15,0.12,0.04,0.09,21280,54,103,101
238430,Cardinal Stritch University,1,0,2010,NA,NA,213,128,85,37,14,23,0.17,0.16,0.17,22240,53,105,124
238458,CARROLL COLLEGE,1,0,1991,NA,NA,275,168,107,132,35,97,0.5700000000000001,0.33,0.48,11068,25,87,250
238458,CARROLL COLLEGE,1,0,1992,NA,NA,298,193,105,93,27,66,0.34,0.26,0.31,11432,24,86,258
238458,CARROLL COLLEGE,1,0,1993,NA,NA,345,211,134,130,45,85,0.4,0.34,0.38,11790,24,70,309
238458,CARROLL COLLEGE,1,0,1995,NA,NA,429,296,133,202,41,161,0.54,0.31,0.47,12880,27,74,378
238458,CARROLL COLLEGE,1,0,1996,NA,NA,450,295,155,214,67,147,0.49,0.43,0.48,13190,29,73,401
238458,CARROLL COLLEGE,1,0,1997,NA,NA,459,287,172,232,65,167,0.58,0.38,0.51,13670,22,74,404
238458,CARROLL COLLEGE,1,0,1998,NA,NA,414,296,118,156,31,125,0.42,0.26,0.38,14200,24,85,390
238458,CARROLL COLLEGE,1,0,1999,NA,NA,482,327,155,219,63,156,0.47000000000000003,0.41,0.45,14740,26,98,446
238458,CARROLL COLLEGE,1,0,2000,NA,NA,500,334,166,220,58,162,0.48,0.35,0.44,15250,30,101,465
238458,CARROLL COLLEGE,1,0,2001,NA,NA,471,319,152,197,48,149,0.46,0.32,0.42,15860,30,104,424
238458,CARROLL COLLEGE,1,0,2002,NA,NA,529,324,205,240,70,170,0.52,0.34,0.45,16400,31,99,492
238458,CARROLL COLLEGE,1,0,2003,NA,NA,501,329,172,220,62,158,0.48,0.36,0.44,17020,31,96,468
238458,CARROLL COLLEGE,1,0,2004,NA,NA,616,405,211,234,61,173,0.42,0.29,0.38,17800,32,94,543
238458,Carroll College,1,0,2005,NA,NA,598,383,215,231,63,168,0.43,0.29,0.39,18650,34,99,530
238458,Carroll College,1,0,2006,NA,NA,675,485,190,284,58,226,0.46,0.31,0.42,19500,36,108,585
238458,Carroll College,1,0,2007,NA,NA,652,440,212,277,88,189,0.42,0.42,0.42,20400,39,117,561
238458,Carroll University,1,0,2008,NA,NA,655,447,208,263,77,186,0.41000000000000003,0.37,0.4,21410,42,113,577
238458,Carroll University,1,0,2009,NA,NA,738,482,256,311,102,209,0.43,0.4,0.42,22470,45,115,644
238458,Carroll University,1,0,2010,NA,NA,751,502,249,386,115,271,0.53,0.46,0.51,23582,50,121,654
238476,CARTHAGE COLLEGE,1,0,1991,NA,NA,401,227,174,183,65,118,0.51,0.37,0.46,10640,20,75,358
238476,CARTHAGE COLLEGE,1,0,1992,NA,NA,406,233,173,196,80,116,0.49,0.46,0.48,11525,22,76,367
238476,CARTHAGE COLLEGE,1,0,1993,NA,NA,441,227,214,216,99,117,0.51,0.46,0.49,12400,25,81,399
238476,CARTHAGE COLLEGE,1,0,1995,NA,NA,395,175,220,190,89,101,0.5700000000000001,0.4,0.48,13850,31,89,369
238476,CARTHAGE COLLEGE,1,0,1996,NA,NA,401,210,191,215,87,128,0.6,0.46,0.54,14600,33,93,383
238476,CARTHAGE COLLEGE,1,0,1997,NA,NA,395,201,194,174,75,99,0.49,0.39,0.44,15365,24,93,364
238476,CARTHAGE COLLEGE,1,0,1998,NA,NA,432,216,216,190,86,104,0.48,0.4,0.44,16060,25,93,405
238476,CARTHAGE COLLEGE,1,0,1999,NA,NA,427,216,211,190,78,112,0.51,0.37,0.44,16690,27,91,389
238476,CARTHAGE COLLEGE,1,0,2000,NA,NA,532,295,237,232,91,141,0.47000000000000003,0.38,0.44,17350,31,96,462
238476,CARTHAGE COLLEGE,1,0,2001,NA,NA,578,280,298,237,112,125,0.44,0.38,0.41,18205,31,102,478
238476,CARTHAGE COLLEGE,1,0,2002,NA,NA,618,351,267,236,84,152,0.43,0.31,0.38,19150,36,111,511
238476,CARTHAGE COLLEGE,1,0,2003,NA,NA,575,307,268,249,103,146,0.47000000000000003,0.38,0.43,20150,39,108,469
238476,CARTHAGE COLLEGE,1,0,2004,NA,NA,579,344,235,277,101,176,0.51,0.43,0.48,21250,40,116,469
238476,Carthage College,1,0,2005,NA,NA,593,315,278,281,120,161,0.51,0.43,0.47,22500,44,122,507
238476,Carthage College,1,0,2006,NA,NA,653,368,285,337,136,201,0.54,0.48,0.52,23650,44,124,538
238476,Carthage College,1,0,2007,NA,NA,683,350,333,371,145,226,0.64,0.44,0.54,25000,47,135,575
238476,Carthage College,1,0,2008,NA,NA,753,359,394,405,192,213,0.59,0.49,0.54,26500,51,145,620
238476,Carthage College,1,0,2009,NA,NA,721,351,370,359,158,201,0.5700000000000001,0.43,0.5,28250,53,145,597
238476,Carthage College,1,0,2010,NA,NA,730,384,346,398,164,234,0.6,0.47,0.55,29750,58,148,628
238616,CONCORDIA UNIVERSITY-WISCONSIN,1,0,1991,NA,NA,205,104,101,64,27,37,0.35000000000000003,0.27,0.31,7400,10,62,171
238616,CONCORDIA UNIVERSITY-WISCONSIN,1,0,1992,NA,NA,183,103,80,69,31,38,0.36,0.39,0.38,8100,13,68,158
238616,CONCORDIA UNIVERSITY-WISCONSIN,1,0,1993,NA,NA,289,139,150,81,37,44,0.31,0.25,0.28,8700,15,74,246
238616,CONCORDIA UNIVERSITY-WISCONSIN,1,0,1995,NA,NA,234,132,102,59,21,38,0.28,0.21,0.25,10000,20,86,208
238616,CONCORDIA UNIVERSITY-WISCONSIN,1,0,1996,NA,NA,254,138,116,117,44,73,0.52,0.38,0.46,10700,23,96,213
238616,CONCORDIA UNIVERSITY-WISCONSIN,1,0,1997,NA,NA,253,147,106,128,45,83,0.56,0.42,0.51,11300,20,91,237
238616,CONCORDIA UNIVERSITY-WISCONSIN,1,0,1998,NA,NA,337,187,150,126,46,80,0.42,0.31,0.37,11900,24,89,249
238616,CONCORDIA UNIVERSITY-WISCONSIN,1,0,1999,NA,NA,321,197,124,104,38,66,0.33,0.31,0.32,12400,26,95,260
238616,CONCORDIA UNIVERSITY-WISCONSIN,1,0,2000,NA,NA,285,169,116,106,43,63,0.37,0.37,0.37,12900,29,93,239
238616,CONCORDIA UNIVERSITY-WISCONSIN,1,0,2001,NA,NA,351,169,182,158,82,76,0.44,0.45,0.45,13550,30,92,218
238616,CONCORDIA UNIVERSITY-WISCONSIN,1,0,2002,NA,NA,287,139,148,96,42,54,0.38,0.28,0.33,14500,33,93,217
238616,CONCORDIA UNIVERSITY-WISCONSIN,1,0,2003,NA,NA,352,192,160,111,35,76,0.39,0.22,0.32,15590,35,92,272
238616,CONCORDIA UNIVERSITY-WISCONSIN,1,0,2004,NA,NA,363,198,165,145,57,88,0.44,0.35,0.4,16370,38,89,309
238616,Concordia University-Wisconsin,1,0,2005,NA,NA,386,207,179,134,52,82,0.39,0.29,0.35,17190,36,93,315
238616,Concordia University-Wisconsin,1,0,2006,NA,NA,391,214,177,135,53,82,0.38,0.3,0.35,18050,39,89,320
238616,Concordia University-Wisconsin,1,0,2007,NA,NA,422,232,190,143,46,97,0.41000000000000003,0.24,0.34,18950,42,95,363
238616,Concordia University-Wisconsin,1,0,2008,NA,NA,402,222,180,139,59,80,0.36,0.33,0.35,19900,46,99,330
238616,Concordia University-Wisconsin,1,0,2009,NA,NA,468,266,202,171,63,108,0.4,0.31,0.37,20900,51,110,401
238616,Concordia University-Wisconsin,1,0,2010,NA,NA,537,317,220,198,71,127,0.4,0.32,0.37,21940,54,128,436
238661,EDGEWOOD COLLEGE,1,0,1991,NA,NA,126,96,30,17,1,16,0.16,0.03,0.13,6950,7,50,105
238661,EDGEWOOD COLLEGE,1,0,1992,NA,NA,131,90,41,25,7,18,0.2,0.17,0.19,7500,9,53,98
238661,EDGEWOOD COLLEGE,1,0,1993,NA,NA,161,121,40,42,7,35,0.28,0.17,0.26,8000,11,59,127
238661,EDGEWOOD COLLEGE,1,0,1995,NA,NA,231,155,76,44,10,34,0.21,0.13,0.19,9000,14,70,178
238661,EDGEWOOD COLLEGE,1,0,1996,NA,NA,210,152,58,40,4,36,0.23,0.07,0.19,9500,15,74,141
238661,EDGEWOOD COLLEGE,1,0,1997,NA,NA,222,164,58,53,11,42,0.25,0.19,0.24,10100,15,73,151
238661,EDGEWOOD COLLEGE,1,0,1998,NA,NA,213,157,56,55,13,42,0.26,0.23,0.26,10884,14,76,134
238661,EDGEWOOD COLLEGE,1,0,1999,NA,NA,196,132,64,49,9,40,0.3,0.14,0.25,11450,15,75,108
238661,EDGEWOOD COLLEGE,1,0,2000,NA,NA,274,203,71,81,13,68,0.33,0.18,0.3,12250,17,78,128
238661,EDGEWOOD COLLEGE,1,0,2001,NA,NA,291,203,88,70,21,49,0.24,0.24,0.24,13300,19,82,145
238661,EDGEWOOD COLLEGE,1,0,2002,NA,NA,271,205,66,70,10,60,0.29,0.15,0.26,14200,21,86,237
238661,EDGEWOOD COLLEGE,1,0,2003,NA,NA,307,229,78,85,14,71,0.31,0.18,0.28,15100,23,92,260
238661,EDGEWOOD COLLEGE,1,0,2004,NA,NA,298,214,84,95,20,75,0.35000000000000003,0.24,0.32,16050,26,97,270
238661,Edgewood College,1,0,2005,NA,NA,281,210,71,77,21,56,0.26,0.3,0.27,17000,28,97,256
238661,Edgewood College,1,0,2006,NA,NA,293,220,73,101,21,80,0.36,0.29,0.34,18000,30,100,258
238661,Edgewood College,1,0,2007,NA,NA,302,202,100,98,28,70,0.34,0.28,0.32,19080,32,102,261
238661,Edgewood College,1,0,2008,NA,NA,298,219,79,108,29,79,0.36,0.37,0.36,20040,35,99,259
238661,Edgewood College,1,0,2009,NA,NA,285,213,72,110,27,83,0.38,0.38,0.39,21042,37,104,228
238661,Edgewood College,1,0,2010,NA,NA,324,243,81,130,36,94,0.38,0.44,0.4,21988,37,106,284
239080,MARIAN COLLEGE OF FOND DU LAC,1,0,1991,NA,NA,146,105,41,52,10,42,0.4,0.24,0.36,7500,10,63,141
239080,MARIAN COLLEGE OF FOND DU LAC,1,0,1992,NA,NA,190,125,65,52,14,38,0.3,0.22,0.27,8120,12,67,177
239080,MARIAN COLLEGE OF FOND DU LAC,1,0,1993,NA,NA,170,115,55,47,12,35,0.3,0.22,0.28,8650,14,71,154
239080,MARIAN COLLEGE OF FOND DU LAC,1,0,1995,NA,NA,184,117,67,44,15,29,0.24,0.22,0.24,10120,16,70,170
239080,MARIAN COLLEGE OF FOND DU LAC,1,0,1996,NA,NA,199,126,73,53,21,32,0.25,0.29,0.27,10730,17,68,189
239080,MARIAN COLLEGE OF FOND DU LAC,1,0,1997,NA,NA,208,119,89,62,16,46,0.38,0.18,0.3,11370,15,60,184
239080,MARIAN COLLEGE OF FOND DU LAC,1,0,1998,NA,NA,204,137,67,64,20,44,0.32,0.3,0.31,11785,15,60,174
239080,MARIAN COLLEGE OF FOND DU LAC,1,0,1999,NA,NA,224,156,68,71,17,54,0.34,0.25,0.32,11966,16,66,195
239080,MARIAN COLLEGE OF FOND DU LAC,1,0,2000,NA,NA,245,180,65,85,18,67,0.37,0.28,0.35,12624,22,66,212
239080,MARIAN COLLEGE OF FOND DU LAC,1,0,2001,NA,NA,227,149,78,65,18,47,0.31,0.23,0.29,13230,19,66,196
239080,MARIAN COLLEGE OF FOND DU LAC,1,0,2002,NA,NA,247,176,71,52,13,39,0.22,0.18,0.21,13880,20,71,203
239080,MARIAN COLLEGE OF FOND DU LAC,1,0,2003,NA,NA,251,170,81,72,17,55,0.32,0.21,0.29,14700,22,71,221
239080,MARIAN COLLEGE OF FOND DU LAC,1,0,2004,NA,NA,270,191,79,84,16,68,0.35000000000000003,0.2,0.31,15500,23,73,227
239080,Marian College of Fond du Lac,1,0,2005,NA,NA,262,190,72,78,17,61,0.32,0.24,0.3,16380,24,73,235
239080,Marian College of Fond du Lac,1,0,2006,NA,NA,245,172,73,61,15,46,0.26,0.21,0.25,17300,27,79,217
239080,Marian College of Fond du Lac,1,0,2007,NA,NA,266,191,75,80,8,72,0.37,0.11,0.3,18330,29,83,220
239080,Marian University-Wisconsin,1,0,2008,NA,NA,284,210,74,103,15,88,0.41000000000000003,0.2,0.36,19590,30,83,232
239080,Marian University,1,0,2009,NA,NA,316,228,88,88,19,69,0.3,0.22,0.28,20550,32,84,221
239080,Marian University,1,0,2010,NA,NA,309,219,90,92,12,80,0.36,0.13,0.3,21140,29,84,236
239105,MARQUETTE UNIVERSITY,1,0,1991,NA,NA,1598,852,746,870,349,521,0.61,0.47,0.54,9000,135,492,1366
239105,MARQUETTE UNIVERSITY,1,0,1992,NA,NA,1651,846,805,804,322,482,0.56,0.4,0.49,9900,146,485,1370
239105,MARQUETTE UNIVERSITY,1,0,1993,NA,NA,1684,895,789,880,339,541,0.6,0.43,0.52,10700,152,483,1433
239105,MARQUETTE UNIVERSITY,1,0,1995,NA,NA,1627,883,744,870,327,543,0.61,0.44,0.53,13010,179,492,1380
239105,MARQUETTE UNIVERSITY,1,0,1996,NA,NA,1420,799,621,803,303,500,0.62,0.49,0.57,14710,198,478,1191
239105,MARQUETTE UNIVERSITY,1,0,1997,NA,NA,1573,830,743,876,351,525,0.63,0.47,0.56,15160,154,481,1321
239105,MARQUETTE UNIVERSITY,1,0,1998,NA,NA,1730,952,778,960,355,605,0.63,0.46,0.55,15620,164,473,1488
239105,MARQUETTE UNIVERSITY,1,0,1999,NA,NA,1715,963,752,1064,414,650,0.67,0.55,0.62,16280,179,474,1497
239105,MARQUETTE UNIVERSITY,1,0,2000,NA,NA,1675,926,749,963,404,559,0.6,0.54,0.57,17080,189,473,1426
239105,MARQUETTE UNIVERSITY,1,0,2001,NA,NA,1658,950,708,947,374,573,0.6,0.53,0.57,18180,193,472,1410
239105,MARQUETTE UNIVERSITY,1,0,2002,NA,NA,1856,1034,822,1052,433,619,0.59,0.53,0.57,19400,205,567,1574
239105,MARQUETTE UNIVERSITY,1,0,2003,NA,NA,1882,1042,840,1125,462,663,0.63,0.55,0.6,20350,224,579,1648
239105,MARQUETTE UNIVERSITY,1,0,2004,NA,NA,1802,979,823,1118,454,664,0.67,0.55,0.62,21550,243,589,1558
239105,Marquette University,1,0,2005,NA,NA,1775,967,808,1083,448,635,0.65,0.55,0.61,22950,262,592,1488
239105,Marquette University,1,0,2006,NA,NA,1842,1025,817,1096,445,651,0.63,0.54,0.6,24670,277,600,1494
239105,Marquette University,1,0,2007,NA,NA,1811,966,845,1038,442,596,0.61,0.52,0.57,26270,290,609,1500
239105,Marquette University,1,0,2008,NA,NA,1950,1043,907,1153,481,672,0.64,0.53,0.59,27720,313,622,1630
239105,Marquette University,1,0,2009,NA,NA,1945,1005,940,1135,505,630,0.62,0.54,0.58,28680,327,627,1583
239105,Marquette University,1,0,2010,NA,NA,1929,1015,914,1161,504,657,0.64,0.55,0.6,30040,330,629,1524
239628,RIPON COLLEGE,1,0,1991,NA,NA,164,84,80,86,35,51,0.6,0.44,0.52,12900,17,71,144
239628,RIPON COLLEGE,1,0,1992,NA,NA,180,92,88,88,32,56,0.6,0.36,0.49,13170,18,70,163
239628,RIPON COLLEGE,1,0,1993,NA,NA,211,102,109,113,47,66,0.64,0.43,0.54,14340,19,69,195
239628,RIPON COLLEGE,1,0,1995,NA,NA,184,101,83,99,42,57,0.56,0.51,0.54,16110,22,59,168
239628,RIPON COLLEGE,1,0,1996,NA,NA,169,97,72,81,28,53,0.54,0.39,0.48,17000,23,61,146
239628,RIPON COLLEGE,1,0,1997,NA,NA,135,62,73,71,35,36,0.58,0.48,0.53,17580,15,58,116
239628,RIPON COLLEGE,1,0,1998,NA,NA,162,66,96,99,55,44,0.66,0.57,0.61,18240,16,60,150
239628,RIPON COLLEGE,1,0,1999,NA,NA,283,156,127,174,73,101,0.64,0.57,0.61,18000,17,61,247
239628,RIPON COLLEGE,1,0,2000,NA,NA,280,166,114,171,64,107,0.64,0.56,0.61,18000,18,59,242
239628,RIPON COLLEGE,1,0,2001,NA,NA,200,108,92,119,48,71,0.65,0.52,0.6,19260,20,57,178
239628,RIPON COLLEGE,1,0,2002,NA,NA,250,116,134,139,75,64,0.55,0.56,0.56,19260,19,48,214
239628,RIPON COLLEGE,1,0,2003,NA,NA,259,130,129,156,72,84,0.64,0.56,0.6,19700,18,51,225
239628,RIPON COLLEGE,1,0,2004,NA,NA,202,114,88,115,53,62,0.54,0.6,0.57,20490,19,49,165
239628,Ripon College,1,0,2005,NA,NA,261,119,142,148,70,78,0.65,0.49,0.57,21310,19,50,216
239628,Ripon College,1,0,2006,NA,NA,264,154,110,153,57,96,0.62,0.52,0.58,22162,21,50,229
239628,Ripon College,1,0,2007,NA,NA,262,124,138,158,78,80,0.64,0.57,0.6,23048,21,53,232
239628,Ripon College,1,0,2008,NA,NA,282,143,139,145,59,86,0.6,0.42,0.51,23970,24,56,239
239628,Ripon College,1,0,2009,NA,NA,248,123,125,148,68,80,0.65,0.54,0.6,25170,27,62,189
239628,Ripon College,1,0,2010,NA,NA,289,162,127,167,66,101,0.62,0.52,0.58,26806,28,63,253
239716,SAINT NORBERT COLLEGE,1,0,1991,NA,NA,442,262,180,288,95,193,0.73,0.53,0.65,10225,28,110,430
239716,SAINT NORBERT COLLEGE,1,0,1992,NA,NA,496,275,221,328,142,186,0.67,0.64,0.66,10805,30,110,479
239716,SAINT NORBERT COLLEGE,1,0,1993,NA,NA,569,320,249,352,142,210,0.65,0.57,0.62,11465,33,109,538
239716,SAINT NORBERT COLLEGE,1,0,1995,NA,NA,520,296,224,319,112,207,0.6900000000000001,0.5,0.61,12940,38,106,487
239716,SAINT NORBERT COLLEGE,1,0,1996,NA,NA,508,321,187,339,121,218,0.67,0.65,0.67,13700,41,108,489
239716,SAINT NORBERT COLLEGE,1,0,1997,NA,NA,480,288,192,324,121,203,0.7000000000000001,0.63,0.68,14234,34,111,447
239716,SAINT NORBERT COLLEGE,1,0,1998,NA,NA,460,247,213,282,106,176,0.71,0.5,0.61,14789,35,100,418
239716,SAINT NORBERT COLLEGE,1,0,1999,NA,NA,519,296,223,332,136,196,0.66,0.61,0.64,15600,36,100,480
239716,SAINT NORBERT COLLEGE,1,0,2000,NA,NA,548,321,227,364,128,236,0.73,0.56,0.66,16570,36,99,505
239716,SAINT NORBERT COLLEGE,1,0,2001,NA,NA,558,306,252,359,142,217,0.7000000000000001,0.56,0.64,17757,39,98,514
239716,SAINT NORBERT COLLEGE,1,0,2002,NA,NA,495,273,222,345,134,211,0.77,0.6,0.7,18834,42,103,457
239716,SAINT NORBERT COLLEGE,1,0,2003,NA,NA,529,289,240,336,128,208,0.71,0.53,0.64,19822,45,108,493
239716,SAINT NORBERT COLLEGE,1,0,2004,NA,NA,520,298,222,364,138,226,0.75,0.62,0.7,21210,45,103,464
239716,Saint Norbert College,1,0,2005,NA,NA,504,282,222,328,147,181,0.64,0.66,0.65,22209,44,109,467
239716,Saint Norbert College,1,0,2006,NA,NA,551,305,246,356,140,216,0.7000000000000001,0.57,0.65,23097,45,109,502
239716,Saint Norbert College,1,0,2007,NA,NA,542,328,214,372,130,242,0.73,0.61,0.69,24253,47,109,489
239716,Saint Norbert College,1,0,2008,NA,NA,531,293,238,335,131,204,0.6900000000000001,0.55,0.63,25526,50,132,486
239716,Saint Norbert College,1,0,2009,NA,NA,543,308,235,359,135,224,0.72,0.57,0.66,26522,52,134,483
239716,Saint Norbert College,1,0,2010,NA,NA,603,367,236,408,144,264,0.71,0.61,0.68,27583,55,135,534
240107,VITERBO COLLEGE,1,0,1991,NA,NA,201,145,56,63,14,49,0.33,0.25,0.31,7960,10,72,187
240107,VITERBO COLLEGE,1,0,1992,NA,NA,218,151,67,61,12,49,0.32,0.18,0.28,8360,12,75,214
240107,VITERBO COLLEGE,1,0,1993,NA,NA,270,205,65,67,14,53,0.25,0.22,0.25,8770,13,73,257
240107,VITERBO COLLEGE,1,0,1995,NA,NA,335,224,111,92,24,68,0.3,0.22,0.27,9850,18,80,308
240107,VITERBO COLLEGE,1,0,1996,NA,NA,284,195,89,70,10,60,0.3,0.11,0.25,10560,21,81,271
240107,VITERBO COLLEGE,1,0,1997,NA,NA,331,240,91,96,18,78,0.32,0.2,0.29,11150,16,82,313
240107,VITERBO COLLEGE,1,0,1998,NA,NA,318,220,98,88,21,67,0.3,0.21,0.28,11690,17,82,290
240107,VITERBO COLLEGE,1,0,1999,NA,NA,311,235,76,111,22,89,0.37,0.29,0.36,12220,19,83,290
240107,VITERBO UNIVERSITY,1,0,2000,NA,NA,327,252,75,98,16,82,0.32,0.21,0.3,12770,20,86,308
240107,VITERBO UNIVERSITY,1,0,2001,NA,NA,335,254,81,97,20,77,0.3,0.25,0.29,13350,21,90,313
240107,VITERBO UNIVERSITY,1,0,2002,NA,NA,321,236,85,91,19,72,0.3,0.22,0.28,14020,22,92,298
240107,VITERBO UNIVERSITY,1,0,2003,NA,NA,355,261,94,107,18,89,0.34,0.19,0.3,14900,23,96,330
240107,VITERBO UNIVERSITY,1,0,2004,NA,NA,308,210,98,82,19,63,0.3,0.19,0.27,15570,27,106,286
240107,Viterbo University,1,0,2005,NA,NA,289,207,82,82,11,71,0.34,0.13,0.28,16240,29,109,271
240107,Viterbo University,1,0,2006,NA,NA,308,223,85,100,21,79,0.35000000000000003,0.25,0.32,17220,32,110,275
240107,Viterbo University,1,0,2007,NA,NA,361,252,109,108,26,82,0.32,0.24,0.3,18170,33,109,341
240107,Viterbo University,1,0,2008,NA,NA,357,250,107,102,27,75,0.3,0.25,0.29,19000,34,107,337
240107,Viterbo University,1,0,2009,NA,NA,405,287,118,119,24,95,0.33,0.2,0.29,19670,35,112,373
240107,Viterbo University,1,0,2010,NA,NA,340,242,98,103,21,82,0.33,0.21,0.3,20360,36,119,309
240189,UNIVERSITY OF WISCONSIN-WHITEWATER,1,0,1991,NA,NA,1765,990,775,200,60,140,0.14,0.08,0.11,1914,70,400,1596
240189,UNIVERSITY OF WISCONSIN-WHITEWATER,1,0,1992,NA,NA,1746,933,813,204,68,136,0.14,0.08,0.12,2039,72,388,1575
240189,UNIVERSITY OF WISCONSIN-WHITEWATER,1,0,1993,NA,NA,1823,1019,804,251,78,173,0.16,0.1,0.14,2178,80,379,1671
240189,UNIVERSITY OF WISCONSIN-WHITEWATER,1,0,1995,NA,NA,1856,989,867,294,108,186,0.18,0.12,0.16,2474,82,368,1712
240189,UNIVERSITY OF WISCONSIN-WHITEWATER,1,0,1996,NA,NA,1825,995,830,369,137,232,0.23,0.17,0.2,2586,84,370,1704
240189,UNIVERSITY OF WISCONSIN-WHITEWATER,1,0,1997,NA,NA,1881,944,937,349,138,211,0.22,0.15,0.19,2772,86,366,1745
240189,UNIVERSITY OF WISCONSIN-WHITEWATER,1,0,1998,NA,NA,1901,965,936,354,122,232,0.24,0.13,0.19,2919,89,370,1756
240189,UNIVERSITY OF WISCONSIN-WHITEWATER,1,0,1999,NA,NA,1877,1017,860,357,119,238,0.23,0.14,0.19,2594,96,365,1718
240189,UNIVERSITY OF WISCONSIN-WHITEWATER,1,0,2000,NA,NA,2052,1051,1001,423,155,268,0.25,0.15,0.21,2594,100,359,1829
240189,UNIVERSITY OF WISCONSIN-WHITEWATER,1,0,2001,NA,NA,1857,936,921,379,153,226,0.24,0.17,0.2,2776,108,354,1681
240189,UNIVERSITY OF WISCONSIN-WHITEWATER,1,0,2002,NA,NA,2004,1095,909,463,176,287,0.26,0.19,0.23,3106,111,366,1827
240189,UNIVERSITY OF WISCONSIN-WHITEWATER,1,0,2003,NA,NA,1825,975,850,459,199,260,0.26,0.23,0.25,3623,104,390,1604
240189,UNIVERSITY OF WISCONSIN-WHITEWATER,1,0,2004,NA,NA,1745,836,909,427,193,234,0.27,0.21,0.24,4150,112,395,1474
240189,University of Wisconsin-Whitewater,1,0,2005,NA,NA,1701,823,878,437,196,241,0.29,0.22,0.26,4427,113,412,1509
240189,University of Wisconsin-Whitewater,1,0,2006,NA,NA,1780,836,944,533,233,300,0.35000000000000003,0.25,0.3,4728,118,423,1615
240189,University of Wisconsin-Whitewater,1,0,2007,NA,NA,2048,993,1055,564,258,306,0.3,0.24,0.28,4988,129,409,1815
240189,University of Wisconsin-Whitewater,1,0,2008,NA,NA,2132,1025,1107,575,276,299,0.29,0.25,0.27,5262,136,425,1859
240189,University of Wisconsin-Whitewater,1,0,2009,NA,NA,1941,941,1000,542,250,292,0.31,0.25,0.28,5551,143,423,1655
240189,University of Wisconsin-Whitewater,1,0,2010,NA,NA,2033,973,1060,590,267,323,0.33,0.25,0.29,5857,155,430,1750
240277,UNIVERSITY OF WISCONSIN-GREEN BAY,1,0,1991,NA,NA,775,506,269,75,21,54,0.1,0.08,0.1,1806,37,149,725
240277,UNIVERSITY OF WISCONSIN-GREEN BAY,1,0,1992,NA,NA,780,487,293,85,22,63,0.12,0.08,0.11,1995,45,153,715
240277,UNIVERSITY OF WISCONSIN-GREEN BAY,1,0,1993,NA,NA,703,438,265,96,29,67,0.15,0.11,0.14,2104,46,157,678
240277,UNIVERSITY OF WISCONSIN-GREEN BAY,1,0,1995,NA,NA,780,522,258,98,30,68,0.13,0.12,0.13,2427,47,146,755
240277,UNIVERSITY OF WISCONSIN-GREEN BAY,1,0,1996,NA,NA,939,581,358,138,48,90,0.15,0.13,0.15,2548,48,145,895
240277,UNIVERSITY OF WISCONSIN-GREEN BAY,1,0,1997,NA,NA,895,568,327,141,39,102,0.17,0.12,0.16,2736,50,151,859
240277,UNIVERSITY OF WISCONSIN-GREEN BAY,1,0,1998,NA,NA,946,612,334,155,53,102,0.16,0.16,0.16,2916,55,147,906
240277,UNIVERSITY OF WISCONSIN-GREEN BAY,1,0,1999,NA,NA,879,578,301,164,45,119,0.2,0.15,0.19,2594,60,163,828
240277,UNIVERSITY OF WISCONSIN-GREEN BAY,1,0,2000,NA,NA,929,631,298,216,55,161,0.25,0.18,0.23,2594,68,166,890
240277,UNIVERSITY OF WISCONSIN-GREEN BAY,1,0,2001,NA,NA,866,608,258,214,45,169,0.27,0.17,0.25,2776,70,169,824
240277,UNIVERSITY OF WISCONSIN-GREEN BAY,1,0,2002,NA,NA,896,595,301,204,55,149,0.25,0.18,0.23,3000,65,170,825
240277,UNIVERSITY OF WISCONSIN-GREEN BAY,1,0,2003,NA,NA,960,640,320,241,70,171,0.26,0.22,0.25,3500,68,177,896
240277,UNIVERSITY OF WISCONSIN-GREEN BAY,1,0,2004,NA,NA,989,636,353,228,71,157,0.24,0.2,0.23,4000,74,183,910
240277,University of Wisconsin-Green Bay,1,0,2005,NA,NA,904,587,317,198,45,153,0.26,0.14,0.22,4277,73,183,838
240277,University of Wisconsin-Green Bay,1,0,2006,NA,NA,1019,667,352,226,63,163,0.24,0.18,0.22,4568,70,175,928
240277,University of Wisconsin-Green Bay,1,0,2007,NA,NA,987,644,343,201,42,159,0.24,0.12,0.2,4819,70,177,904
240277,University of Wisconsin-Green Bay,1,0,2008,NA,NA,1000,614,386,236,67,169,0.27,0.17,0.24,5084,74,189,918
240277,University of Wisconsin-Green Bay,1,0,2009,NA,NA,1037,647,390,248,58,190,0.29,0.15,0.24,5364,78,188,928
240277,University of Wisconsin-Green Bay,1,0,2010,NA,NA,894,572,322,214,46,168,0.29,0.14,0.24,5659,83,194,804
240329,UNIVERSITY OF WISCONSIN-LA CROSSE,1,0,1991,NA,NA,1648,959,689,159,57,102,0.1,0.08,0.1,1945,66,362,1580
240329,UNIVERSITY OF WISCONSIN-LA CROSSE,1,0,1992,NA,NA,1486,921,565,161,42,119,0.12,0.07,0.11,2076,68,365,1390
240329,UNIVERSITY OF WISCONSIN-LA CROSSE,1,0,1993,NA,NA,1695,1008,687,243,83,160,0.15,0.12,0.14,2217,70,369,1595
240329,UNIVERSITY OF WISCONSIN-LA CROSSE,1,0,1995,NA,NA,1731,1035,696,324,104,220,0.21,0.15,0.19,2513,79,354,1643
240329,UNIVERSITY OF WISCONSIN-LA CROSSE,1,0,1996,NA,NA,1721,1074,647,393,109,284,0.26,0.17,0.23,2633,82,347,1650
240329,UNIVERSITY OF WISCONSIN-LA CROSSE,1,0,1997,NA,NA,1700,1042,658,386,108,278,0.26,0.16,0.23,2857,87,342,1620
240329,UNIVERSITY OF WISCONSIN-LA CROSSE,1,0,1998,NA,NA,1740,1123,617,450,128,322,0.28,0.21,0.26,3009,94,345,1649
240329,UNIVERSITY OF WISCONSIN-LA CROSSE,1,0,1999,NA,NA,1631,1035,596,395,128,267,0.25,0.21,0.24,2594,89,340,1544
240329,UNIVERSITY OF WISCONSIN-LA CROSSE,1,0,2000,NA,NA,1609,1009,600,420,131,289,0.28,0.22,0.26,2594,104,347,1501
240329,UNIVERSITY OF WISCONSIN-LA CROSSE,1,0,2001,NA,NA,1596,1022,574,444,138,306,0.29,0.24,0.28,2776,111,354,1504
240329,UNIVERSITY OF WISCONSIN-LA CROSSE,1,0,2002,NA,NA,1555,1006,549,463,128,335,0.33,0.23,0.3,3000,101,349,1456
240329,UNIVERSITY OF WISCONSIN-LA CROSSE,1,0,2003,NA,NA,1506,984,522,507,153,354,0.35000000000000003,0.29,0.34,3540,102,356,1398
240329,UNIVERSITY OF WISCONSIN-LA CROSSE,1,0,2004,NA,NA,1539,958,581,498,157,341,0.35000000000000003,0.27,0.32,4040,105,358,1411
240329,University of Wisconsin-La Crosse,1,0,2005,NA,NA,1755,1056,699,579,176,403,0.38,0.25,0.33,4331,106,360,1611
240329,University of Wisconsin-La Crosse,1,0,2006,NA,NA,1751,1098,653,633,190,443,0.4,0.29,0.36,4623,110,357,1585
240329,University of Wisconsin-La Crosse,1,0,2007,NA,NA,1750,1084,666,621,196,425,0.39,0.29,0.35,4876,116,370,1558
240329,University of Wisconsin-La Crosse,1,0,2008,NA,NA,1779,1081,698,577,192,385,0.35000000000000003,0.28,0.32,5643,118,360,1573
240329,University of Wisconsin-La Crosse,1,0,2009,NA,NA,1826,1128,698,660,193,467,0.41000000000000003,0.28,0.36,6425,129,384,1608
240329,University of Wisconsin-La Crosse,1,0,2010,NA,NA,1836,1093,743,660,209,451,0.41000000000000003,0.28,0.36,6809,138,404,1648
240338,WISCONSIN LUTHERAN COLLEGE,1,0,1991,NA,NA,71,45,26,20,8,12,0.26,0.31,0.28,7500,5,22,69
240338,WISCONSIN LUTHERAN COLLEGE,1,0,1992,NA,NA,77,45,32,22,7,15,0.33,0.22,0.29,8280,6,24,73
240338,WISCONSIN LUTHERAN COLLEGE,1,0,1993,NA,NA,80,55,25,31,10,21,0.38,0.4,0.39,8600,6,25,74
240338,WISCONSIN LUTHERAN COLLEGE,1,0,1995,NA,NA,109,63,46,51,18,33,0.52,0.39,0.47,9940,8,29,105
240338,WISCONSIN LUTHERAN COLLEGE,1,0,1996,NA,NA,101,71,30,55,12,43,0.6,0.4,0.54,11000,7,31,95
240338,WISCONSIN LUTHERAN COLLEGE,1,0,1997,NA,NA,109,61,48,50,21,29,0.47000000000000003,0.44,0.46,11450,7,29,104
240338,WISCONSIN LUTHERAN COLLEGE,1,0,1998,NA,NA,124,80,44,60,20,40,0.5,0.45,0.48,11960,8,33,120
240338,WISCONSIN LUTHERAN COLLEGE,1,0,1999,NA,NA,161,92,69,79,23,56,0.6,0.33,0.49,12460,10,39,149
240338,WISCONSIN LUTHERAN COLLEGE,1,0,2000,NA,NA,194,125,69,91,33,58,0.46,0.48,0.47,12980,12,42,184
240338,WISCONSIN LUTHERAN COLLEGE,1,0,2001,NA,NA,200,124,76,96,31,65,0.52,0.41,0.48,13990,15,45,194
240338,WISCONSIN LUTHERAN COLLEGE,1,0,2002,NA,NA,158,88,70,79,31,48,0.54,0.44,0.5,14970,15,50,147
240338,WISCONSIN LUTHERAN COLLEGE,1,0,2003,NA,NA,207,126,81,110,31,79,0.62,0.38,0.53,15720,16,43,196
240338,WISCONSIN LUTHERAN COLLEGE,1,0,2004,NA,NA,186,112,74,79,28,51,0.45,0.38,0.42,16510,17,44,173
240338,Wisconsin Lutheran College,1,0,2005,NA,NA,180,110,70,81,33,48,0.43,0.47,0.45,17340,19,50,172
240338,Wisconsin Lutheran College,1,0,2006,NA,NA,198,116,82,81,31,50,0.43,0.38,0.41,18520,23,57,184
240338,Wisconsin Lutheran College,1,0,2007,NA,NA,181,97,84,82,34,48,0.49,0.4,0.45,19430,25,61,155
240338,Wisconsin Lutheran College,1,0,2008,NA,NA,223,128,95,110,43,67,0.52,0.45,0.49,20420,26,60,190
240338,Wisconsin Lutheran College,1,0,2009,NA,NA,202,104,98,89,33,56,0.53,0.34,0.44,21040,26,61,176
240338,Wisconsin Lutheran College,1,0,2010,NA,NA,246,136,110,108,32,76,0.55,0.29,0.44,21820,24,58,206
240365,UNIVERSITY OF WISCONSIN-OSHKOSH,1,0,1991,NA,NA,1411,787,624,136,31,105,0.13,0.05,0.1,1821,77,382,1314
240365,UNIVERSITY OF WISCONSIN-OSHKOSH,1,0,1992,NA,NA,1461,834,627,172,32,140,0.16,0.05,0.12,1927,79,372,1356
240365,UNIVERSITY OF WISCONSIN-OSHKOSH,1,0,1993,NA,NA,1465,833,632,200,53,147,0.17,0.08,0.14,2037,83,356,1368
240365,UNIVERSITY OF WISCONSIN-OSHKOSH,1,0,1995,NA,NA,1487,844,643,211,74,137,0.16,0.12,0.14,2300,90,340,1428
240365,UNIVERSITY OF WISCONSIN-OSHKOSH,1,0,1996,NA,NA,1501,855,646,227,65,162,0.18,0.1,0.15,2417,91,350,1432
240365,UNIVERSITY OF WISCONSIN-OSHKOSH,1,0,1997,NA,NA,1719,994,725,242,69,173,0.17,0.1,0.14,2607,93,360,1656
240365,UNIVERSITY OF WISCONSIN-OSHKOSH,1,0,1998,NA,NA,1894,1095,799,252,67,185,0.16,0.08,0.13,2780,97,382,1820
240365,UNIVERSITY OF WISCONSIN-OSHKOSH,1,0,1999,NA,NA,1834,1084,750,284,85,199,0.18,0.11,0.15,2594,103,360,1750
240365,UNIVERSITY OF WISCONSIN-OSHKOSH,1,0,2000,NA,NA,1624,969,655,236,65,171,0.17,0.1,0.15,2594,108,342,1550
240365,UNIVERSITY OF WISCONSIN-OSHKOSH,1,0,2001,NA,NA,1822,994,828,249,86,163,0.16,0.1,0.14,2776,116,324,1726
240365,UNIVERSITY OF WISCONSIN-OSHKOSH,1,0,2002,NA,NA,1775,1045,730,259,71,188,0.17,0.1,0.15,3000,112,341,1669
240365,UNIVERSITY OF WISCONSIN-OSHKOSH,1,0,2003,NA,NA,1765,1077,688,261,67,194,0.18,0.1,0.15,3551,124,368,1641
240365,UNIVERSITY OF WISCONSIN-OSHKOSH,1,0,2004,NA,NA,1708,1033,675,250,78,172,0.16,0.12,0.15,4110,132,405,1577
240365,University of Wisconsin-Oshkosh,1,0,2005,NA,NA,1617,982,635,234,81,153,0.15,0.13,0.14,4387,129,385,1471
240365,University of Wisconsin-Oshkosh,1,0,2006,NA,NA,1726,1024,702,272,83,189,0.18,0.12,0.16,4678,134,377,1575
240365,University of Wisconsin-Oshkosh,1,0,2007,NA,NA,1723,1018,705,300,96,204,0.2,0.14,0.17,4929,139,386,1576
240365,University of Wisconsin-Oshkosh,1,0,2008,NA,NA,1807,1048,759,294,112,182,0.17,0.15,0.16,5194,149,389,1618
240365,University of Wisconsin-Oshkosh,1,0,2009,NA,NA,1874,1061,813,274,95,179,0.16,0.12,0.15,5477,159,413,1680
240365,University of Wisconsin-Oshkosh,1,0,2010,NA,NA,1817,1039,778,328,116,212,0.2,0.15,0.18,5775,166,424,1610
240374,UNIVERSITY OF WISCONSIN-PARKSIDE,1,0,1991,NA,NA,627,333,294,29,11,18,0.05,0.04,0.05,1863,33,164,556
240374,UNIVERSITY OF WISCONSIN-PARKSIDE,1,0,1992,NA,NA,633,321,312,32,14,18,0.05,0.04,0.05,1990,34,161,549
240374,UNIVERSITY OF WISCONSIN-PARKSIDE,1,0,1993,NA,NA,668,355,313,51,17,34,0.09,0.05,0.08,2113,35,163,566
240374,UNIVERSITY OF WISCONSIN-PARKSIDE,1,0,1995,NA,NA,637,369,268,42,13,29,0.07,0.05,0.07,2406,38,158,532
240374,UNIVERSITY OF WISCONSIN-PARKSIDE,1,0,1996,NA,NA,606,354,252,49,14,35,0.09,0.06,0.08,2523,38,157,530
240374,UNIVERSITY OF WISCONSIN-PARKSIDE,1,0,1997,NA,NA,726,440,286,87,24,63,0.14,0.08,0.12,2705,39,153,583
240374,UNIVERSITY OF WISCONSIN-PARKSIDE,1,0,1998,NA,NA,790,441,349,83,24,59,0.13,0.07,0.11,2840,41,143,644
240374,UNIVERSITY OF WISCONSIN-PARKSIDE,1,0,1999,NA,NA,811,419,392,78,30,48,0.11,0.08,0.1,2594,44,152,644
240374,UNIVERSITY OF WISCONSIN-PARKSIDE,1,0,2000,NA,NA,747,413,334,82,31,51,0.12,0.09,0.11,2594,49,157,578
240374,UNIVERSITY OF WISCONSIN-PARKSIDE,1,0,2001,NA,NA,854,486,368,84,21,63,0.12,0.06,0.1,2776,53,163,678
240374,UNIVERSITY OF WISCONSIN-PARKSIDE,1,0,2002,NA,NA,760,418,342,70,24,46,0.11,0.07,0.09,3000,48,177,627
240374,UNIVERSITY OF WISCONSIN-PARKSIDE,1,0,2003,NA,NA,863,469,394,68,27,41,0.08,0.07,0.08,3500,50,170,713
240374,UNIVERSITY OF WISCONSIN-PARKSIDE,1,0,2004,NA,NA,890,491,399,87,34,53,0.1,0.09,0.1,4000,53,174,670
240374,University of Wisconsin-Parkside,1,0,2005,NA,NA,783,442,341,61,27,34,0.07,0.08,0.08,4277,56,170,582
240374,University of Wisconsin-Parkside,1,0,2006,NA,NA,814,442,372,60,18,42,0.09,0.05,0.07,4568,57,175,587
240374,University of Wisconsin-Parkside,1,0,2007,NA,NA,833,418,415,75,38,37,0.08,0.09,0.09,4819,58,171,600
240374,University of Wisconsin-Parkside,1,0,2008,NA,NA,833,420,413,70,36,34,0.08,0.09,0.08,5084,59,173,544
240374,University of Wisconsin-Parkside,1,0,2009,NA,NA,788,427,361,88,31,57,0.13,0.09,0.11,5364,66,174,557
240374,University of Wisconsin-Parkside,1,0,2010,NA,NA,711,355,356,40,14,26,0.07,0.04,0.06,5659,75,177,492
240417,UNIVERSITY OF WISCONSIN-STOUT,1,0,1991,NA,NA,1158,606,552,77,19,58,0.09,0.03,0.07,1933,71,310,1086
240417,UNIVERSITY OF WISCONSIN-STOUT,1,0,1992,NA,NA,988,530,458,114,25,89,0.16,0.05,0.12,2054,73,298,909
240417,UNIVERSITY OF WISCONSIN-STOUT,1,0,1993,NA,NA,1023,488,535,143,36,107,0.21,0.07,0.14,2175,74,300,962
240417,UNIVERSITY OF WISCONSIN-STOUT,1,0,1995,NA,NA,1133,542,591,143,36,107,0.19,0.06,0.13,2461,79,287,1085
240417,UNIVERSITY OF WISCONSIN-STOUT,1,0,1996,NA,NA,1275,644,631,194,61,133,0.2,0.1,0.15,2619,78,294,1226
240417,UNIVERSITY OF WISCONSIN-STOUT,1,0,1997,NA,NA,1241,604,637,170,47,123,0.2,0.07,0.14,2806,79,276,1185
240417,UNIVERSITY OF WISCONSIN-STOUT,1,0,1998,NA,NA,1333,614,719,209,74,135,0.21,0.1,0.16,2938,89,290,1287
240417,UNIVERSITY OF WISCONSIN-STOUT,1,0,1999,NA,NA,1317,661,656,185,57,128,0.19,0.09,0.14,2724,93,282,1259
240417,UNIVERSITY OF WISCONSIN-STOUT,1,0,2000,NA,NA,1307,668,639,195,58,137,0.2,0.09,0.15,2724,98,276,1258
240417,UNIVERSITY OF WISCONSIN-STOUT,1,0,2001,NA,NA,1272,652,620,202,62,140,0.21,0.1,0.16,2916,109,271,1225
240417,UNIVERSITY OF WISCONSIN-STOUT,1,0,2002,NA,NA,1303,658,645,219,51,168,0.25,0.08,0.17,3150,94,282,1243
240417,UNIVERSITY OF WISCONSIN-STOUT,1,0,2003,NA,NA,1267,654,613,244,75,169,0.25,0.12,0.19,5024,97,295,1216
240417,UNIVERSITY OF WISCONSIN-STOUT,1,0,2004,NA,NA,1277,649,628,254,67,187,0.28,0.11,0.2,5580,101,310,1178
240417,University of Wisconsin-Stout,1,0,2005,NA,NA,1699,863,836,322,103,219,0.25,0.12,0.19,4745,102,304,1565
240417,University of Wisconsin-Stout,1,0,2006,NA,NA,1507,792,715,275,90,185,0.23,0.13,0.18,5087,111,312,1394
240417,University of Wisconsin-Stout,1,0,2007,NA,NA,1489,763,726,309,108,201,0.26,0.15,0.21,5367,114,308,1375
240417,University of Wisconsin-Stout,1,0,2008,NA,NA,1633,837,796,313,103,210,0.25,0.13,0.19,5662,121,327,1502
240417,University of Wisconsin-Stout,1,0,2009,NA,NA,1517,788,729,350,111,239,0.3,0.15,0.23,5974,127,336,1395
240417,University of Wisconsin-Stout,1,0,2010,NA,NA,1571,756,815,324,124,200,0.26,0.15,0.21,6302,135,333,1428
240426,UNIVERSITY OF WISCONSIN-SUPERIOR,1,0,1991,NA,NA,443,220,223,24,10,14,0.06,0.04,0.05,1806,27,90,420
240426,UNIVERSITY OF WISCONSIN-SUPERIOR,1,0,1992,NA,NA,350,189,161,35,14,21,0.11,0.09,0.1,1917,28,101,319
240426,UNIVERSITY OF WISCONSIN-SUPERIOR,1,0,1993,NA,NA,323,182,141,41,14,27,0.14,0.1,0.13,2036,29,100,306
240426,UNIVERSITY OF WISCONSIN-SUPERIOR,1,0,1995,NA,NA,288,173,115,52,17,35,0.2,0.15,0.18,2335,31,95,268
240426,UNIVERSITY OF WISCONSIN-SUPERIOR,1,0,1996,NA,NA,308,158,150,42,13,29,0.18,0.09,0.14,2463,31,97,286
240426,UNIVERSITY OF WISCONSIN-SUPERIOR,1,0,1997,NA,NA,326,182,144,36,13,23,0.12,0.09,0.11,2652,32,102,300
240426,UNIVERSITY OF WISCONSIN-SUPERIOR,1,0,1998,NA,NA,376,218,158,55,16,39,0.17,0.1,0.15,2770,34,98,356
240426,UNIVERSITY OF WISCONSIN-SUPERIOR,1,0,1999,NA,NA,406,241,165,38,6,32,0.13,0.04,0.09,2594,37,106,387
240426,UNIVERSITY OF WISCONSIN-SUPERIOR,1,0,2000,NA,NA,395,234,161,57,21,36,0.15,0.13,0.14,2594,40,100,367
240426,UNIVERSITY OF WISCONSIN-SUPERIOR,1,0,2001,NA,NA,339,192,147,53,24,29,0.15,0.16,0.16,2776,45,95,297
240426,UNIVERSITY OF WISCONSIN-SUPERIOR,1,0,2002,NA,NA,286,150,136,37,15,22,0.14,0.11,0.13,3000,35,97,254
240426,UNIVERSITY OF WISCONSIN-SUPERIOR,1,0,2003,NA,NA,336,213,123,66,14,52,0.24,0.11,0.2,3650,35,113,303
240426,UNIVERSITY OF WISCONSIN-SUPERIOR,1,0,2004,NA,NA,329,190,139,54,20,34,0.17,0.14,0.16,4150,40,114,293
240426,University of Wisconsin-Superior,1,0,2005,NA,NA,336,208,128,61,11,50,0.24,0.09,0.18,4427,39,114,290
240426,University of Wisconsin-Superior,1,0,2006,NA,NA,293,143,150,53,26,27,0.18,0.17,0.18,4718,45,115,255
240426,University of Wisconsin-Superior,1,0,2007,NA,NA,343,197,146,47,14,33,0.16,0.1,0.14,4969,44,116,307
240426,University of Wisconsin-Superior,1,0,2008,NA,NA,303,168,135,59,15,44,0.26,0.11,0.19,5291,45,114,259
240426,University of Wisconsin-Superior,1,0,2009,NA,NA,364,194,170,58,22,36,0.18,0.13,0.16,5571,50,116,297
240426,University of Wisconsin-Superior,1,0,2010,NA,NA,369,197,172,80,27,53,0.26,0.16,0.22,5866,57,126,303
240444,UNIVERSITY OF WISCONSIN-MADISON,1,0,1991,NA,NA,4582,2387,2195,1516,589,927,0.38,0.27,0.33,2188,1192,1647,4138
240444,UNIVERSITY OF WISCONSIN-MADISON,1,0,1992,NA,NA,4390,2244,2146,1514,599,915,0.4,0.28,0.34,2346,1263,1641,3910
240444,UNIVERSITY OF WISCONSIN-MADISON,1,0,1993,NA,NA,4585,2396,2189,1686,659,1027,0.42,0.3,0.37,2540,1343,1637,4052
240444,UNIVERSITY OF WISCONSIN-MADISON,1,0,1995,NA,NA,5101,2779,2322,2037,768,1269,0.45,0.33,0.4,2881,1401,1495,4547
240444,UNIVERSITY OF WISCONSIN-MADISON,1,0,1996,NA,NA,5394,2954,2440,2090,769,1321,0.44,0.32,0.39,3030,1437,1474,4772
240444,UNIVERSITY OF WISCONSIN-MADISON,1,0,1997,NA,NA,5828,3156,2672,2303,835,1468,0.46,0.31,0.4,3241,1205,1421,5148
240444,UNIVERSITY OF WISCONSIN-MADISON,1,0,1998,NA,NA,5548,3038,2510,2190,844,1346,0.44,0.34,0.39,3408,1301,1436,4850
240444,UNIVERSITY OF WISCONSIN-MADISON,1,0,1999,NA,NA,5520,2985,2535,2263,847,1416,0.47000000000000003,0.33,0.41,3290,1332,1397,4831
240444,UNIVERSITY OF WISCONSIN-MADISON,1,0,2000,NA,NA,5636,3120,2516,2500,963,1537,0.49,0.38,0.44,3290,1479,1445,4979
240444,UNIVERSITY OF WISCONSIN-MADISON,1,0,2001,NA,NA,6050,3370,2680,2758,1046,1712,0.5,0.39,0.46,3658,1610,1494,5223
240444,UNIVERSITY OF WISCONSIN-MADISON,1,0,2002,NA,NA,5488,3016,2472,2729,1037,1692,0.56,0.42,0.5,3854,1536,1461,4742
240444,UNIVERSITY OF WISCONSIN-MADISON,1,0,2003,NA,NA,5553,2968,2585,2689,1114,1575,0.53,0.43,0.48,4554,1643,1614,4649
240444,UNIVERSITY OF WISCONSIN-MADISON,1,0,2004,NA,NA,5617,3124,2493,2792,1096,1696,0.54,0.44,0.5,5254,1796,1623,4607
240444,University of Wisconsin-Madison,1,0,2005,NA,NA,6118,3434,2684,3174,1255,1919,0.55,0.47,0.52,5618,1878,1646,4942
240444,University of Wisconsin-Madison,1,0,2006,NA,NA,5633,3033,2600,2965,1202,1763,0.58,0.46,0.53,6000,1931,1686,4458
240444,University of Wisconsin-Madison,1,0,2007,NA,NA,5980,3197,2783,3291,1332,1959,0.61,0.48,0.55,6330,1988,1650,4658
240444,University of Wisconsin-Madison,1,0,2008,NA,NA,5759,3027,2732,3148,1333,1815,0.59,0.49,0.55,6678,2125,1641,4465
240444,University of Wisconsin-Madison,1,0,2009,NA,NA,5673,3033,2640,3179,1277,1902,0.62,0.48,0.56,7296,2277,1658,4394
240444,University of Wisconsin-Madison,1,0,2010,NA,NA,5920,3108,2812,3337,1328,2009,0.64,0.47,0.56,7933,2298,1665,4676
240453,UNIVERSITY OF WISCONSIN-MILWAUKEE,1,0,1991,NA,NA,1392,730,662,145,53,92,0.12,0.08,0.1,2231,209,813,1241
240453,UNIVERSITY OF WISCONSIN-MILWAUKEE,1,0,1992,NA,NA,1187,566,621,113,40,73,0.12,0.06,0.1,2391,217,806,1056
240453,UNIVERSITY OF WISCONSIN-MILWAUKEE,1,0,1993,NA,NA,1712,849,863,117,51,66,0.07,0.06,0.07,2548,226,797,1411
240453,UNIVERSITY OF WISCONSIN-MILWAUKEE,1,0,1995,NA,NA,1785,926,859,186,75,111,0.11,0.09,0.1,2947,240,782,1467
240453,UNIVERSITY OF WISCONSIN-MILWAUKEE,1,0,1996,NA,NA,2033,1113,920,233,88,145,0.13,0.1,0.11,3102,242,754,1690
240453,UNIVERSITY OF WISCONSIN-MILWAUKEE,1,0,1997,NA,NA,2272,1263,1009,327,124,203,0.16,0.12,0.14,3327,248,743,1866
240453,UNIVERSITY OF WISCONSIN-MILWAUKEE,1,0,1998,NA,NA,2513,1367,1146,273,102,171,0.12,0.09,0.11,3482,266,724,2019
240453,UNIVERSITY OF WISCONSIN-MILWAUKEE,1,0,1999,NA,NA,2694,1523,1171,356,127,229,0.15,0.11,0.13,3194,281,751,2243
240453,UNIVERSITY OF WISCONSIN-MILWAUKEE,1,0,2000,NA,NA,2663,1449,1214,395,142,253,0.17,0.12,0.15,3194,290,763,2187
240453,UNIVERSITY OF WISCONSIN-MILWAUKEE,1,0,2001,NA,NA,2884,1532,1352,423,160,263,0.17,0.12,0.15,3462,324,775,2335
240453,UNIVERSITY OF WISCONSIN-MILWAUKEE,1,0,2002,NA,NA,3178,1736,1442,457,175,282,0.16,0.12,0.14,3738,320,809,2633
240453,UNIVERSITY OF WISCONSIN-MILWAUKEE,1,0,2003,NA,NA,3716,2023,1693,552,217,335,0.16,0.13,0.15,4439,333,902,3089
240453,UNIVERSITY OF WISCONSIN-MILWAUKEE,1,0,2004,NA,NA,3714,2000,1714,555,216,339,0.16,0.13,0.15,5138,351,935,3051
240453,University of Wisconsin-Milwaukee,1,0,2005,NA,NA,4218,2233,1985,604,258,346,0.15,0.13,0.14,5494,371,964,3456
240453,University of Wisconsin-Milwaukee,1,0,2006,NA,NA,3977,2064,1913,554,247,307,0.14,0.13,0.14,5868,389,991,3280
240453,University of Wisconsin-Milwaukee,1,0,2007,NA,NA,4465,2228,2237,585,259,326,0.14,0.12,0.13,6191,419,996,3619
240453,University of Wisconsin-Milwaukee,1,0,2008,NA,NA,4002,2100,1902,572,246,326,0.15,0.13,0.14,6531,443,1022,3124
240453,University of Wisconsin-Milwaukee,1,0,2009,NA,NA,4051,2020,2031,578,250,328,0.16,0.12,0.14,6890,460,1041,3138
240453,University of Wisconsin-Milwaukee,1,0,2010,NA,NA,3731,1876,1855,506,225,281,0.14,0.12,0.14,7269,487,1075,2737
240462,UNIVERSITY OF WISCONSIN-PLATTEVILLE,1,0,1991,NA,NA,986,339,647,110,56,54,0.15,0.09,0.11,1955,48,227,939
240462,UNIVERSITY OF WISCONSIN-PLATTEVILLE,1,0,1992,NA,NA,878,304,574,98,48,50,0.16,0.08,0.11,2087,50,234,843
240462,UNIVERSITY OF WISCONSIN-PLATTEVILLE,1,0,1993,NA,NA,917,276,641,109,51,58,0.21,0.08,0.12,2207,50,221,871
240462,UNIVERSITY OF WISCONSIN-PLATTEVILLE,1,0,1995,NA,NA,926,315,611,125,59,66,0.2,0.1,0.13,2485,55,219,883
240462,UNIVERSITY OF WISCONSIN-PLATTEVILLE,1,0,1996,NA,NA,933,300,633,120,59,61,0.2,0.09,0.13,2591,56,206,907
240462,UNIVERSITY OF WISCONSIN-PLATTEVILLE,1,0,1997,NA,NA,978,304,674,138,69,69,0.22,0.1,0.14,2775,57,197,940
240462,UNIVERSITY OF WISCONSIN-PLATTEVILLE,1,0,1998,NA,NA,1118,369,749,134,63,71,0.19,0.08,0.12,2916,61,219,1070
240462,UNIVERSITY OF WISCONSIN-PLATTEVILLE,1,0,1999,NA,NA,1093,377,716,148,61,87,0.23,0.09,0.14,2594,63,212,1059
240462,UNIVERSITY OF WISCONSIN-PLATTEVILLE,1,0,2000,NA,NA,958,340,618,129,53,76,0.22,0.09,0.13,2594,65,210,925
240462,UNIVERSITY OF WISCONSIN-PLATTEVILLE,1,0,2001,NA,NA,1039,373,666,176,85,91,0.24,0.13,0.17,2776,72,208,1010
240462,UNIVERSITY OF WISCONSIN-PLATTEVILLE,1,0,2002,NA,NA,1120,395,725,184,75,109,0.27,0.1,0.16,3000,68,209,1076
240462,UNIVERSITY OF WISCONSIN-PLATTEVILLE,1,0,2003,NA,NA,1116,406,710,203,105,98,0.24,0.15,0.18,3500,75,237,1081
240462,UNIVERSITY OF WISCONSIN-PLATTEVILLE,1,0,2004,NA,NA,1164,398,766,205,90,115,0.28,0.12,0.18,4000,75,243,1103
240462,University of Wisconsin-Platteville,1,0,2005,NA,NA,1218,426,792,187,83,104,0.24,0.1,0.15,4277,77,248,1152
240462,University of Wisconsin-Platteville,1,0,2006,NA,NA,1387,467,920,259,145,114,0.24,0.16,0.19,4568,81,268,1292
240462,University of Wisconsin-Platteville,1,0,2007,NA,NA,1466,500,966,275,127,148,0.29,0.13,0.19,4819,89,278,1371
240462,University of Wisconsin-Platteville,1,0,2008,NA,NA,1468,496,972,235,117,118,0.23,0.12,0.16,5184,93,286,1353
240462,University of Wisconsin-Platteville,1,0,2009,NA,NA,1531,512,1019,304,166,138,0.26,0.16,0.2,5466,99,291,1409
240462,University of Wisconsin-Platteville,1,0,2010,NA,NA,1534,508,1026,297,170,127,0.25,0.17,0.19,5766,101,294,1428
240471,UNIVERSITY OF WISCONSIN-RIVER FALLS,1,0,1991,NA,NA,1022,557,465,122,48,74,0.13,0.1,0.12,2199,52,244,966
240471,UNIVERSITY OF WISCONSIN-RIVER FALLS,1,0,1992,NA,NA,1009,543,466,151,68,83,0.15,0.15,0.15,2024,55,234,962
240471,UNIVERSITY OF WISCONSIN-RIVER FALLS,1,0,1993,NA,NA,838,443,395,162,64,98,0.22,0.16,0.19,2145,57,238,776
240471,UNIVERSITY OF WISCONSIN-RIVER FALLS,1,0,1995,NA,NA,957,548,409,204,73,131,0.23,0.18,0.21,2445,61,222,909
240471,UNIVERSITY OF WISCONSIN-RIVER FALLS,1,0,1996,NA,NA,1149,688,461,249,82,167,0.24,0.18,0.22,2565,63,214,1106
240471,UNIVERSITY OF WISCONSIN-RIVER FALLS,1,0,1997,NA,NA,1144,698,446,269,79,190,0.27,0.18,0.24,2750,64,209,1100
240471,UNIVERSITY OF WISCONSIN-RIVER FALLS,1,0,1998,NA,NA,1199,773,426,287,87,200,0.25,0.2,0.24,2890,68,212,1149
240471,UNIVERSITY OF WISCONSIN-RIVER FALLS,1,0,1999,NA,NA,1104,684,420,277,95,182,0.26,0.23,0.25,2594,73,216,1038
240471,UNIVERSITY OF WISCONSIN-RIVER FALLS,1,0,2000,NA,NA,1096,669,427,259,81,178,0.26,0.19,0.24,2594,80,218,1018
240471,UNIVERSITY OF WISCONSIN-RIVER FALLS,1,0,2001,NA,NA,1108,680,428,265,86,179,0.26,0.2,0.24,2776,85,220,1028
240471,UNIVERSITY OF WISCONSIN-RIVER FALLS,1,0,2002,NA,NA,1045,642,403,277,81,196,0.3,0.2,0.27,3000,61,214,971
240471,UNIVERSITY OF WISCONSIN-RIVER FALLS,1,0,2003,NA,NA,1220,757,463,305,98,207,0.27,0.21,0.25,3500,66,221,1113
240471,UNIVERSITY OF WISCONSIN-RIVER FALLS,1,0,2004,NA,NA,1197,722,475,311,109,202,0.27,0.23,0.26,4000,68,223,1086
240471,University of Wisconsin-River Falls,1,0,2005,NA,NA,1192,734,458,268,80,188,0.25,0.17,0.22,4277,71,231,1076
240471,University of Wisconsin-River Falls,1,0,2006,NA,NA,1289,773,516,281,77,204,0.26,0.15,0.22,4568,75,238,1176
240471,University of Wisconsin-River Falls,1,0,2007,NA,NA,1276,743,533,297,103,194,0.26,0.19,0.23,4891,86,237,1184
240471,University of Wisconsin-River Falls,1,0,2008,NA,NA,1332,783,549,365,136,229,0.29,0.25,0.27,5156,90,241,1228
240471,University of Wisconsin-River Falls,1,0,2009,NA,NA,1325,836,489,382,108,274,0.32,0.22,0.29,5436,92,231,1214
240471,University of Wisconsin-River Falls,1,0,2010,NA,NA,1230,758,472,360,112,248,0.32,0.24,0.29,5731,96,240,1104
240480,UNIVERSITY OF WISCONSIN-STEVENS POINT,1,0,1991,NA,NA,1494,763,731,183,62,121,0.15,0.08,0.12,1955,80,367,1434
240480,UNIVERSITY OF WISCONSIN-STEVENS POINT,1,0,1992,NA,NA,1388,772,616,229,61,168,0.21,0.1,0.16,2078,82,349,1315
240480,UNIVERSITY OF WISCONSIN-STEVENS POINT,1,0,1993,NA,NA,1359,702,657,201,72,129,0.18,0.11,0.15,2218,82,344,1298
240480,UNIVERSITY OF WISCONSIN-STEVENS POINT,1,0,1995,NA,NA,1474,817,657,285,82,203,0.24,0.12,0.19,2488,90,324,1392
240480,UNIVERSITY OF WISCONSIN-STEVENS POINT,1,0,1996,NA,NA,1555,806,749,301,97,204,0.25,0.13,0.19,2601,92,314,1485
240480,UNIVERSITY OF WISCONSIN-STEVENS POINT,1,0,1997,NA,NA,1527,837,690,262,78,184,0.21,0.11,0.17,2790,94,308,1445
240480,UNIVERSITY OF WISCONSIN-STEVENS POINT,1,0,1998,NA,NA,1503,868,635,310,85,225,0.25,0.13,0.21,2929,97,311,1442
240480,UNIVERSITY OF WISCONSIN-STEVENS POINT,1,0,1999,NA,NA,1490,849,641,285,99,186,0.21,0.15,0.19,2594,101,311,1409
240480,UNIVERSITY OF WISCONSIN-STEVENS POINT,1,0,2000,NA,NA,1518,925,593,333,107,226,0.24,0.18,0.22,2594,105,314,1438
240480,UNIVERSITY OF WISCONSIN-STEVENS POINT,1,0,2001,NA,NA,1505,849,656,297,108,189,0.22,0.16,0.2,2776,114,318,1424
240480,UNIVERSITY OF WISCONSIN-STEVENS POINT,1,0,2002,NA,NA,1464,806,658,286,109,177,0.21,0.17,0.2,3000,108,316,1369
240480,UNIVERSITY OF WISCONSIN-STEVENS POINT,1,0,2003,NA,NA,1498,853,645,335,101,234,0.27,0.16,0.22,3500,113,369,1403
240480,UNIVERSITY OF WISCONSIN-STEVENS POINT,1,0,2004,NA,NA,1525,857,668,322,118,204,0.23,0.18,0.21,4000,121,366,1413
240480,University of Wisconsin-Stevens Point,1,0,2005,NA,NA,1521,832,689,365,136,229,0.27,0.2,0.24,4277,119,362,1414
240480,University of Wisconsin-Stevens Point,1,0,2006,NA,NA,1640,888,752,395,153,242,0.27,0.2,0.24,4568,124,349,1529
240480,University of Wisconsin-Stevens Point,1,0,2007,NA,NA,1611,892,719,358,145,213,0.23,0.2,0.22,4819,133,359,1458
240480,University of Wisconsin-Stevens Point,1,0,2008,NA,NA,1608,882,726,412,145,267,0.3,0.2,0.26,5084,138,355,1441
240480,University of Wisconsin-Stevens Point,1,0,2009,NA,NA,1632,835,797,422,156,266,0.31,0.2,0.26,5364,141,355,1454
240480,University of Wisconsin-Stevens Point,1,0,2010,NA,NA,1644,881,763,499,213,286,0.32,0.28,0.3,5659,155,375,1479
240727,UNIVERSITY OF WYOMING,1,0,1991,NA,NA,1257,534,723,174,73,101,0.18,0.1,0.14,1293,172,635,1105
240727,UNIVERSITY OF WYOMING,1,0,1992,NA,NA,1281,640,641,221,73,148,0.23,0.11,0.17,1430,190,600,1134
240727,UNIVERSITY OF WYOMING,1,0,1993,NA,NA,1212,560,652,207,79,128,0.22,0.12,0.17,1648,192,591,1080
240727,UNIVERSITY OF WYOMING,1,0,1995,NA,NA,1267,661,606,276,88,188,0.28,0.15,0.22,2005,213,626,1076
240727,UNIVERSITY OF WYOMING,1,0,1996,NA,NA,1203,628,575,297,101,196,0.31,0.18,0.25,2144,205,620,1035
240727,UNIVERSITY OF WYOMING,1,0,1997,NA,NA,1119,562,557,276,97,179,0.31,0.17,0.25,2326,207,615,956
240727,UNIVERSITY OF WYOMING,1,0,1998,NA,NA,1225,660,565,306,104,202,0.3,0.18,0.25,2330,212,612,1042
240727,UNIVERSITY OF WYOMING,1,0,1999,NA,NA,1194,654,540,352,124,228,0.34,0.23,0.29,2016,219,606,1042
240727,UNIVERSITY OF WYOMING,1,0,2000,NA,NA,1313,658,655,337,126,211,0.32,0.19,0.26,2166,213,605,1138
240727,UNIVERSITY OF WYOMING,1,0,2001,NA,NA,1411,724,687,369,135,234,0.32,0.2,0.26,2316,249,604,1256
240727,UNIVERSITY OF WYOMING,1,0,2002,NA,NA,1443,733,710,328,113,215,0.29,0.16,0.23,2400,246,612,1284
240727,UNIVERSITY OF WYOMING,1,0,2003,NA,NA,1388,709,679,310,102,208,0.29,0.15,0.22,2520,273,624,1224
240727,UNIVERSITY OF WYOMING,1,0,2004,NA,NA,1496,754,742,336,133,203,0.26,0.18,0.22,2088,289,643,1302
240727,University of Wyoming,1,0,2005,NA,NA,1399,739,660,320,107,213,0.28,0.16,0.23,2208,307,688,1219
240727,University of Wyoming,1,0,2006,NA,NA,1543,761,782,359,118,241,0.31,0.15,0.23,2256,315,666,1283
240727,University of Wyoming,1,0,2007,NA,NA,1614,831,783,389,132,257,0.3,0.17,0.24,2256,334,692,1356
240727,University of Wyoming,1,0,2008,NA,NA,1674,851,823,408,148,260,0.3,0.18,0.24,2256,373,715,1406
240727,University of Wyoming,1,0,2009,NA,NA,1568,799,769,405,136,269,0.33,0.18,0.26,2256,405,730,1331
240727,University of Wyoming,1,0,2010,NA,NA,1451,711,740,386,144,242,0.34,0.19,0.27,2376,430,740,1210
243443,UNIVERSITY OF SACRED HEART,1,0,1991,NA,NA,518,370,148,1,0,1,0,0,0,2795,29,168,0
243443,UNIVERSITY OF SACRED HEART,1,0,1992,NA,NA,584,396,188,47,7,40,0.1,0.04,0.08,3245,27,167,0
243443,UNIVERSITY OF SACRED HEART,1,0,1993,NA,NA,796,541,255,44,8,36,0.06,0.03,0.06,3245,25,141,0
243443,UNIVERSITY OF SACRED HEART,1,0,1995,NA,NA,728,466,262,33,8,25,0.05,0.03,0.05,3745,27,126,0
243443,UNIVERSITY OF SACRED HEART,1,0,1996,NA,NA,780,483,297,46,11,35,0.07,0.04,0.06,3800,28,123,0
243443,UNIVERSITY OF SACRED HEART,1,0,1997,NA,NA,723,471,252,50,6,44,0.09,0.02,0.07,4000,20,119,0
243443,UNIVERSITY OF SACRED HEART,1,0,1998,NA,NA,885,567,318,76,10,66,0.11,0.03,0.09,4000,21,118,0
243443,UNIVERSITY OF SACRED HEART,1,0,1999,NA,NA,799,506,293,63,13,50,0.09,0.04,0.08,3900,22,114,0
243443,UNIVERSITY OF SACRED HEART,1,0,2000,NA,NA,540,350,190,59,10,49,0.14,0.05,0.11,4050,23,110,0
243443,UNIVERSITY OF SACRED HEART,1,0,2001,NA,NA,478,333,145,52,7,45,0.13,0.05,0.11,4200,26,106,0
243443,UNIVERSITY OF SACRED HEART,1,0,2002,NA,NA,496,320,176,43,8,35,0.1,0.05,0.09,4200,27,108,0
243443,UNIVERSITY OF SACRED HEART,1,0,2003,NA,NA,425,274,151,10,3,7,0.02,0.02,0.02,4350,30,108,0
243443,UNIVERSITY OF SACRED HEART,1,0,2004,NA,NA,519,340,179,50,11,39,0.11,0.06,0.1,4350,31,105,0
243443,University of Sacred Heart,1,0,2005,NA,NA,796,500,296,66,8,58,0.11,0.03,0.08,4500,34,104,0
243443,University of Sacred Heart,1,0,2006,NA,NA,764,532,232,66,13,53,0.09,0.06,0.09,4650,33,100,0
243443,University of Sacred Heart,1,0,2007,NA,NA,690,422,268,41,10,31,0.07,0.04,0.06,3840,32,98,0
243443,University of Sacred Heart,1,0,2008,NA,NA,750,435,315,43,9,34,0.07,0.03,0.06,3960,35,99,0
243443,University of Sacred Heart,1,0,2009,NA,NA,726,461,265,43,12,31,0.06,0.05,0.06,4080,38,101,0
243443,University of Sacred Heart,1,0,2010,NA,NA,933,541,392,63,19,44,0.08,0.05,0.07,4200,39,100,0
243780,PURDUE UNIVERSITY MAIN CAMPUS,1,0,1991,NA,NA,5754,2516,3238,1682,790,892,0.35000000000000003,0.24,0.29,2324,567,1485,5057
243780,PURDUE UNIVERSITY MAIN CAMPUS,1,0,1992,NA,NA,5583,2396,3187,1589,761,828,0.34,0.24,0.28,2520,603,1475,4886
243780,PURDUE UNIVERSITY-MAIN CAMPUS,1,0,1993,NA,NA,5725,2560,3165,1625,773,852,0.33,0.24,0.28,2696,627,1443,5059
243780,PURDUE UNIVERSITY-MAIN CAMPUS,1,0,1995,NA,NA,6064,2696,3368,1625,786,839,0.31,0.23,0.27,3056,670,1457,5375
243780,PURDUE UNIVERSITY-MAIN CAMPUS,1,0,1996,NA,NA,6339,2713,3626,1843,903,940,0.34,0.25,0.29,3208,697,1462,5548
243780,PURDUE UNIVERSITY-MAIN CAMPUS,1,0,1997,NA,NA,6369,2806,3563,1994,953,1041,0.37,0.27,0.31,3352,756,1469,5521
243780,PURDUE UNIVERSITY-MAIN CAMPUS,1,0,1998,NA,NA,6625,2825,3800,2040,998,1042,0.36,0.26,0.31,3532,770,1505,5820
243780,PURDUE UNIVERSITY-MAIN CAMPUS,1,0,1999,NA,NA,6895,2945,3950,2083,974,1109,0.37,0.25,0.3,3409,836,1481,5965
243780,PURDUE UNIVERSITY-MAIN CAMPUS,1,0,2000,NA,NA,6403,2646,3757,2209,1046,1163,0.43,0.28,0.34,3552,882,1652,5548
243780,PURDUE UNIVERSITY-MAIN CAMPUS,1,0,2001,NA,NA,6567,2601,3966,2218,1059,1159,0.44,0.27,0.34,3830,936,1824,5611
243780,PURDUE UNIVERSITY-MAIN CAMPUS,1,0,2002,NA,NA,6294,2535,3759,2230,1046,1184,0.46,0.28,0.35,5228,968,1831,5139
243780,PURDUE UNIVERSITY-MAIN CAMPUS,1,0,2003,NA,NA,6459,2559,3900,2254,1121,1133,0.44,0.29,0.35,5498,1012,1857,5345
243780,PURDUE UNIVERSITY-MAIN CAMPUS,1,0,2004,NA,NA,6766,2781,3985,2419,1066,1353,0.48,0.27,0.36,5962,1093,2131,5604
243780,Purdue University-Main Campus,1,0,2005,NA,NA,7167,2860,4307,2547,1189,1358,0.47000000000000003,0.28,0.36,6320,1217,2183,5851
243780,Purdue University-Main Campus,1,0,2006,NA,NA,7430,3019,4411,2764,1350,1414,0.46,0.31,0.37,6700,1210,2255,5954
243780,Purdue University-Main Campus,1,0,2007,NA,NA,6830,2882,3948,2702,1260,1442,0.5,0.32,0.4,7002,1264,2347,5431
243780,Purdue University-Main Campus,1,0,2008,NA,NA,7058,3083,3975,3028,1409,1619,0.52,0.35,0.43,7317,1367,2311,5628
243780,Purdue University-Main Campus,1,0,2009,NA,NA,6308,2660,3648,2868,1412,1456,0.54,0.39,0.45,8183,1443,2367,4560
243780,Purdue University-Main Campus,1,0,2010,NA,NA,6454,2706,3748,3133,1579,1554,0.5700000000000001,0.42,0.49,8592,1505,2393,4593
